code;name;agegroup;population_total;population_m;population_f
09161;      Ingolstadt (Krfr.St);unter 1;1618;826;792
09161;      Ingolstadt (Krfr.St);1 bis unter 2;1499;768;731
09161;      Ingolstadt (Krfr.St);2 bis unter 3;1442;737;705
09161;      Ingolstadt (Krfr.St);3 bis unter 4;1354;694;660
09161;      Ingolstadt (Krfr.St);4 bis unter 5;1385;718;667
09161;      Ingolstadt (Krfr.St);5 bis unter 6;1321;689;632
09161;      Ingolstadt (Krfr.St);6 bis unter 7;1232;644;588
09161;      Ingolstadt (Krfr.St);7 bis unter 8;1196;610;586
09161;      Ingolstadt (Krfr.St);8 bis unter 9;1223;647;576
09161;      Ingolstadt (Krfr.St);9 bis unter 10;1120;557;563
09161;      Ingolstadt (Krfr.St);10 bis unter 11;1150;602;548
09161;      Ingolstadt (Krfr.St);11 bis unter 12;1222;632;590
09161;      Ingolstadt (Krfr.St);12 bis unter 13;1206;629;577
09161;      Ingolstadt (Krfr.St);13 bis unter 14;1125;597;528
09161;      Ingolstadt (Krfr.St);14 bis unter 15;1202;569;633
09161;      Ingolstadt (Krfr.St);15 bis unter 16;1189;617;572
09161;      Ingolstadt (Krfr.St);16 bis unter 17;1260;657;603
09161;      Ingolstadt (Krfr.St);17 bis unter 18;1172;654;518
09161;      Ingolstadt (Krfr.St);18 bis unter 19;1303;722;581
09161;      Ingolstadt (Krfr.St);19 bis unter 20;1418;785;633
09161;      Ingolstadt (Krfr.St);20 bis unter 21;1554;893;661
09161;      Ingolstadt (Krfr.St);21 bis unter 22;1621;893;728
09161;      Ingolstadt (Krfr.St);22 bis unter 23;1663;867;796
09161;      Ingolstadt (Krfr.St);23 bis unter 24;1635;896;739
09161;      Ingolstadt (Krfr.St);24 bis unter 25;1842;962;880
09161;      Ingolstadt (Krfr.St);25 bis unter 26;1912;1021;891
09161;      Ingolstadt (Krfr.St);26 bis unter 27;1984;1056;928
09161;      Ingolstadt (Krfr.St);27 bis unter 28;2205;1152;1053
09161;      Ingolstadt (Krfr.St);28 bis unter 29;2402;1282;1120
09161;      Ingolstadt (Krfr.St);29 bis unter 30;2489;1304;1185
09161;      Ingolstadt (Krfr.St);30 bis unter 31;2487;1371;1116
09161;      Ingolstadt (Krfr.St);31 bis unter 32;2470;1339;1131
09161;      Ingolstadt (Krfr.St);32 bis unter 33;2375;1315;1060
09161;      Ingolstadt (Krfr.St);33 bis unter 34;2268;1261;1007
09161;      Ingolstadt (Krfr.St);34 bis unter 35;2160;1162;998
09161;      Ingolstadt (Krfr.St);35 bis unter 36;2128;1149;979
09161;      Ingolstadt (Krfr.St);36 bis unter 37;2069;1095;974
09161;      Ingolstadt (Krfr.St);37 bis unter 38;2026;1028;998
09161;      Ingolstadt (Krfr.St);38 bis unter 39;1979;1009;970
09161;      Ingolstadt (Krfr.St);39 bis unter 40;1955;1008;947
09161;      Ingolstadt (Krfr.St);40 bis unter 41;1840;979;861
09161;      Ingolstadt (Krfr.St);41 bis unter 42;1852;976;876
09161;      Ingolstadt (Krfr.St);42 bis unter 43;1761;940;821
09161;      Ingolstadt (Krfr.St);43 bis unter 44;1714;840;874
09161;      Ingolstadt (Krfr.St);44 bis unter 45;1767;919;848
09161;      Ingolstadt (Krfr.St);45 bis unter 46;1645;817;828
09161;      Ingolstadt (Krfr.St);46 bis unter 47;1696;863;833
09161;      Ingolstadt (Krfr.St);47 bis unter 48;1867;974;893
09161;      Ingolstadt (Krfr.St);48 bis unter 49;1876;973;903
09161;      Ingolstadt (Krfr.St);49 bis unter 50;1941;1027;914
09161;      Ingolstadt (Krfr.St);50 bis unter 51;2024;1061;963
09161;      Ingolstadt (Krfr.St);51 bis unter 52;2017;1013;1004
09161;      Ingolstadt (Krfr.St);52 bis unter 53;1969;1026;943
09161;      Ingolstadt (Krfr.St);53 bis unter 54;1981;993;988
09161;      Ingolstadt (Krfr.St);54 bis unter 55;1984;1033;951
09161;      Ingolstadt (Krfr.St);55 bis unter 56;1947;985;962
09161;      Ingolstadt (Krfr.St);56 bis unter 57;1820;919;901
09161;      Ingolstadt (Krfr.St);57 bis unter 58;1936;1037;899
09161;      Ingolstadt (Krfr.St);58 bis unter 59;1774;887;887
09161;      Ingolstadt (Krfr.St);59 bis unter 60;1785;897;888
09161;      Ingolstadt (Krfr.St);60 bis unter 61;1694;810;884
09161;      Ingolstadt (Krfr.St);61 bis unter 62;1629;820;809
09161;      Ingolstadt (Krfr.St);62 bis unter 63;1552;757;795
09161;      Ingolstadt (Krfr.St);63 bis unter 64;1496;714;782
09161;      Ingolstadt (Krfr.St);64 bis unter 65;1415;666;749
09161;      Ingolstadt (Krfr.St);65 bis unter 66;1318;615;703
09161;      Ingolstadt (Krfr.St);66 bis unter 67;1363;637;726
09161;      Ingolstadt (Krfr.St);67 bis unter 68;1287;619;668
09161;      Ingolstadt (Krfr.St);68 bis unter 69;1306;589;717
09161;      Ingolstadt (Krfr.St);69 bis unter 70;1198;530;668
09161;      Ingolstadt (Krfr.St);70 bis unter 71;1122;524;598
09161;      Ingolstadt (Krfr.St);71 bis unter 72;1148;542;606
09161;      Ingolstadt (Krfr.St);72 bis unter 73;972;464;508
09161;      Ingolstadt (Krfr.St);73 bis unter 74;874;401;473
09161;      Ingolstadt (Krfr.St);74 bis unter 75;1056;496;560
09161;      Ingolstadt (Krfr.St);75 bis unter 76;1036;446;590
09161;      Ingolstadt (Krfr.St);76 bis unter 77;1094;508;586
09161;      Ingolstadt (Krfr.St);77 bis unter 78;1247;548;699
09161;      Ingolstadt (Krfr.St);78 bis unter 79;1223;547;676
09161;      Ingolstadt (Krfr.St);79 bis unter 80;1230;566;664
09161;      Ingolstadt (Krfr.St);80 bis unter 81;1074;453;621
09161;      Ingolstadt (Krfr.St);81 bis unter 82;967;386;581
09161;      Ingolstadt (Krfr.St);82 bis unter 83;818;333;485
09161;      Ingolstadt (Krfr.St);83 bis unter 84;766;319;447
09161;      Ingolstadt (Krfr.St);84 bis unter 85;679;262;417
09161;      Ingolstadt (Krfr.St);85 bis unter 90;2174;789;1385
09161;      Ingolstadt (Krfr.St);90 bis unter 95;968;288;680
09161;      Ingolstadt (Krfr.St);95 oder älter;218;47;171
09161;      Ingolstadt (Krfr.St);Insgesamt;136981;69252;67729
09162;      München, Landeshauptstadt;unter 1;17192;8879;8313
09162;      München, Landeshauptstadt;1 bis unter 2;16497;8272;8225
09162;      München, Landeshauptstadt;2 bis unter 3;16020;8182;7838
09162;      München, Landeshauptstadt;3 bis unter 4;14826;7505;7321
09162;      München, Landeshauptstadt;4 bis unter 5;14265;7333;6932
09162;      München, Landeshauptstadt;5 bis unter 6;13883;7090;6793
09162;      München, Landeshauptstadt;6 bis unter 7;13129;6710;6419
09162;      München, Landeshauptstadt;7 bis unter 8;12300;6290;6010
09162;      München, Landeshauptstadt;8 bis unter 9;12169;6189;5980
09162;      München, Landeshauptstadt;9 bis unter 10;11944;6150;5794
09162;      München, Landeshauptstadt;10 bis unter 11;12104;6119;5985
09162;      München, Landeshauptstadt;11 bis unter 12;11714;5983;5731
09162;      München, Landeshauptstadt;12 bis unter 13;11328;5885;5443
09162;      München, Landeshauptstadt;13 bis unter 14;11304;5723;5581
09162;      München, Landeshauptstadt;14 bis unter 15;10915;5595;5320
09162;      München, Landeshauptstadt;15 bis unter 16;10971;5627;5344
09162;      München, Landeshauptstadt;16 bis unter 17;10704;5421;5283
09162;      München, Landeshauptstadt;17 bis unter 18;10805;5717;5088
09162;      München, Landeshauptstadt;18 bis unter 19;11853;6025;5828
09162;      München, Landeshauptstadt;19 bis unter 20;13612;6967;6645
09162;      München, Landeshauptstadt;20 bis unter 21;15795;8145;7650
09162;      München, Landeshauptstadt;21 bis unter 22;17437;9063;8374
09162;      München, Landeshauptstadt;22 bis unter 23;18391;9288;9103
09162;      München, Landeshauptstadt;23 bis unter 24;19730;9756;9974
09162;      München, Landeshauptstadt;24 bis unter 25;21299;10412;10887
09162;      München, Landeshauptstadt;25 bis unter 26;23492;11454;12038
09162;      München, Landeshauptstadt;26 bis unter 27;25328;12071;13257
09162;      München, Landeshauptstadt;27 bis unter 28;27278;13292;13986
09162;      München, Landeshauptstadt;28 bis unter 29;29111;14363;14748
09162;      München, Landeshauptstadt;29 bis unter 30;28831;13915;14916
09162;      München, Landeshauptstadt;30 bis unter 31;29853;14797;15056
09162;      München, Landeshauptstadt;31 bis unter 32;28851;14553;14298
09162;      München, Landeshauptstadt;32 bis unter 33;27518;13866;13652
09162;      München, Landeshauptstadt;33 bis unter 34;26380;13284;13096
09162;      München, Landeshauptstadt;34 bis unter 35;25659;12929;12730
09162;      München, Landeshauptstadt;35 bis unter 36;24733;12150;12583
09162;      München, Landeshauptstadt;36 bis unter 37;24809;12366;12443
09162;      München, Landeshauptstadt;37 bis unter 38;24045;11906;12139
09162;      München, Landeshauptstadt;38 bis unter 39;23279;11525;11754
09162;      München, Landeshauptstadt;39 bis unter 40;22120;10955;11165
09162;      München, Landeshauptstadt;40 bis unter 41;21006;10371;10635
09162;      München, Landeshauptstadt;41 bis unter 42;20570;10257;10313
09162;      München, Landeshauptstadt;42 bis unter 43;20136;10030;10106
09162;      München, Landeshauptstadt;43 bis unter 44;19566;9691;9875
09162;      München, Landeshauptstadt;44 bis unter 45;19530;9788;9742
09162;      München, Landeshauptstadt;45 bis unter 46;18674;9454;9220
09162;      München, Landeshauptstadt;46 bis unter 47;19609;9757;9852
09162;      München, Landeshauptstadt;47 bis unter 48;20350;10385;9965
09162;      München, Landeshauptstadt;48 bis unter 49;20525;10455;10070
09162;      München, Landeshauptstadt;49 bis unter 50;21483;11000;10483
09162;      München, Landeshauptstadt;50 bis unter 51;22052;11419;10633
09162;      München, Landeshauptstadt;51 bis unter 52;22191;11340;10851
09162;      München, Landeshauptstadt;52 bis unter 53;21793;11165;10628
09162;      München, Landeshauptstadt;53 bis unter 54;21243;10833;10410
09162;      München, Landeshauptstadt;54 bis unter 55;20952;10445;10507
09162;      München, Landeshauptstadt;55 bis unter 56;20111;10077;10034
09162;      München, Landeshauptstadt;56 bis unter 57;18749;9311;9438
09162;      München, Landeshauptstadt;57 bis unter 58;17918;8807;9111
09162;      München, Landeshauptstadt;58 bis unter 59;17071;8344;8727
09162;      München, Landeshauptstadt;59 bis unter 60;16278;7970;8308
09162;      München, Landeshauptstadt;60 bis unter 61;15324;7373;7951
09162;      München, Landeshauptstadt;61 bis unter 62;14800;7198;7602
09162;      München, Landeshauptstadt;62 bis unter 63;14422;6928;7494
09162;      München, Landeshauptstadt;63 bis unter 64;13650;6364;7286
09162;      München, Landeshauptstadt;64 bis unter 65;12741;5793;6948
09162;      München, Landeshauptstadt;65 bis unter 66;12389;5482;6907
09162;      München, Landeshauptstadt;66 bis unter 67;12749;5634;7115
09162;      München, Landeshauptstadt;67 bis unter 68;11902;5268;6634
09162;      München, Landeshauptstadt;68 bis unter 69;12878;5708;7170
09162;      München, Landeshauptstadt;69 bis unter 70;12819;5803;7016
09162;      München, Landeshauptstadt;70 bis unter 71;12543;5747;6796
09162;      München, Landeshauptstadt;71 bis unter 72;12688;5857;6831
09162;      München, Landeshauptstadt;72 bis unter 73;11603;5222;6381
09162;      München, Landeshauptstadt;73 bis unter 74;10124;4549;5575
09162;      München, Landeshauptstadt;74 bis unter 75;12450;5700;6750
09162;      München, Landeshauptstadt;75 bis unter 76;12446;5595;6851
09162;      München, Landeshauptstadt;76 bis unter 77;11660;5220;6440
09162;      München, Landeshauptstadt;77 bis unter 78;12920;5721;7199
09162;      München, Landeshauptstadt;78 bis unter 79;13088;5658;7430
09162;      München, Landeshauptstadt;79 bis unter 80;12133;5180;6953
09162;      München, Landeshauptstadt;80 bis unter 81;10557;4500;6057
09162;      München, Landeshauptstadt;81 bis unter 82;9523;3960;5563
09162;      München, Landeshauptstadt;82 bis unter 83;8727;3567;5160
09162;      München, Landeshauptstadt;83 bis unter 84;7512;2972;4540
09162;      München, Landeshauptstadt;84 bis unter 85;6564;2627;3937
09162;      München, Landeshauptstadt;85 bis unter 90;20601;7722;12879
09162;      München, Landeshauptstadt;90 bis unter 95;9087;2758;6329
09162;      München, Landeshauptstadt;95 oder älter;2327;551;1776
09162;      München, Landeshauptstadt;Insgesamt;1471508;717308;754200
09163;      Rosenheim (Krfr.St);unter 1;669;371;298
09163;      Rosenheim (Krfr.St);1 bis unter 2;693;376;317
09163;      Rosenheim (Krfr.St);2 bis unter 3;598;323;275
09163;      Rosenheim (Krfr.St);3 bis unter 4;613;324;289
09163;      Rosenheim (Krfr.St);4 bis unter 5;541;271;270
09163;      Rosenheim (Krfr.St);5 bis unter 6;544;280;264
09163;      Rosenheim (Krfr.St);6 bis unter 7;540;287;253
09163;      Rosenheim (Krfr.St);7 bis unter 8;521;237;284
09163;      Rosenheim (Krfr.St);8 bis unter 9;562;296;266
09163;      Rosenheim (Krfr.St);9 bis unter 10;560;292;268
09163;      Rosenheim (Krfr.St);10 bis unter 11;537;261;276
09163;      Rosenheim (Krfr.St);11 bis unter 12;553;273;280
09163;      Rosenheim (Krfr.St);12 bis unter 13;546;281;265
09163;      Rosenheim (Krfr.St);13 bis unter 14;560;275;285
09163;      Rosenheim (Krfr.St);14 bis unter 15;573;303;270
09163;      Rosenheim (Krfr.St);15 bis unter 16;558;306;252
09163;      Rosenheim (Krfr.St);16 bis unter 17;579;299;280
09163;      Rosenheim (Krfr.St);17 bis unter 18;588;310;278
09163;      Rosenheim (Krfr.St);18 bis unter 19;643;330;313
09163;      Rosenheim (Krfr.St);19 bis unter 20;659;332;327
09163;      Rosenheim (Krfr.St);20 bis unter 21;731;395;336
09163;      Rosenheim (Krfr.St);21 bis unter 22;784;403;381
09163;      Rosenheim (Krfr.St);22 bis unter 23;826;427;399
09163;      Rosenheim (Krfr.St);23 bis unter 24;883;461;422
09163;      Rosenheim (Krfr.St);24 bis unter 25;890;424;466
09163;      Rosenheim (Krfr.St);25 bis unter 26;1010;501;509
09163;      Rosenheim (Krfr.St);26 bis unter 27;917;505;412
09163;      Rosenheim (Krfr.St);27 bis unter 28;904;471;433
09163;      Rosenheim (Krfr.St);28 bis unter 29;1056;601;455
09163;      Rosenheim (Krfr.St);29 bis unter 30;985;539;446
09163;      Rosenheim (Krfr.St);30 bis unter 31;1062;549;513
09163;      Rosenheim (Krfr.St);31 bis unter 32;1006;555;451
09163;      Rosenheim (Krfr.St);32 bis unter 33;927;487;440
09163;      Rosenheim (Krfr.St);33 bis unter 34;897;469;428
09163;      Rosenheim (Krfr.St);34 bis unter 35;921;488;433
09163;      Rosenheim (Krfr.St);35 bis unter 36;879;491;388
09163;      Rosenheim (Krfr.St);36 bis unter 37;870;446;424
09163;      Rosenheim (Krfr.St);37 bis unter 38;810;401;409
09163;      Rosenheim (Krfr.St);38 bis unter 39;853;424;429
09163;      Rosenheim (Krfr.St);39 bis unter 40;795;401;394
09163;      Rosenheim (Krfr.St);40 bis unter 41;809;424;385
09163;      Rosenheim (Krfr.St);41 bis unter 42;808;419;389
09163;      Rosenheim (Krfr.St);42 bis unter 43;804;406;398
09163;      Rosenheim (Krfr.St);43 bis unter 44;805;419;386
09163;      Rosenheim (Krfr.St);44 bis unter 45;825;391;434
09163;      Rosenheim (Krfr.St);45 bis unter 46;794;392;402
09163;      Rosenheim (Krfr.St);46 bis unter 47;766;386;380
09163;      Rosenheim (Krfr.St);47 bis unter 48;814;411;403
09163;      Rosenheim (Krfr.St);48 bis unter 49;849;450;399
09163;      Rosenheim (Krfr.St);49 bis unter 50;940;492;448
09163;      Rosenheim (Krfr.St);50 bis unter 51;958;477;481
09163;      Rosenheim (Krfr.St);51 bis unter 52;959;492;467
09163;      Rosenheim (Krfr.St);52 bis unter 53;996;514;482
09163;      Rosenheim (Krfr.St);53 bis unter 54;1025;502;523
09163;      Rosenheim (Krfr.St);54 bis unter 55;1007;502;505
09163;      Rosenheim (Krfr.St);55 bis unter 56;998;511;487
09163;      Rosenheim (Krfr.St);56 bis unter 57;876;426;450
09163;      Rosenheim (Krfr.St);57 bis unter 58;867;427;440
09163;      Rosenheim (Krfr.St);58 bis unter 59;834;413;421
09163;      Rosenheim (Krfr.St);59 bis unter 60;761;383;378
09163;      Rosenheim (Krfr.St);60 bis unter 61;709;354;355
09163;      Rosenheim (Krfr.St);61 bis unter 62;744;382;362
09163;      Rosenheim (Krfr.St);62 bis unter 63;680;328;352
09163;      Rosenheim (Krfr.St);63 bis unter 64;651;303;348
09163;      Rosenheim (Krfr.St);64 bis unter 65;670;295;375
09163;      Rosenheim (Krfr.St);65 bis unter 66;618;267;351
09163;      Rosenheim (Krfr.St);66 bis unter 67;653;276;377
09163;      Rosenheim (Krfr.St);67 bis unter 68;633;295;338
09163;      Rosenheim (Krfr.St);68 bis unter 69;672;298;374
09163;      Rosenheim (Krfr.St);69 bis unter 70;681;312;369
09163;      Rosenheim (Krfr.St);70 bis unter 71;618;283;335
09163;      Rosenheim (Krfr.St);71 bis unter 72;620;274;346
09163;      Rosenheim (Krfr.St);72 bis unter 73;567;246;321
09163;      Rosenheim (Krfr.St);73 bis unter 74;443;208;235
09163;      Rosenheim (Krfr.St);74 bis unter 75;586;257;329
09163;      Rosenheim (Krfr.St);75 bis unter 76;633;282;351
09163;      Rosenheim (Krfr.St);76 bis unter 77;560;256;304
09163;      Rosenheim (Krfr.St);77 bis unter 78;653;283;370
09163;      Rosenheim (Krfr.St);78 bis unter 79;613;266;347
09163;      Rosenheim (Krfr.St);79 bis unter 80;577;244;333
09163;      Rosenheim (Krfr.St);80 bis unter 81;530;225;305
09163;      Rosenheim (Krfr.St);81 bis unter 82;446;195;251
09163;      Rosenheim (Krfr.St);82 bis unter 83;443;165;278
09163;      Rosenheim (Krfr.St);83 bis unter 84;305;118;187
09163;      Rosenheim (Krfr.St);84 bis unter 85;302;110;192
09163;      Rosenheim (Krfr.St);85 bis unter 90;991;353;638
09163;      Rosenheim (Krfr.St);90 bis unter 95;460;123;337
09163;      Rosenheim (Krfr.St);95 oder älter;128;21;107
09163;      Rosenheim (Krfr.St);Insgesamt;63324;31321;32003
KS091;    Kreisfreie Städte Oberbayern;unter 1;19479;10076;9403
KS091;    Kreisfreie Städte Oberbayern;1 bis unter 2;18689;9416;9273
KS091;    Kreisfreie Städte Oberbayern;2 bis unter 3;18060;9242;8818
KS091;    Kreisfreie Städte Oberbayern;3 bis unter 4;16793;8523;8270
KS091;    Kreisfreie Städte Oberbayern;4 bis unter 5;16191;8322;7869
KS091;    Kreisfreie Städte Oberbayern;5 bis unter 6;15748;8059;7689
KS091;    Kreisfreie Städte Oberbayern;6 bis unter 7;14901;7641;7260
KS091;    Kreisfreie Städte Oberbayern;7 bis unter 8;14017;7137;6880
KS091;    Kreisfreie Städte Oberbayern;8 bis unter 9;13954;7132;6822
KS091;    Kreisfreie Städte Oberbayern;9 bis unter 10;13624;6999;6625
KS091;    Kreisfreie Städte Oberbayern;10 bis unter 11;13791;6982;6809
KS091;    Kreisfreie Städte Oberbayern;11 bis unter 12;13489;6888;6601
KS091;    Kreisfreie Städte Oberbayern;12 bis unter 13;13080;6795;6285
KS091;    Kreisfreie Städte Oberbayern;13 bis unter 14;12989;6595;6394
KS091;    Kreisfreie Städte Oberbayern;14 bis unter 15;12690;6467;6223
KS091;    Kreisfreie Städte Oberbayern;15 bis unter 16;12718;6550;6168
KS091;    Kreisfreie Städte Oberbayern;16 bis unter 17;12543;6377;6166
KS091;    Kreisfreie Städte Oberbayern;17 bis unter 18;12565;6681;5884
KS091;    Kreisfreie Städte Oberbayern;18 bis unter 19;13799;7077;6722
KS091;    Kreisfreie Städte Oberbayern;19 bis unter 20;15689;8084;7605
KS091;    Kreisfreie Städte Oberbayern;20 bis unter 21;18080;9433;8647
KS091;    Kreisfreie Städte Oberbayern;21 bis unter 22;19842;10359;9483
KS091;    Kreisfreie Städte Oberbayern;22 bis unter 23;20880;10582;10298
KS091;    Kreisfreie Städte Oberbayern;23 bis unter 24;22248;11113;11135
KS091;    Kreisfreie Städte Oberbayern;24 bis unter 25;24031;11798;12233
KS091;    Kreisfreie Städte Oberbayern;25 bis unter 26;26414;12976;13438
KS091;    Kreisfreie Städte Oberbayern;26 bis unter 27;28229;13632;14597
KS091;    Kreisfreie Städte Oberbayern;27 bis unter 28;30387;14915;15472
KS091;    Kreisfreie Städte Oberbayern;28 bis unter 29;32569;16246;16323
KS091;    Kreisfreie Städte Oberbayern;29 bis unter 30;32305;15758;16547
KS091;    Kreisfreie Städte Oberbayern;30 bis unter 31;33402;16717;16685
KS091;    Kreisfreie Städte Oberbayern;31 bis unter 32;32327;16447;15880
KS091;    Kreisfreie Städte Oberbayern;32 bis unter 33;30820;15668;15152
KS091;    Kreisfreie Städte Oberbayern;33 bis unter 34;29545;15014;14531
KS091;    Kreisfreie Städte Oberbayern;34 bis unter 35;28740;14579;14161
KS091;    Kreisfreie Städte Oberbayern;35 bis unter 36;27740;13790;13950
KS091;    Kreisfreie Städte Oberbayern;36 bis unter 37;27748;13907;13841
KS091;    Kreisfreie Städte Oberbayern;37 bis unter 38;26881;13335;13546
KS091;    Kreisfreie Städte Oberbayern;38 bis unter 39;26111;12958;13153
KS091;    Kreisfreie Städte Oberbayern;39 bis unter 40;24870;12364;12506
KS091;    Kreisfreie Städte Oberbayern;40 bis unter 41;23655;11774;11881
KS091;    Kreisfreie Städte Oberbayern;41 bis unter 42;23230;11652;11578
KS091;    Kreisfreie Städte Oberbayern;42 bis unter 43;22701;11376;11325
KS091;    Kreisfreie Städte Oberbayern;43 bis unter 44;22085;10950;11135
KS091;    Kreisfreie Städte Oberbayern;44 bis unter 45;22122;11098;11024
KS091;    Kreisfreie Städte Oberbayern;45 bis unter 46;21113;10663;10450
KS091;    Kreisfreie Städte Oberbayern;46 bis unter 47;22071;11006;11065
KS091;    Kreisfreie Städte Oberbayern;47 bis unter 48;23031;11770;11261
KS091;    Kreisfreie Städte Oberbayern;48 bis unter 49;23250;11878;11372
KS091;    Kreisfreie Städte Oberbayern;49 bis unter 50;24364;12519;11845
KS091;    Kreisfreie Städte Oberbayern;50 bis unter 51;25034;12957;12077
KS091;    Kreisfreie Städte Oberbayern;51 bis unter 52;25167;12845;12322
KS091;    Kreisfreie Städte Oberbayern;52 bis unter 53;24758;12705;12053
KS091;    Kreisfreie Städte Oberbayern;53 bis unter 54;24249;12328;11921
KS091;    Kreisfreie Städte Oberbayern;54 bis unter 55;23943;11980;11963
KS091;    Kreisfreie Städte Oberbayern;55 bis unter 56;23056;11573;11483
KS091;    Kreisfreie Städte Oberbayern;56 bis unter 57;21445;10656;10789
KS091;    Kreisfreie Städte Oberbayern;57 bis unter 58;20721;10271;10450
KS091;    Kreisfreie Städte Oberbayern;58 bis unter 59;19679;9644;10035
KS091;    Kreisfreie Städte Oberbayern;59 bis unter 60;18824;9250;9574
KS091;    Kreisfreie Städte Oberbayern;60 bis unter 61;17727;8537;9190
KS091;    Kreisfreie Städte Oberbayern;61 bis unter 62;17173;8400;8773
KS091;    Kreisfreie Städte Oberbayern;62 bis unter 63;16654;8013;8641
KS091;    Kreisfreie Städte Oberbayern;63 bis unter 64;15797;7381;8416
KS091;    Kreisfreie Städte Oberbayern;64 bis unter 65;14826;6754;8072
KS091;    Kreisfreie Städte Oberbayern;65 bis unter 66;14325;6364;7961
KS091;    Kreisfreie Städte Oberbayern;66 bis unter 67;14765;6547;8218
KS091;    Kreisfreie Städte Oberbayern;67 bis unter 68;13822;6182;7640
KS091;    Kreisfreie Städte Oberbayern;68 bis unter 69;14856;6595;8261
KS091;    Kreisfreie Städte Oberbayern;69 bis unter 70;14698;6645;8053
KS091;    Kreisfreie Städte Oberbayern;70 bis unter 71;14283;6554;7729
KS091;    Kreisfreie Städte Oberbayern;71 bis unter 72;14456;6673;7783
KS091;    Kreisfreie Städte Oberbayern;72 bis unter 73;13142;5932;7210
KS091;    Kreisfreie Städte Oberbayern;73 bis unter 74;11441;5158;6283
KS091;    Kreisfreie Städte Oberbayern;74 bis unter 75;14092;6453;7639
KS091;    Kreisfreie Städte Oberbayern;75 bis unter 76;14115;6323;7792
KS091;    Kreisfreie Städte Oberbayern;76 bis unter 77;13314;5984;7330
KS091;    Kreisfreie Städte Oberbayern;77 bis unter 78;14820;6552;8268
KS091;    Kreisfreie Städte Oberbayern;78 bis unter 79;14924;6471;8453
KS091;    Kreisfreie Städte Oberbayern;79 bis unter 80;13940;5990;7950
KS091;    Kreisfreie Städte Oberbayern;80 bis unter 81;12161;5178;6983
KS091;    Kreisfreie Städte Oberbayern;81 bis unter 82;10936;4541;6395
KS091;    Kreisfreie Städte Oberbayern;82 bis unter 83;9988;4065;5923
KS091;    Kreisfreie Städte Oberbayern;83 bis unter 84;8583;3409;5174
KS091;    Kreisfreie Städte Oberbayern;84 bis unter 85;7545;2999;4546
KS091;    Kreisfreie Städte Oberbayern;85 bis unter 90;23766;8864;14902
KS091;    Kreisfreie Städte Oberbayern;90 bis unter 95;10515;3169;7346
KS091;    Kreisfreie Städte Oberbayern;95 oder älter;2673;619;2054
KS091;    Kreisfreie Städte Oberbayern;Insgesamt;1671813;817881;853932
09171;      Altötting (Lkr);unter 1;1117;555;562
09171;      Altötting (Lkr);1 bis unter 2;1084;569;515
09171;      Altötting (Lkr);2 bis unter 3;1111;544;567
09171;      Altötting (Lkr);3 bis unter 4;1033;502;531
09171;      Altötting (Lkr);4 bis unter 5;1065;557;508
09171;      Altötting (Lkr);5 bis unter 6;952;458;494
09171;      Altötting (Lkr);6 bis unter 7;1029;503;526
09171;      Altötting (Lkr);7 bis unter 8;1016;525;491
09171;      Altötting (Lkr);8 bis unter 9;1004;536;468
09171;      Altötting (Lkr);9 bis unter 10;944;490;454
09171;      Altötting (Lkr);10 bis unter 11;1018;509;509
09171;      Altötting (Lkr);11 bis unter 12;997;529;468
09171;      Altötting (Lkr);12 bis unter 13;1011;520;491
09171;      Altötting (Lkr);13 bis unter 14;1036;536;500
09171;      Altötting (Lkr);14 bis unter 15;1080;542;538
09171;      Altötting (Lkr);15 bis unter 16;1106;573;533
09171;      Altötting (Lkr);16 bis unter 17;1098;578;520
09171;      Altötting (Lkr);17 bis unter 18;1085;540;545
09171;      Altötting (Lkr);18 bis unter 19;1108;540;568
09171;      Altötting (Lkr);19 bis unter 20;1207;656;551
09171;      Altötting (Lkr);20 bis unter 21;1207;670;537
09171;      Altötting (Lkr);21 bis unter 22;1234;647;587
09171;      Altötting (Lkr);22 bis unter 23;1216;639;577
09171;      Altötting (Lkr);23 bis unter 24;1213;643;570
09171;      Altötting (Lkr);24 bis unter 25;1271;711;560
09171;      Altötting (Lkr);25 bis unter 26;1247;607;640
09171;      Altötting (Lkr);26 bis unter 27;1313;727;586
09171;      Altötting (Lkr);27 bis unter 28;1306;699;607
09171;      Altötting (Lkr);28 bis unter 29;1304;671;633
09171;      Altötting (Lkr);29 bis unter 30;1323;703;620
09171;      Altötting (Lkr);30 bis unter 31;1296;682;614
09171;      Altötting (Lkr);31 bis unter 32;1289;678;611
09171;      Altötting (Lkr);32 bis unter 33;1350;688;662
09171;      Altötting (Lkr);33 bis unter 34;1336;713;623
09171;      Altötting (Lkr);34 bis unter 35;1281;647;634
09171;      Altötting (Lkr);35 bis unter 36;1332;717;615
09171;      Altötting (Lkr);36 bis unter 37;1457;720;737
09171;      Altötting (Lkr);37 bis unter 38;1373;709;664
09171;      Altötting (Lkr);38 bis unter 39;1440;727;713
09171;      Altötting (Lkr);39 bis unter 40;1321;692;629
09171;      Altötting (Lkr);40 bis unter 41;1212;599;613
09171;      Altötting (Lkr);41 bis unter 42;1243;641;602
09171;      Altötting (Lkr);42 bis unter 43;1257;651;606
09171;      Altötting (Lkr);43 bis unter 44;1222;642;580
09171;      Altötting (Lkr);44 bis unter 45;1306;655;651
09171;      Altötting (Lkr);45 bis unter 46;1323;664;659
09171;      Altötting (Lkr);46 bis unter 47;1444;737;707
09171;      Altötting (Lkr);47 bis unter 48;1535;798;737
09171;      Altötting (Lkr);48 bis unter 49;1585;806;779
09171;      Altötting (Lkr);49 bis unter 50;1709;877;832
09171;      Altötting (Lkr);50 bis unter 51;1808;952;856
09171;      Altötting (Lkr);51 bis unter 52;1889;962;927
09171;      Altötting (Lkr);52 bis unter 53;1851;901;950
09171;      Altötting (Lkr);53 bis unter 54;1823;933;890
09171;      Altötting (Lkr);54 bis unter 55;1904;929;975
09171;      Altötting (Lkr);55 bis unter 56;1941;975;966
09171;      Altötting (Lkr);56 bis unter 57;1855;942;913
09171;      Altötting (Lkr);57 bis unter 58;1834;951;883
09171;      Altötting (Lkr);58 bis unter 59;1802;904;898
09171;      Altötting (Lkr);59 bis unter 60;1689;834;855
09171;      Altötting (Lkr);60 bis unter 61;1693;826;867
09171;      Altötting (Lkr);61 bis unter 62;1550;782;768
09171;      Altötting (Lkr);62 bis unter 63;1454;724;730
09171;      Altötting (Lkr);63 bis unter 64;1450;666;784
09171;      Altötting (Lkr);64 bis unter 65;1423;671;752
09171;      Altötting (Lkr);65 bis unter 66;1318;643;675
09171;      Altötting (Lkr);66 bis unter 67;1299;641;658
09171;      Altötting (Lkr);67 bis unter 68;1289;608;681
09171;      Altötting (Lkr);68 bis unter 69;1321;615;706
09171;      Altötting (Lkr);69 bis unter 70;1217;561;656
09171;      Altötting (Lkr);70 bis unter 71;1139;534;605
09171;      Altötting (Lkr);71 bis unter 72;1120;518;602
09171;      Altötting (Lkr);72 bis unter 73;997;450;547
09171;      Altötting (Lkr);73 bis unter 74;772;338;434
09171;      Altötting (Lkr);74 bis unter 75;951;431;520
09171;      Altötting (Lkr);75 bis unter 76;910;417;493
09171;      Altötting (Lkr);76 bis unter 77;961;424;537
09171;      Altötting (Lkr);77 bis unter 78;1152;527;625
09171;      Altötting (Lkr);78 bis unter 79;1255;561;694
09171;      Altötting (Lkr);79 bis unter 80;1128;479;649
09171;      Altötting (Lkr);80 bis unter 81;1003;422;581
09171;      Altötting (Lkr);81 bis unter 82;915;378;537
09171;      Altötting (Lkr);82 bis unter 83;798;308;490
09171;      Altötting (Lkr);83 bis unter 84;736;295;441
09171;      Altötting (Lkr);84 bis unter 85;630;265;365
09171;      Altötting (Lkr);85 bis unter 90;2151;754;1397
09171;      Altötting (Lkr);90 bis unter 95;914;266;648
09171;      Altötting (Lkr);95 oder älter;222;33;189
09171;      Altötting (Lkr);Insgesamt;111210;54942;56268
09172;      Berchtesgadener Land (Lkr);unter 1;976;492;484
09172;      Berchtesgadener Land (Lkr);1 bis unter 2;1022;501;521
09172;      Berchtesgadener Land (Lkr);2 bis unter 3;940;510;430
09172;      Berchtesgadener Land (Lkr);3 bis unter 4;951;496;455
09172;      Berchtesgadener Land (Lkr);4 bis unter 5;925;479;446
09172;      Berchtesgadener Land (Lkr);5 bis unter 6;863;461;402
09172;      Berchtesgadener Land (Lkr);6 bis unter 7;889;457;432
09172;      Berchtesgadener Land (Lkr);7 bis unter 8;839;415;424
09172;      Berchtesgadener Land (Lkr);8 bis unter 9;861;428;433
09172;      Berchtesgadener Land (Lkr);9 bis unter 10;843;431;412
09172;      Berchtesgadener Land (Lkr);10 bis unter 11;820;417;403
09172;      Berchtesgadener Land (Lkr);11 bis unter 12;927;474;453
09172;      Berchtesgadener Land (Lkr);12 bis unter 13;900;481;419
09172;      Berchtesgadener Land (Lkr);13 bis unter 14;888;471;417
09172;      Berchtesgadener Land (Lkr);14 bis unter 15;933;478;455
09172;      Berchtesgadener Land (Lkr);15 bis unter 16;878;450;428
09172;      Berchtesgadener Land (Lkr);16 bis unter 17;923;459;464
09172;      Berchtesgadener Land (Lkr);17 bis unter 18;948;492;456
09172;      Berchtesgadener Land (Lkr);18 bis unter 19;1039;530;509
09172;      Berchtesgadener Land (Lkr);19 bis unter 20;1099;599;500
09172;      Berchtesgadener Land (Lkr);20 bis unter 21;1161;643;518
09172;      Berchtesgadener Land (Lkr);21 bis unter 22;1240;662;578
09172;      Berchtesgadener Land (Lkr);22 bis unter 23;1213;643;570
09172;      Berchtesgadener Land (Lkr);23 bis unter 24;1211;639;572
09172;      Berchtesgadener Land (Lkr);24 bis unter 25;1240;674;566
09172;      Berchtesgadener Land (Lkr);25 bis unter 26;1270;700;570
09172;      Berchtesgadener Land (Lkr);26 bis unter 27;1352;704;648
09172;      Berchtesgadener Land (Lkr);27 bis unter 28;1392;763;629
09172;      Berchtesgadener Land (Lkr);28 bis unter 29;1379;730;649
09172;      Berchtesgadener Land (Lkr);29 bis unter 30;1330;705;625
09172;      Berchtesgadener Land (Lkr);30 bis unter 31;1401;738;663
09172;      Berchtesgadener Land (Lkr);31 bis unter 32;1437;752;685
09172;      Berchtesgadener Land (Lkr);32 bis unter 33;1349;730;619
09172;      Berchtesgadener Land (Lkr);33 bis unter 34;1349;664;685
09172;      Berchtesgadener Land (Lkr);34 bis unter 35;1315;695;620
09172;      Berchtesgadener Land (Lkr);35 bis unter 36;1345;696;649
09172;      Berchtesgadener Land (Lkr);36 bis unter 37;1382;720;662
09172;      Berchtesgadener Land (Lkr);37 bis unter 38;1251;643;608
09172;      Berchtesgadener Land (Lkr);38 bis unter 39;1257;645;612
09172;      Berchtesgadener Land (Lkr);39 bis unter 40;1263;640;623
09172;      Berchtesgadener Land (Lkr);40 bis unter 41;1248;600;648
09172;      Berchtesgadener Land (Lkr);41 bis unter 42;1227;633;594
09172;      Berchtesgadener Land (Lkr);42 bis unter 43;1185;582;603
09172;      Berchtesgadener Land (Lkr);43 bis unter 44;1172;556;616
09172;      Berchtesgadener Land (Lkr);44 bis unter 45;1210;627;583
09172;      Berchtesgadener Land (Lkr);45 bis unter 46;1166;595;571
09172;      Berchtesgadener Land (Lkr);46 bis unter 47;1185;588;597
09172;      Berchtesgadener Land (Lkr);47 bis unter 48;1406;707;699
09172;      Berchtesgadener Land (Lkr);48 bis unter 49;1449;697;752
09172;      Berchtesgadener Land (Lkr);49 bis unter 50;1616;826;790
09172;      Berchtesgadener Land (Lkr);50 bis unter 51;1697;862;835
09172;      Berchtesgadener Land (Lkr);51 bis unter 52;1773;913;860
09172;      Berchtesgadener Land (Lkr);52 bis unter 53;1754;898;856
09172;      Berchtesgadener Land (Lkr);53 bis unter 54;1670;816;854
09172;      Berchtesgadener Land (Lkr);54 bis unter 55;1770;883;887
09172;      Berchtesgadener Land (Lkr);55 bis unter 56;1766;846;920
09172;      Berchtesgadener Land (Lkr);56 bis unter 57;1666;808;858
09172;      Berchtesgadener Land (Lkr);57 bis unter 58;1593;775;818
09172;      Berchtesgadener Land (Lkr);58 bis unter 59;1573;781;792
09172;      Berchtesgadener Land (Lkr);59 bis unter 60;1518;749;769
09172;      Berchtesgadener Land (Lkr);60 bis unter 61;1363;687;676
09172;      Berchtesgadener Land (Lkr);61 bis unter 62;1388;658;730
09172;      Berchtesgadener Land (Lkr);62 bis unter 63;1277;639;638
09172;      Berchtesgadener Land (Lkr);63 bis unter 64;1256;591;665
09172;      Berchtesgadener Land (Lkr);64 bis unter 65;1193;587;606
09172;      Berchtesgadener Land (Lkr);65 bis unter 66;1213;546;667
09172;      Berchtesgadener Land (Lkr);66 bis unter 67;1186;519;667
09172;      Berchtesgadener Land (Lkr);67 bis unter 68;1154;559;595
09172;      Berchtesgadener Land (Lkr);68 bis unter 69;1264;584;680
09172;      Berchtesgadener Land (Lkr);69 bis unter 70;1216;556;660
09172;      Berchtesgadener Land (Lkr);70 bis unter 71;1150;541;609
09172;      Berchtesgadener Land (Lkr);71 bis unter 72;1250;572;678
09172;      Berchtesgadener Land (Lkr);72 bis unter 73;1087;475;612
09172;      Berchtesgadener Land (Lkr);73 bis unter 74;875;389;486
09172;      Berchtesgadener Land (Lkr);74 bis unter 75;1108;531;577
09172;      Berchtesgadener Land (Lkr);75 bis unter 76;1112;508;604
09172;      Berchtesgadener Land (Lkr);76 bis unter 77;1082;505;577
09172;      Berchtesgadener Land (Lkr);77 bis unter 78;1274;569;705
09172;      Berchtesgadener Land (Lkr);78 bis unter 79;1296;581;715
09172;      Berchtesgadener Land (Lkr);79 bis unter 80;1228;513;715
09172;      Berchtesgadener Land (Lkr);80 bis unter 81;1073;475;598
09172;      Berchtesgadener Land (Lkr);81 bis unter 82;916;391;525
09172;      Berchtesgadener Land (Lkr);82 bis unter 83;840;347;493
09172;      Berchtesgadener Land (Lkr);83 bis unter 84;746;304;442
09172;      Berchtesgadener Land (Lkr);84 bis unter 85;633;234;399
09172;      Berchtesgadener Land (Lkr);85 bis unter 90;2049;757;1292
09172;      Berchtesgadener Land (Lkr);90 bis unter 95;937;283;654
09172;      Berchtesgadener Land (Lkr);95 oder älter;311;57;254
09172;      Berchtesgadener Land (Lkr);Insgesamt;105722;52007;53715
09173;      Bad Tölz-Wolfratshausen (Lkr);unter 1;1314;651;663
09173;      Bad Tölz-Wolfratshausen (Lkr);1 bis unter 2;1287;648;639
09173;      Bad Tölz-Wolfratshausen (Lkr);2 bis unter 3;1291;680;611
09173;      Bad Tölz-Wolfratshausen (Lkr);3 bis unter 4;1237;626;611
09173;      Bad Tölz-Wolfratshausen (Lkr);4 bis unter 5;1216;608;608
09173;      Bad Tölz-Wolfratshausen (Lkr);5 bis unter 6;1190;660;530
09173;      Bad Tölz-Wolfratshausen (Lkr);6 bis unter 7;1188;624;564
09173;      Bad Tölz-Wolfratshausen (Lkr);7 bis unter 8;1103;554;549
09173;      Bad Tölz-Wolfratshausen (Lkr);8 bis unter 9;1213;653;560
09173;      Bad Tölz-Wolfratshausen (Lkr);9 bis unter 10;1133;588;545
09173;      Bad Tölz-Wolfratshausen (Lkr);10 bis unter 11;1227;650;577
09173;      Bad Tölz-Wolfratshausen (Lkr);11 bis unter 12;1183;589;594
09173;      Bad Tölz-Wolfratshausen (Lkr);12 bis unter 13;1169;611;558
09173;      Bad Tölz-Wolfratshausen (Lkr);13 bis unter 14;1229;658;571
09173;      Bad Tölz-Wolfratshausen (Lkr);14 bis unter 15;1237;617;620
09173;      Bad Tölz-Wolfratshausen (Lkr);15 bis unter 16;1223;607;616
09173;      Bad Tölz-Wolfratshausen (Lkr);16 bis unter 17;1289;652;637
09173;      Bad Tölz-Wolfratshausen (Lkr);17 bis unter 18;1337;689;648
09173;      Bad Tölz-Wolfratshausen (Lkr);18 bis unter 19;1343;687;656
09173;      Bad Tölz-Wolfratshausen (Lkr);19 bis unter 20;1273;684;589
09173;      Bad Tölz-Wolfratshausen (Lkr);20 bis unter 21;1428;770;658
09173;      Bad Tölz-Wolfratshausen (Lkr);21 bis unter 22;1482;785;697
09173;      Bad Tölz-Wolfratshausen (Lkr);22 bis unter 23;1395;767;628
09173;      Bad Tölz-Wolfratshausen (Lkr);23 bis unter 24;1399;727;672
09173;      Bad Tölz-Wolfratshausen (Lkr);24 bis unter 25;1420;747;673
09173;      Bad Tölz-Wolfratshausen (Lkr);25 bis unter 26;1367;728;639
09173;      Bad Tölz-Wolfratshausen (Lkr);26 bis unter 27;1419;793;626
09173;      Bad Tölz-Wolfratshausen (Lkr);27 bis unter 28;1400;731;669
09173;      Bad Tölz-Wolfratshausen (Lkr);28 bis unter 29;1506;807;699
09173;      Bad Tölz-Wolfratshausen (Lkr);29 bis unter 30;1510;762;748
09173;      Bad Tölz-Wolfratshausen (Lkr);30 bis unter 31;1494;756;738
09173;      Bad Tölz-Wolfratshausen (Lkr);31 bis unter 32;1540;810;730
09173;      Bad Tölz-Wolfratshausen (Lkr);32 bis unter 33;1503;763;740
09173;      Bad Tölz-Wolfratshausen (Lkr);33 bis unter 34;1455;722;733
09173;      Bad Tölz-Wolfratshausen (Lkr);34 bis unter 35;1442;700;742
09173;      Bad Tölz-Wolfratshausen (Lkr);35 bis unter 36;1513;759;754
09173;      Bad Tölz-Wolfratshausen (Lkr);36 bis unter 37;1544;779;765
09173;      Bad Tölz-Wolfratshausen (Lkr);37 bis unter 38;1545;758;787
09173;      Bad Tölz-Wolfratshausen (Lkr);38 bis unter 39;1640;791;849
09173;      Bad Tölz-Wolfratshausen (Lkr);39 bis unter 40;1552;778;774
09173;      Bad Tölz-Wolfratshausen (Lkr);40 bis unter 41;1550;780;770
09173;      Bad Tölz-Wolfratshausen (Lkr);41 bis unter 42;1530;744;786
09173;      Bad Tölz-Wolfratshausen (Lkr);42 bis unter 43;1533;761;772
09173;      Bad Tölz-Wolfratshausen (Lkr);43 bis unter 44;1545;768;777
09173;      Bad Tölz-Wolfratshausen (Lkr);44 bis unter 45;1486;736;750
09173;      Bad Tölz-Wolfratshausen (Lkr);45 bis unter 46;1516;748;768
09173;      Bad Tölz-Wolfratshausen (Lkr);46 bis unter 47;1637;775;862
09173;      Bad Tölz-Wolfratshausen (Lkr);47 bis unter 48;1812;877;935
09173;      Bad Tölz-Wolfratshausen (Lkr);48 bis unter 49;1894;928;966
09173;      Bad Tölz-Wolfratshausen (Lkr);49 bis unter 50;2082;1009;1073
09173;      Bad Tölz-Wolfratshausen (Lkr);50 bis unter 51;2142;1061;1081
09173;      Bad Tölz-Wolfratshausen (Lkr);51 bis unter 52;2360;1191;1169
09173;      Bad Tölz-Wolfratshausen (Lkr);52 bis unter 53;2293;1121;1172
09173;      Bad Tölz-Wolfratshausen (Lkr);53 bis unter 54;2280;1174;1106
09173;      Bad Tölz-Wolfratshausen (Lkr);54 bis unter 55;2272;1144;1128
09173;      Bad Tölz-Wolfratshausen (Lkr);55 bis unter 56;2170;1105;1065
09173;      Bad Tölz-Wolfratshausen (Lkr);56 bis unter 57;2037;1002;1035
09173;      Bad Tölz-Wolfratshausen (Lkr);57 bis unter 58;2005;992;1013
09173;      Bad Tölz-Wolfratshausen (Lkr);58 bis unter 59;1936;979;957
09173;      Bad Tölz-Wolfratshausen (Lkr);59 bis unter 60;1892;954;938
09173;      Bad Tölz-Wolfratshausen (Lkr);60 bis unter 61;1755;882;873
09173;      Bad Tölz-Wolfratshausen (Lkr);61 bis unter 62;1682;824;858
09173;      Bad Tölz-Wolfratshausen (Lkr);62 bis unter 63;1636;800;836
09173;      Bad Tölz-Wolfratshausen (Lkr);63 bis unter 64;1381;677;704
09173;      Bad Tölz-Wolfratshausen (Lkr);64 bis unter 65;1420;700;720
09173;      Bad Tölz-Wolfratshausen (Lkr);65 bis unter 66;1417;658;759
09173;      Bad Tölz-Wolfratshausen (Lkr);66 bis unter 67;1379;651;728
09173;      Bad Tölz-Wolfratshausen (Lkr);67 bis unter 68;1316;627;689
09173;      Bad Tölz-Wolfratshausen (Lkr);68 bis unter 69;1329;611;718
09173;      Bad Tölz-Wolfratshausen (Lkr);69 bis unter 70;1399;622;777
09173;      Bad Tölz-Wolfratshausen (Lkr);70 bis unter 71;1225;579;646
09173;      Bad Tölz-Wolfratshausen (Lkr);71 bis unter 72;1271;623;648
09173;      Bad Tölz-Wolfratshausen (Lkr);72 bis unter 73;1092;490;602
09173;      Bad Tölz-Wolfratshausen (Lkr);73 bis unter 74;952;441;511
09173;      Bad Tölz-Wolfratshausen (Lkr);74 bis unter 75;1197;573;624
09173;      Bad Tölz-Wolfratshausen (Lkr);75 bis unter 76;1250;584;666
09173;      Bad Tölz-Wolfratshausen (Lkr);76 bis unter 77;1237;572;665
09173;      Bad Tölz-Wolfratshausen (Lkr);77 bis unter 78;1355;602;753
09173;      Bad Tölz-Wolfratshausen (Lkr);78 bis unter 79;1414;642;772
09173;      Bad Tölz-Wolfratshausen (Lkr);79 bis unter 80;1351;615;736
09173;      Bad Tölz-Wolfratshausen (Lkr);80 bis unter 81;1120;490;630
09173;      Bad Tölz-Wolfratshausen (Lkr);81 bis unter 82;991;420;571
09173;      Bad Tölz-Wolfratshausen (Lkr);82 bis unter 83;886;392;494
09173;      Bad Tölz-Wolfratshausen (Lkr);83 bis unter 84;801;334;467
09173;      Bad Tölz-Wolfratshausen (Lkr);84 bis unter 85;670;277;393
09173;      Bad Tölz-Wolfratshausen (Lkr);85 bis unter 90;2222;859;1363
09173;      Bad Tölz-Wolfratshausen (Lkr);90 bis unter 95;987;313;674
09173;      Bad Tölz-Wolfratshausen (Lkr);95 oder älter;284;55;229
09173;      Bad Tölz-Wolfratshausen (Lkr);Insgesamt;127227;62731;64496
09174;      Dachau (Lkr);unter 1;1629;832;797
09174;      Dachau (Lkr);1 bis unter 2;1592;815;777
09174;      Dachau (Lkr);2 bis unter 3;1615;841;774
09174;      Dachau (Lkr);3 bis unter 4;1526;755;771
09174;      Dachau (Lkr);4 bis unter 5;1511;820;691
09174;      Dachau (Lkr);5 bis unter 6;1536;807;729
09174;      Dachau (Lkr);6 bis unter 7;1488;799;689
09174;      Dachau (Lkr);7 bis unter 8;1497;770;727
09174;      Dachau (Lkr);8 bis unter 9;1514;768;746
09174;      Dachau (Lkr);9 bis unter 10;1359;655;704
09174;      Dachau (Lkr);10 bis unter 11;1479;744;735
09174;      Dachau (Lkr);11 bis unter 12;1524;797;727
09174;      Dachau (Lkr);12 bis unter 13;1447;749;698
09174;      Dachau (Lkr);13 bis unter 14;1408;711;697
09174;      Dachau (Lkr);14 bis unter 15;1524;751;773
09174;      Dachau (Lkr);15 bis unter 16;1457;765;692
09174;      Dachau (Lkr);16 bis unter 17;1486;732;754
09174;      Dachau (Lkr);17 bis unter 18;1560;825;735
09174;      Dachau (Lkr);18 bis unter 19;1503;817;686
09174;      Dachau (Lkr);19 bis unter 20;1570;847;723
09174;      Dachau (Lkr);20 bis unter 21;1784;974;810
09174;      Dachau (Lkr);21 bis unter 22;1786;991;795
09174;      Dachau (Lkr);22 bis unter 23;1779;949;830
09174;      Dachau (Lkr);23 bis unter 24;1783;953;830
09174;      Dachau (Lkr);24 bis unter 25;1724;925;799
09174;      Dachau (Lkr);25 bis unter 26;1826;956;870
09174;      Dachau (Lkr);26 bis unter 27;1868;973;895
09174;      Dachau (Lkr);27 bis unter 28;1824;1006;818
09174;      Dachau (Lkr);28 bis unter 29;1999;1067;932
09174;      Dachau (Lkr);29 bis unter 30;1917;990;927
09174;      Dachau (Lkr);30 bis unter 31;2104;1090;1014
09174;      Dachau (Lkr);31 bis unter 32;1987;1008;979
09174;      Dachau (Lkr);32 bis unter 33;2039;1057;982
09174;      Dachau (Lkr);33 bis unter 34;2056;1044;1012
09174;      Dachau (Lkr);34 bis unter 35;2065;1036;1029
09174;      Dachau (Lkr);35 bis unter 36;2008;1013;995
09174;      Dachau (Lkr);36 bis unter 37;2233;1144;1089
09174;      Dachau (Lkr);37 bis unter 38;2215;1126;1089
09174;      Dachau (Lkr);38 bis unter 39;2256;1150;1106
09174;      Dachau (Lkr);39 bis unter 40;2155;1097;1058
09174;      Dachau (Lkr);40 bis unter 41;2153;1074;1079
09174;      Dachau (Lkr);41 bis unter 42;2133;1084;1049
09174;      Dachau (Lkr);42 bis unter 43;2058;1031;1027
09174;      Dachau (Lkr);43 bis unter 44;2002;999;1003
09174;      Dachau (Lkr);44 bis unter 45;1975;993;982
09174;      Dachau (Lkr);45 bis unter 46;1926;949;977
09174;      Dachau (Lkr);46 bis unter 47;2119;1099;1020
09174;      Dachau (Lkr);47 bis unter 48;2291;1174;1117
09174;      Dachau (Lkr);48 bis unter 49;2325;1187;1138
09174;      Dachau (Lkr);49 bis unter 50;2535;1281;1254
09174;      Dachau (Lkr);50 bis unter 51;2673;1371;1302
09174;      Dachau (Lkr);51 bis unter 52;2777;1362;1415
09174;      Dachau (Lkr);52 bis unter 53;2743;1397;1346
09174;      Dachau (Lkr);53 bis unter 54;2586;1321;1265
09174;      Dachau (Lkr);54 bis unter 55;2690;1386;1304
09174;      Dachau (Lkr);55 bis unter 56;2588;1303;1285
09174;      Dachau (Lkr);56 bis unter 57;2409;1229;1180
09174;      Dachau (Lkr);57 bis unter 58;2412;1213;1199
09174;      Dachau (Lkr);58 bis unter 59;2250;1132;1118
09174;      Dachau (Lkr);59 bis unter 60;2128;1106;1022
09174;      Dachau (Lkr);60 bis unter 61;2058;1050;1008
09174;      Dachau (Lkr);61 bis unter 62;1901;934;967
09174;      Dachau (Lkr);62 bis unter 63;1827;936;891
09174;      Dachau (Lkr);63 bis unter 64;1686;875;811
09174;      Dachau (Lkr);64 bis unter 65;1616;793;823
09174;      Dachau (Lkr);65 bis unter 66;1536;737;799
09174;      Dachau (Lkr);66 bis unter 67;1505;709;796
09174;      Dachau (Lkr);67 bis unter 68;1443;672;771
09174;      Dachau (Lkr);68 bis unter 69;1500;720;780
09174;      Dachau (Lkr);69 bis unter 70;1416;644;772
09174;      Dachau (Lkr);70 bis unter 71;1441;670;771
09174;      Dachau (Lkr);71 bis unter 72;1395;675;720
09174;      Dachau (Lkr);72 bis unter 73;1255;590;665
09174;      Dachau (Lkr);73 bis unter 74;1008;465;543
09174;      Dachau (Lkr);74 bis unter 75;1245;594;651
09174;      Dachau (Lkr);75 bis unter 76;1187;576;611
09174;      Dachau (Lkr);76 bis unter 77;1210;578;632
09174;      Dachau (Lkr);77 bis unter 78;1376;642;734
09174;      Dachau (Lkr);78 bis unter 79;1403;648;755
09174;      Dachau (Lkr);79 bis unter 80;1386;637;749
09174;      Dachau (Lkr);80 bis unter 81;1217;549;668
09174;      Dachau (Lkr);81 bis unter 82;967;402;565
09174;      Dachau (Lkr);82 bis unter 83;923;394;529
09174;      Dachau (Lkr);83 bis unter 84;845;321;524
09174;      Dachau (Lkr);84 bis unter 85;670;307;363
09174;      Dachau (Lkr);85 bis unter 90;2260;854;1406
09174;      Dachau (Lkr);90 bis unter 95;942;257;685
09174;      Dachau (Lkr);95 oder älter;260;51;209
09174;      Dachau (Lkr);Insgesamt;153884;77120;76764
09175;      Ebersberg (Lkr);unter 1;1392;724;668
09175;      Ebersberg (Lkr);1 bis unter 2;1414;703;711
09175;      Ebersberg (Lkr);2 bis unter 3;1499;766;733
09175;      Ebersberg (Lkr);3 bis unter 4;1445;729;716
09175;      Ebersberg (Lkr);4 bis unter 5;1625;836;789
09175;      Ebersberg (Lkr);5 bis unter 6;1533;778;755
09175;      Ebersberg (Lkr);6 bis unter 7;1473;760;713
09175;      Ebersberg (Lkr);7 bis unter 8;1401;758;643
09175;      Ebersberg (Lkr);8 bis unter 9;1488;748;740
09175;      Ebersberg (Lkr);9 bis unter 10;1480;733;747
09175;      Ebersberg (Lkr);10 bis unter 11;1455;754;701
09175;      Ebersberg (Lkr);11 bis unter 12;1491;798;693
09175;      Ebersberg (Lkr);12 bis unter 13;1450;753;697
09175;      Ebersberg (Lkr);13 bis unter 14;1478;786;692
09175;      Ebersberg (Lkr);14 bis unter 15;1483;766;717
09175;      Ebersberg (Lkr);15 bis unter 16;1371;711;660
09175;      Ebersberg (Lkr);16 bis unter 17;1468;743;725
09175;      Ebersberg (Lkr);17 bis unter 18;1559;804;755
09175;      Ebersberg (Lkr);18 bis unter 19;1564;824;740
09175;      Ebersberg (Lkr);19 bis unter 20;1580;860;720
09175;      Ebersberg (Lkr);20 bis unter 21;1639;881;758
09175;      Ebersberg (Lkr);21 bis unter 22;1708;950;758
09175;      Ebersberg (Lkr);22 bis unter 23;1610;901;709
09175;      Ebersberg (Lkr);23 bis unter 24;1527;795;732
09175;      Ebersberg (Lkr);24 bis unter 25;1487;783;704
09175;      Ebersberg (Lkr);25 bis unter 26;1463;817;646
09175;      Ebersberg (Lkr);26 bis unter 27;1570;830;740
09175;      Ebersberg (Lkr);27 bis unter 28;1549;855;694
09175;      Ebersberg (Lkr);28 bis unter 29;1640;873;767
09175;      Ebersberg (Lkr);29 bis unter 30;1568;787;781
09175;      Ebersberg (Lkr);30 bis unter 31;1650;837;813
09175;      Ebersberg (Lkr);31 bis unter 32;1655;837;818
09175;      Ebersberg (Lkr);32 bis unter 33;1692;859;833
09175;      Ebersberg (Lkr);33 bis unter 34;1671;868;803
09175;      Ebersberg (Lkr);34 bis unter 35;1705;800;905
09175;      Ebersberg (Lkr);35 bis unter 36;1814;890;924
09175;      Ebersberg (Lkr);36 bis unter 37;1924;941;983
09175;      Ebersberg (Lkr);37 bis unter 38;1969;984;985
09175;      Ebersberg (Lkr);38 bis unter 39;1918;918;1000
09175;      Ebersberg (Lkr);39 bis unter 40;1957;963;994
09175;      Ebersberg (Lkr);40 bis unter 41;2014;994;1020
09175;      Ebersberg (Lkr);41 bis unter 42;1929;974;955
09175;      Ebersberg (Lkr);42 bis unter 43;1922;969;953
09175;      Ebersberg (Lkr);43 bis unter 44;1981;981;1000
09175;      Ebersberg (Lkr);44 bis unter 45;1890;939;951
09175;      Ebersberg (Lkr);45 bis unter 46;1934;1011;923
09175;      Ebersberg (Lkr);46 bis unter 47;1988;974;1014
09175;      Ebersberg (Lkr);47 bis unter 48;2070;1071;999
09175;      Ebersberg (Lkr);48 bis unter 49;2380;1225;1155
09175;      Ebersberg (Lkr);49 bis unter 50;2526;1266;1260
09175;      Ebersberg (Lkr);50 bis unter 51;2667;1292;1375
09175;      Ebersberg (Lkr);51 bis unter 52;2549;1312;1237
09175;      Ebersberg (Lkr);52 bis unter 53;2595;1394;1201
09175;      Ebersberg (Lkr);53 bis unter 54;2507;1268;1239
09175;      Ebersberg (Lkr);54 bis unter 55;2496;1235;1261
09175;      Ebersberg (Lkr);55 bis unter 56;2271;1131;1140
09175;      Ebersberg (Lkr);56 bis unter 57;2278;1143;1135
09175;      Ebersberg (Lkr);57 bis unter 58;2215;1136;1079
09175;      Ebersberg (Lkr);58 bis unter 59;2102;1077;1025
09175;      Ebersberg (Lkr);59 bis unter 60;1956;1014;942
09175;      Ebersberg (Lkr);60 bis unter 61;1788;906;882
09175;      Ebersberg (Lkr);61 bis unter 62;1713;861;852
09175;      Ebersberg (Lkr);62 bis unter 63;1597;789;808
09175;      Ebersberg (Lkr);63 bis unter 64;1464;776;688
09175;      Ebersberg (Lkr);64 bis unter 65;1384;632;752
09175;      Ebersberg (Lkr);65 bis unter 66;1284;620;664
09175;      Ebersberg (Lkr);66 bis unter 67;1339;633;706
09175;      Ebersberg (Lkr);67 bis unter 68;1238;555;683
09175;      Ebersberg (Lkr);68 bis unter 69;1285;607;678
09175;      Ebersberg (Lkr);69 bis unter 70;1299;628;671
09175;      Ebersberg (Lkr);70 bis unter 71;1254;598;656
09175;      Ebersberg (Lkr);71 bis unter 72;1180;540;640
09175;      Ebersberg (Lkr);72 bis unter 73;1106;540;566
09175;      Ebersberg (Lkr);73 bis unter 74;960;454;506
09175;      Ebersberg (Lkr);74 bis unter 75;1208;554;654
09175;      Ebersberg (Lkr);75 bis unter 76;1264;555;709
09175;      Ebersberg (Lkr);76 bis unter 77;1169;542;627
09175;      Ebersberg (Lkr);77 bis unter 78;1415;648;767
09175;      Ebersberg (Lkr);78 bis unter 79;1384;628;756
09175;      Ebersberg (Lkr);79 bis unter 80;1394;634;760
09175;      Ebersberg (Lkr);80 bis unter 81;1171;529;642
09175;      Ebersberg (Lkr);81 bis unter 82;998;444;554
09175;      Ebersberg (Lkr);82 bis unter 83;880;383;497
09175;      Ebersberg (Lkr);83 bis unter 84;745;326;419
09175;      Ebersberg (Lkr);84 bis unter 85;735;319;416
09175;      Ebersberg (Lkr);85 bis unter 90;2151;820;1331
09175;      Ebersberg (Lkr);90 bis unter 95;894;295;599
09175;      Ebersberg (Lkr);95 oder älter;208;47;161
09175;      Ebersberg (Lkr);Insgesamt;142142;70972;71170
09176;      Eichstätt (Lkr);unter 1;1483;743;740
09176;      Eichstätt (Lkr);1 bis unter 2;1471;731;740
09176;      Eichstätt (Lkr);2 bis unter 3;1485;728;757
09176;      Eichstätt (Lkr);3 bis unter 4;1459;762;697
09176;      Eichstätt (Lkr);4 bis unter 5;1342;667;675
09176;      Eichstätt (Lkr);5 bis unter 6;1424;728;696
09176;      Eichstätt (Lkr);6 bis unter 7;1355;700;655
09176;      Eichstätt (Lkr);7 bis unter 8;1331;693;638
09176;      Eichstätt (Lkr);8 bis unter 9;1258;652;606
09176;      Eichstätt (Lkr);9 bis unter 10;1256;650;606
09176;      Eichstätt (Lkr);10 bis unter 11;1325;697;628
09176;      Eichstätt (Lkr);11 bis unter 12;1294;660;634
09176;      Eichstätt (Lkr);12 bis unter 13;1231;650;581
09176;      Eichstätt (Lkr);13 bis unter 14;1301;649;652
09176;      Eichstätt (Lkr);14 bis unter 15;1368;711;657
09176;      Eichstätt (Lkr);15 bis unter 16;1395;729;666
09176;      Eichstätt (Lkr);16 bis unter 17;1369;716;653
09176;      Eichstätt (Lkr);17 bis unter 18;1451;763;688
09176;      Eichstätt (Lkr);18 bis unter 19;1486;753;733
09176;      Eichstätt (Lkr);19 bis unter 20;1521;813;708
09176;      Eichstätt (Lkr);20 bis unter 21;1587;823;764
09176;      Eichstätt (Lkr);21 bis unter 22;1739;953;786
09176;      Eichstätt (Lkr);22 bis unter 23;1593;857;736
09176;      Eichstätt (Lkr);23 bis unter 24;1592;889;703
09176;      Eichstätt (Lkr);24 bis unter 25;1603;845;758
09176;      Eichstätt (Lkr);25 bis unter 26;1608;899;709
09176;      Eichstätt (Lkr);26 bis unter 27;1612;813;799
09176;      Eichstätt (Lkr);27 bis unter 28;1590;858;732
09176;      Eichstätt (Lkr);28 bis unter 29;1782;973;809
09176;      Eichstätt (Lkr);29 bis unter 30;1741;930;811
09176;      Eichstätt (Lkr);30 bis unter 31;1783;923;860
09176;      Eichstätt (Lkr);31 bis unter 32;1666;852;814
09176;      Eichstätt (Lkr);32 bis unter 33;1750;915;835
09176;      Eichstätt (Lkr);33 bis unter 34;1770;895;875
09176;      Eichstätt (Lkr);34 bis unter 35;1757;909;848
09176;      Eichstätt (Lkr);35 bis unter 36;1774;908;866
09176;      Eichstätt (Lkr);36 bis unter 37;1881;979;902
09176;      Eichstätt (Lkr);37 bis unter 38;1807;957;850
09176;      Eichstätt (Lkr);38 bis unter 39;1801;892;909
09176;      Eichstätt (Lkr);39 bis unter 40;1814;962;852
09176;      Eichstätt (Lkr);40 bis unter 41;1706;896;810
09176;      Eichstätt (Lkr);41 bis unter 42;1775;931;844
09176;      Eichstätt (Lkr);42 bis unter 43;1692;916;776
09176;      Eichstätt (Lkr);43 bis unter 44;1653;916;737
09176;      Eichstätt (Lkr);44 bis unter 45;1696;888;808
09176;      Eichstätt (Lkr);45 bis unter 46;1609;835;774
09176;      Eichstätt (Lkr);46 bis unter 47;1739;872;867
09176;      Eichstätt (Lkr);47 bis unter 48;1875;938;937
09176;      Eichstätt (Lkr);48 bis unter 49;1889;966;923
09176;      Eichstätt (Lkr);49 bis unter 50;2041;1067;974
09176;      Eichstätt (Lkr);50 bis unter 51;2171;1159;1012
09176;      Eichstätt (Lkr);51 bis unter 52;2206;1139;1067
09176;      Eichstätt (Lkr);52 bis unter 53;2236;1189;1047
09176;      Eichstätt (Lkr);53 bis unter 54;2198;1095;1103
09176;      Eichstätt (Lkr);54 bis unter 55;2221;1149;1072
09176;      Eichstätt (Lkr);55 bis unter 56;2124;1100;1024
09176;      Eichstätt (Lkr);56 bis unter 57;2070;1059;1011
09176;      Eichstätt (Lkr);57 bis unter 58;2115;1061;1054
09176;      Eichstätt (Lkr);58 bis unter 59;2015;998;1017
09176;      Eichstätt (Lkr);59 bis unter 60;1992;1008;984
09176;      Eichstätt (Lkr);60 bis unter 61;1874;999;875
09176;      Eichstätt (Lkr);61 bis unter 62;1726;879;847
09176;      Eichstätt (Lkr);62 bis unter 63;1670;850;820
09176;      Eichstätt (Lkr);63 bis unter 64;1543;811;732
09176;      Eichstätt (Lkr);64 bis unter 65;1447;729;718
09176;      Eichstätt (Lkr);65 bis unter 66;1361;638;723
09176;      Eichstätt (Lkr);66 bis unter 67;1372;710;662
09176;      Eichstätt (Lkr);67 bis unter 68;1407;690;717
09176;      Eichstätt (Lkr);68 bis unter 69;1318;654;664
09176;      Eichstätt (Lkr);69 bis unter 70;1243;633;610
09176;      Eichstätt (Lkr);70 bis unter 71;1072;543;529
09176;      Eichstätt (Lkr);71 bis unter 72;1003;508;495
09176;      Eichstätt (Lkr);72 bis unter 73;901;420;481
09176;      Eichstätt (Lkr);73 bis unter 74;668;324;344
09176;      Eichstätt (Lkr);74 bis unter 75;823;388;435
09176;      Eichstätt (Lkr);75 bis unter 76;890;450;440
09176;      Eichstätt (Lkr);76 bis unter 77;846;427;419
09176;      Eichstätt (Lkr);77 bis unter 78;1079;496;583
09176;      Eichstätt (Lkr);78 bis unter 79;1161;531;630
09176;      Eichstätt (Lkr);79 bis unter 80;1134;485;649
09176;      Eichstätt (Lkr);80 bis unter 81;1016;449;567
09176;      Eichstätt (Lkr);81 bis unter 82;860;396;464
09176;      Eichstätt (Lkr);82 bis unter 83;820;346;474
09176;      Eichstätt (Lkr);83 bis unter 84;696;275;421
09176;      Eichstätt (Lkr);84 bis unter 85;636;252;384
09176;      Eichstätt (Lkr);85 bis unter 90;2004;774;1230
09176;      Eichstätt (Lkr);90 bis unter 95;728;221;507
09176;      Eichstätt (Lkr);95 oder älter;165;38;127
09176;      Eichstätt (Lkr);Insgesamt;132341;67325;65016
09177;      Erding (Lkr);unter 1;1342;664;678
09177;      Erding (Lkr);1 bis unter 2;1438;711;727
09177;      Erding (Lkr);2 bis unter 3;1392;747;645
09177;      Erding (Lkr);3 bis unter 4;1445;766;679
09177;      Erding (Lkr);4 bis unter 5;1390;747;643
09177;      Erding (Lkr);5 bis unter 6;1316;639;677
09177;      Erding (Lkr);6 bis unter 7;1313;699;614
09177;      Erding (Lkr);7 bis unter 8;1303;678;625
09177;      Erding (Lkr);8 bis unter 9;1258;645;613
09177;      Erding (Lkr);9 bis unter 10;1313;692;621
09177;      Erding (Lkr);10 bis unter 11;1321;676;645
09177;      Erding (Lkr);11 bis unter 12;1427;729;698
09177;      Erding (Lkr);12 bis unter 13;1302;665;637
09177;      Erding (Lkr);13 bis unter 14;1296;682;614
09177;      Erding (Lkr);14 bis unter 15;1538;790;748
09177;      Erding (Lkr);15 bis unter 16;1365;690;675
09177;      Erding (Lkr);16 bis unter 17;1485;761;724
09177;      Erding (Lkr);17 bis unter 18;1433;735;698
09177;      Erding (Lkr);18 bis unter 19;1548;787;761
09177;      Erding (Lkr);19 bis unter 20;1578;819;759
09177;      Erding (Lkr);20 bis unter 21;1597;837;760
09177;      Erding (Lkr);21 bis unter 22;1643;862;781
09177;      Erding (Lkr);22 bis unter 23;1650;828;822
09177;      Erding (Lkr);23 bis unter 24;1578;845;733
09177;      Erding (Lkr);24 bis unter 25;1577;839;738
09177;      Erding (Lkr);25 bis unter 26;1671;906;765
09177;      Erding (Lkr);26 bis unter 27;1677;877;800
09177;      Erding (Lkr);27 bis unter 28;1650;886;764
09177;      Erding (Lkr);28 bis unter 29;1808;933;875
09177;      Erding (Lkr);29 bis unter 30;1734;918;816
09177;      Erding (Lkr);30 bis unter 31;1771;950;821
09177;      Erding (Lkr);31 bis unter 32;1631;822;809
09177;      Erding (Lkr);32 bis unter 33;1721;874;847
09177;      Erding (Lkr);33 bis unter 34;1764;889;875
09177;      Erding (Lkr);34 bis unter 35;1755;872;883
09177;      Erding (Lkr);35 bis unter 36;1746;855;891
09177;      Erding (Lkr);36 bis unter 37;1856;909;947
09177;      Erding (Lkr);37 bis unter 38;1795;918;877
09177;      Erding (Lkr);38 bis unter 39;1981;999;982
09177;      Erding (Lkr);39 bis unter 40;1905;957;948
09177;      Erding (Lkr);40 bis unter 41;1900;971;929
09177;      Erding (Lkr);41 bis unter 42;1893;984;909
09177;      Erding (Lkr);42 bis unter 43;1851;999;852
09177;      Erding (Lkr);43 bis unter 44;1761;906;855
09177;      Erding (Lkr);44 bis unter 45;1829;928;901
09177;      Erding (Lkr);45 bis unter 46;1817;938;879
09177;      Erding (Lkr);46 bis unter 47;2037;1007;1030
09177;      Erding (Lkr);47 bis unter 48;2149;1069;1080
09177;      Erding (Lkr);48 bis unter 49;2274;1154;1120
09177;      Erding (Lkr);49 bis unter 50;2473;1345;1128
09177;      Erding (Lkr);50 bis unter 51;2553;1328;1225
09177;      Erding (Lkr);51 bis unter 52;2580;1294;1286
09177;      Erding (Lkr);52 bis unter 53;2649;1344;1305
09177;      Erding (Lkr);53 bis unter 54;2491;1268;1223
09177;      Erding (Lkr);54 bis unter 55;2534;1293;1241
09177;      Erding (Lkr);55 bis unter 56;2455;1246;1209
09177;      Erding (Lkr);56 bis unter 57;2375;1222;1153
09177;      Erding (Lkr);57 bis unter 58;2212;1172;1040
09177;      Erding (Lkr);58 bis unter 59;2026;1025;1001
09177;      Erding (Lkr);59 bis unter 60;1945;1005;940
09177;      Erding (Lkr);60 bis unter 61;1890;970;920
09177;      Erding (Lkr);61 bis unter 62;1756;885;871
09177;      Erding (Lkr);62 bis unter 63;1651;818;833
09177;      Erding (Lkr);63 bis unter 64;1459;795;664
09177;      Erding (Lkr);64 bis unter 65;1516;745;771
09177;      Erding (Lkr);65 bis unter 66;1395;677;718
09177;      Erding (Lkr);66 bis unter 67;1396;666;730
09177;      Erding (Lkr);67 bis unter 68;1306;681;625
09177;      Erding (Lkr);68 bis unter 69;1268;627;641
09177;      Erding (Lkr);69 bis unter 70;1307;615;692
09177;      Erding (Lkr);70 bis unter 71;1174;570;604
09177;      Erding (Lkr);71 bis unter 72;1113;527;586
09177;      Erding (Lkr);72 bis unter 73;959;452;507
09177;      Erding (Lkr);73 bis unter 74;812;377;435
09177;      Erding (Lkr);74 bis unter 75;943;454;489
09177;      Erding (Lkr);75 bis unter 76;903;454;449
09177;      Erding (Lkr);76 bis unter 77;889;397;492
09177;      Erding (Lkr);77 bis unter 78;1046;465;581
09177;      Erding (Lkr);78 bis unter 79;1092;507;585
09177;      Erding (Lkr);79 bis unter 80;1058;502;556
09177;      Erding (Lkr);80 bis unter 81;976;438;538
09177;      Erding (Lkr);81 bis unter 82;823;356;467
09177;      Erding (Lkr);82 bis unter 83;728;293;435
09177;      Erding (Lkr);83 bis unter 84;635;266;369
09177;      Erding (Lkr);84 bis unter 85;612;261;351
09177;      Erding (Lkr);85 bis unter 90;1911;708;1203
09177;      Erding (Lkr);90 bis unter 95;741;225;516
09177;      Erding (Lkr);95 oder älter;184;40;144
09177;      Erding (Lkr);Insgesamt;137660;69367;68293
09178;      Freising (Lkr);unter 1;1871;978;893
09178;      Freising (Lkr);1 bis unter 2;1916;984;932
09178;      Freising (Lkr);2 bis unter 3;1847;916;931
09178;      Freising (Lkr);3 bis unter 4;1862;966;896
09178;      Freising (Lkr);4 bis unter 5;1709;872;837
09178;      Freising (Lkr);5 bis unter 6;1794;917;877
09178;      Freising (Lkr);6 bis unter 7;1693;910;783
09178;      Freising (Lkr);7 bis unter 8;1714;892;822
09178;      Freising (Lkr);8 bis unter 9;1662;854;808
09178;      Freising (Lkr);9 bis unter 10;1639;845;794
09178;      Freising (Lkr);10 bis unter 11;1634;842;792
09178;      Freising (Lkr);11 bis unter 12;1739;913;826
09178;      Freising (Lkr);12 bis unter 13;1641;817;824
09178;      Freising (Lkr);13 bis unter 14;1649;854;795
09178;      Freising (Lkr);14 bis unter 15;1747;922;825
09178;      Freising (Lkr);15 bis unter 16;1747;860;887
09178;      Freising (Lkr);16 bis unter 17;1737;916;821
09178;      Freising (Lkr);17 bis unter 18;1767;933;834
09178;      Freising (Lkr);18 bis unter 19;1892;1005;887
09178;      Freising (Lkr);19 bis unter 20;2044;1049;995
09178;      Freising (Lkr);20 bis unter 21;2345;1249;1096
09178;      Freising (Lkr);21 bis unter 22;2467;1331;1136
09178;      Freising (Lkr);22 bis unter 23;2463;1326;1137
09178;      Freising (Lkr);23 bis unter 24;2458;1322;1136
09178;      Freising (Lkr);24 bis unter 25;2467;1313;1154
09178;      Freising (Lkr);25 bis unter 26;2564;1341;1223
09178;      Freising (Lkr);26 bis unter 27;2621;1398;1223
09178;      Freising (Lkr);27 bis unter 28;2629;1411;1218
09178;      Freising (Lkr);28 bis unter 29;2791;1510;1281
09178;      Freising (Lkr);29 bis unter 30;2667;1481;1186
09178;      Freising (Lkr);30 bis unter 31;2612;1376;1236
09178;      Freising (Lkr);31 bis unter 32;2612;1343;1269
09178;      Freising (Lkr);32 bis unter 33;2589;1379;1210
09178;      Freising (Lkr);33 bis unter 34;2589;1376;1213
09178;      Freising (Lkr);34 bis unter 35;2514;1327;1187
09178;      Freising (Lkr);35 bis unter 36;2489;1316;1173
09178;      Freising (Lkr);36 bis unter 37;2575;1314;1261
09178;      Freising (Lkr);37 bis unter 38;2592;1318;1274
09178;      Freising (Lkr);38 bis unter 39;2541;1273;1268
09178;      Freising (Lkr);39 bis unter 40;2485;1273;1212
09178;      Freising (Lkr);40 bis unter 41;2468;1253;1215
09178;      Freising (Lkr);41 bis unter 42;2430;1257;1173
09178;      Freising (Lkr);42 bis unter 43;2381;1282;1099
09178;      Freising (Lkr);43 bis unter 44;2410;1256;1154
09178;      Freising (Lkr);44 bis unter 45;2400;1243;1157
09178;      Freising (Lkr);45 bis unter 46;2338;1288;1050
09178;      Freising (Lkr);46 bis unter 47;2503;1288;1215
09178;      Freising (Lkr);47 bis unter 48;2720;1445;1275
09178;      Freising (Lkr);48 bis unter 49;2796;1420;1376
09178;      Freising (Lkr);49 bis unter 50;2991;1530;1461
09178;      Freising (Lkr);50 bis unter 51;3140;1627;1513
09178;      Freising (Lkr);51 bis unter 52;3068;1559;1509
09178;      Freising (Lkr);52 bis unter 53;3236;1710;1526
09178;      Freising (Lkr);53 bis unter 54;3172;1633;1539
09178;      Freising (Lkr);54 bis unter 55;3103;1628;1475
09178;      Freising (Lkr);55 bis unter 56;2856;1488;1368
09178;      Freising (Lkr);56 bis unter 57;2826;1454;1372
09178;      Freising (Lkr);57 bis unter 58;2624;1332;1292
09178;      Freising (Lkr);58 bis unter 59;2596;1318;1278
09178;      Freising (Lkr);59 bis unter 60;2451;1284;1167
09178;      Freising (Lkr);60 bis unter 61;2269;1158;1111
09178;      Freising (Lkr);61 bis unter 62;2145;1127;1018
09178;      Freising (Lkr);62 bis unter 63;1965;1011;954
09178;      Freising (Lkr);63 bis unter 64;1814;903;911
09178;      Freising (Lkr);64 bis unter 65;1803;901;902
09178;      Freising (Lkr);65 bis unter 66;1605;816;789
09178;      Freising (Lkr);66 bis unter 67;1549;750;799
09178;      Freising (Lkr);67 bis unter 68;1520;703;817
09178;      Freising (Lkr);68 bis unter 69;1542;713;829
09178;      Freising (Lkr);69 bis unter 70;1414;661;753
09178;      Freising (Lkr);70 bis unter 71;1422;670;752
09178;      Freising (Lkr);71 bis unter 72;1349;648;701
09178;      Freising (Lkr);72 bis unter 73;1215;581;634
09178;      Freising (Lkr);73 bis unter 74;972;471;501
09178;      Freising (Lkr);74 bis unter 75;1309;615;694
09178;      Freising (Lkr);75 bis unter 76;1251;591;660
09178;      Freising (Lkr);76 bis unter 77;1178;570;608
09178;      Freising (Lkr);77 bis unter 78;1383;665;718
09178;      Freising (Lkr);78 bis unter 79;1343;633;710
09178;      Freising (Lkr);79 bis unter 80;1354;605;749
09178;      Freising (Lkr);80 bis unter 81;1156;542;614
09178;      Freising (Lkr);81 bis unter 82;1011;463;548
09178;      Freising (Lkr);82 bis unter 83;865;360;505
09178;      Freising (Lkr);83 bis unter 84;804;321;483
09178;      Freising (Lkr);84 bis unter 85;725;296;429
09178;      Freising (Lkr);85 bis unter 90;2190;782;1408
09178;      Freising (Lkr);90 bis unter 95;897;273;624
09178;      Freising (Lkr);95 oder älter;183;47;136
09178;      Freising (Lkr);Insgesamt;179116;91393;87723
09179;      Fürstenfeldbruck (Lkr);unter 1;2201;1181;1020
09179;      Fürstenfeldbruck (Lkr);1 bis unter 2;2229;1104;1125
09179;      Fürstenfeldbruck (Lkr);2 bis unter 3;2193;1101;1092
09179;      Fürstenfeldbruck (Lkr);3 bis unter 4;2132;1080;1052
09179;      Fürstenfeldbruck (Lkr);4 bis unter 5;2152;1112;1040
09179;      Fürstenfeldbruck (Lkr);5 bis unter 6;2210;1091;1119
09179;      Fürstenfeldbruck (Lkr);6 bis unter 7;2187;1140;1047
09179;      Fürstenfeldbruck (Lkr);7 bis unter 8;2131;1071;1060
09179;      Fürstenfeldbruck (Lkr);8 bis unter 9;2133;1118;1015
09179;      Fürstenfeldbruck (Lkr);9 bis unter 10;2220;1115;1105
09179;      Fürstenfeldbruck (Lkr);10 bis unter 11;2044;1034;1010
09179;      Fürstenfeldbruck (Lkr);11 bis unter 12;2080;1073;1007
09179;      Fürstenfeldbruck (Lkr);12 bis unter 13;2043;1071;972
09179;      Fürstenfeldbruck (Lkr);13 bis unter 14;2090;1079;1011
09179;      Fürstenfeldbruck (Lkr);14 bis unter 15;2127;1068;1059
09179;      Fürstenfeldbruck (Lkr);15 bis unter 16;2105;1040;1065
09179;      Fürstenfeldbruck (Lkr);16 bis unter 17;2097;1045;1052
09179;      Fürstenfeldbruck (Lkr);17 bis unter 18;2146;1086;1060
09179;      Fürstenfeldbruck (Lkr);18 bis unter 19;2283;1194;1089
09179;      Fürstenfeldbruck (Lkr);19 bis unter 20;2336;1257;1079
09179;      Fürstenfeldbruck (Lkr);20 bis unter 21;2300;1237;1063
09179;      Fürstenfeldbruck (Lkr);21 bis unter 22;2467;1347;1120
09179;      Fürstenfeldbruck (Lkr);22 bis unter 23;2417;1315;1102
09179;      Fürstenfeldbruck (Lkr);23 bis unter 24;2357;1235;1122
09179;      Fürstenfeldbruck (Lkr);24 bis unter 25;2348;1240;1108
09179;      Fürstenfeldbruck (Lkr);25 bis unter 26;2328;1184;1144
09179;      Fürstenfeldbruck (Lkr);26 bis unter 27;2459;1307;1152
09179;      Fürstenfeldbruck (Lkr);27 bis unter 28;2458;1272;1186
09179;      Fürstenfeldbruck (Lkr);28 bis unter 29;2619;1389;1230
09179;      Fürstenfeldbruck (Lkr);29 bis unter 30;2648;1381;1267
09179;      Fürstenfeldbruck (Lkr);30 bis unter 31;2612;1331;1281
09179;      Fürstenfeldbruck (Lkr);31 bis unter 32;2541;1247;1294
09179;      Fürstenfeldbruck (Lkr);32 bis unter 33;2652;1357;1295
09179;      Fürstenfeldbruck (Lkr);33 bis unter 34;2612;1356;1256
09179;      Fürstenfeldbruck (Lkr);34 bis unter 35;2613;1361;1252
09179;      Fürstenfeldbruck (Lkr);35 bis unter 36;2600;1271;1329
09179;      Fürstenfeldbruck (Lkr);36 bis unter 37;2734;1354;1380
09179;      Fürstenfeldbruck (Lkr);37 bis unter 38;2892;1403;1489
09179;      Fürstenfeldbruck (Lkr);38 bis unter 39;3024;1471;1553
09179;      Fürstenfeldbruck (Lkr);39 bis unter 40;2909;1471;1438
09179;      Fürstenfeldbruck (Lkr);40 bis unter 41;2877;1404;1473
09179;      Fürstenfeldbruck (Lkr);41 bis unter 42;2938;1483;1455
09179;      Fürstenfeldbruck (Lkr);42 bis unter 43;2775;1340;1435
09179;      Fürstenfeldbruck (Lkr);43 bis unter 44;2738;1367;1371
09179;      Fürstenfeldbruck (Lkr);44 bis unter 45;2763;1411;1352
09179;      Fürstenfeldbruck (Lkr);45 bis unter 46;2869;1416;1453
09179;      Fürstenfeldbruck (Lkr);46 bis unter 47;2843;1397;1446
09179;      Fürstenfeldbruck (Lkr);47 bis unter 48;3135;1566;1569
09179;      Fürstenfeldbruck (Lkr);48 bis unter 49;3364;1752;1612
09179;      Fürstenfeldbruck (Lkr);49 bis unter 50;3525;1753;1772
09179;      Fürstenfeldbruck (Lkr);50 bis unter 51;3750;1925;1825
09179;      Fürstenfeldbruck (Lkr);51 bis unter 52;3820;1962;1858
09179;      Fürstenfeldbruck (Lkr);52 bis unter 53;3759;1878;1881
09179;      Fürstenfeldbruck (Lkr);53 bis unter 54;3735;1846;1889
09179;      Fürstenfeldbruck (Lkr);54 bis unter 55;3712;1799;1913
09179;      Fürstenfeldbruck (Lkr);55 bis unter 56;3631;1817;1814
09179;      Fürstenfeldbruck (Lkr);56 bis unter 57;3305;1663;1642
09179;      Fürstenfeldbruck (Lkr);57 bis unter 58;3332;1668;1664
09179;      Fürstenfeldbruck (Lkr);58 bis unter 59;3077;1519;1558
09179;      Fürstenfeldbruck (Lkr);59 bis unter 60;2920;1425;1495
09179;      Fürstenfeldbruck (Lkr);60 bis unter 61;2758;1370;1388
09179;      Fürstenfeldbruck (Lkr);61 bis unter 62;2669;1273;1396
09179;      Fürstenfeldbruck (Lkr);62 bis unter 63;2473;1200;1273
09179;      Fürstenfeldbruck (Lkr);63 bis unter 64;2359;1127;1232
09179;      Fürstenfeldbruck (Lkr);64 bis unter 65;2226;1021;1205
09179;      Fürstenfeldbruck (Lkr);65 bis unter 66;2270;1044;1226
09179;      Fürstenfeldbruck (Lkr);66 bis unter 67;2180;978;1202
09179;      Fürstenfeldbruck (Lkr);67 bis unter 68;2116;941;1175
09179;      Fürstenfeldbruck (Lkr);68 bis unter 69;2304;1081;1223
09179;      Fürstenfeldbruck (Lkr);69 bis unter 70;2216;1006;1210
09179;      Fürstenfeldbruck (Lkr);70 bis unter 71;2287;1039;1248
09179;      Fürstenfeldbruck (Lkr);71 bis unter 72;2332;1035;1297
09179;      Fürstenfeldbruck (Lkr);72 bis unter 73;1996;886;1110
09179;      Fürstenfeldbruck (Lkr);73 bis unter 74;1816;848;968
09179;      Fürstenfeldbruck (Lkr);74 bis unter 75;2241;1011;1230
09179;      Fürstenfeldbruck (Lkr);75 bis unter 76;2262;1051;1211
09179;      Fürstenfeldbruck (Lkr);76 bis unter 77;2198;1018;1180
09179;      Fürstenfeldbruck (Lkr);77 bis unter 78;2557;1127;1430
09179;      Fürstenfeldbruck (Lkr);78 bis unter 79;2552;1109;1443
09179;      Fürstenfeldbruck (Lkr);79 bis unter 80;2466;1063;1403
09179;      Fürstenfeldbruck (Lkr);80 bis unter 81;2159;962;1197
09179;      Fürstenfeldbruck (Lkr);81 bis unter 82;1760;783;977
09179;      Fürstenfeldbruck (Lkr);82 bis unter 83;1554;676;878
09179;      Fürstenfeldbruck (Lkr);83 bis unter 84;1374;582;792
09179;      Fürstenfeldbruck (Lkr);84 bis unter 85;1167;500;667
09179;      Fürstenfeldbruck (Lkr);85 bis unter 90;3563;1427;2136
09179;      Fürstenfeldbruck (Lkr);90 bis unter 95;1457;472;985
09179;      Fürstenfeldbruck (Lkr);95 oder älter;411;76;335
09179;      Fürstenfeldbruck (Lkr);Insgesamt;219320;107686;111634
09180;      Garmisch-Partenkirchen (Lkr);unter 1;845;444;401
09180;      Garmisch-Partenkirchen (Lkr);1 bis unter 2;809;431;378
09180;      Garmisch-Partenkirchen (Lkr);2 bis unter 3;823;416;407
09180;      Garmisch-Partenkirchen (Lkr);3 bis unter 4;747;372;375
09180;      Garmisch-Partenkirchen (Lkr);4 bis unter 5;744;387;357
09180;      Garmisch-Partenkirchen (Lkr);5 bis unter 6;735;369;366
09180;      Garmisch-Partenkirchen (Lkr);6 bis unter 7;730;378;352
09180;      Garmisch-Partenkirchen (Lkr);7 bis unter 8;667;339;328
09180;      Garmisch-Partenkirchen (Lkr);8 bis unter 9;707;365;342
09180;      Garmisch-Partenkirchen (Lkr);9 bis unter 10;719;416;303
09180;      Garmisch-Partenkirchen (Lkr);10 bis unter 11;679;331;348
09180;      Garmisch-Partenkirchen (Lkr);11 bis unter 12;737;362;375
09180;      Garmisch-Partenkirchen (Lkr);12 bis unter 13;742;395;347
09180;      Garmisch-Partenkirchen (Lkr);13 bis unter 14;706;368;338
09180;      Garmisch-Partenkirchen (Lkr);14 bis unter 15;734;380;354
09180;      Garmisch-Partenkirchen (Lkr);15 bis unter 16;749;376;373
09180;      Garmisch-Partenkirchen (Lkr);16 bis unter 17;785;416;369
09180;      Garmisch-Partenkirchen (Lkr);17 bis unter 18;805;419;386
09180;      Garmisch-Partenkirchen (Lkr);18 bis unter 19;927;490;437
09180;      Garmisch-Partenkirchen (Lkr);19 bis unter 20;887;486;401
09180;      Garmisch-Partenkirchen (Lkr);20 bis unter 21;969;538;431
09180;      Garmisch-Partenkirchen (Lkr);21 bis unter 22;916;469;447
09180;      Garmisch-Partenkirchen (Lkr);22 bis unter 23;1021;555;466
09180;      Garmisch-Partenkirchen (Lkr);23 bis unter 24;994;547;447
09180;      Garmisch-Partenkirchen (Lkr);24 bis unter 25;1015;536;479
09180;      Garmisch-Partenkirchen (Lkr);25 bis unter 26;1018;539;479
09180;      Garmisch-Partenkirchen (Lkr);26 bis unter 27;1016;538;478
09180;      Garmisch-Partenkirchen (Lkr);27 bis unter 28;1014;550;464
09180;      Garmisch-Partenkirchen (Lkr);28 bis unter 29;1020;545;475
09180;      Garmisch-Partenkirchen (Lkr);29 bis unter 30;1053;550;503
09180;      Garmisch-Partenkirchen (Lkr);30 bis unter 31;1064;560;504
09180;      Garmisch-Partenkirchen (Lkr);31 bis unter 32;986;517;469
09180;      Garmisch-Partenkirchen (Lkr);32 bis unter 33;1000;516;484
09180;      Garmisch-Partenkirchen (Lkr);33 bis unter 34;960;492;468
09180;      Garmisch-Partenkirchen (Lkr);34 bis unter 35;941;472;469
09180;      Garmisch-Partenkirchen (Lkr);35 bis unter 36;962;493;469
09180;      Garmisch-Partenkirchen (Lkr);36 bis unter 37;974;446;528
09180;      Garmisch-Partenkirchen (Lkr);37 bis unter 38;951;474;477
09180;      Garmisch-Partenkirchen (Lkr);38 bis unter 39;1085;528;557
09180;      Garmisch-Partenkirchen (Lkr);39 bis unter 40;976;460;516
09180;      Garmisch-Partenkirchen (Lkr);40 bis unter 41;1022;495;527
09180;      Garmisch-Partenkirchen (Lkr);41 bis unter 42;941;461;480
09180;      Garmisch-Partenkirchen (Lkr);42 bis unter 43;982;462;520
09180;      Garmisch-Partenkirchen (Lkr);43 bis unter 44;947;455;492
09180;      Garmisch-Partenkirchen (Lkr);44 bis unter 45;955;474;481
09180;      Garmisch-Partenkirchen (Lkr);45 bis unter 46;968;481;487
09180;      Garmisch-Partenkirchen (Lkr);46 bis unter 47;1086;522;564
09180;      Garmisch-Partenkirchen (Lkr);47 bis unter 48;1261;626;635
09180;      Garmisch-Partenkirchen (Lkr);48 bis unter 49;1202;618;584
09180;      Garmisch-Partenkirchen (Lkr);49 bis unter 50;1341;659;682
09180;      Garmisch-Partenkirchen (Lkr);50 bis unter 51;1521;722;799
09180;      Garmisch-Partenkirchen (Lkr);51 bis unter 52;1568;731;837
09180;      Garmisch-Partenkirchen (Lkr);52 bis unter 53;1475;700;775
09180;      Garmisch-Partenkirchen (Lkr);53 bis unter 54;1632;822;810
09180;      Garmisch-Partenkirchen (Lkr);54 bis unter 55;1541;759;782
09180;      Garmisch-Partenkirchen (Lkr);55 bis unter 56;1593;796;797
09180;      Garmisch-Partenkirchen (Lkr);56 bis unter 57;1493;738;755
09180;      Garmisch-Partenkirchen (Lkr);57 bis unter 58;1444;696;748
09180;      Garmisch-Partenkirchen (Lkr);58 bis unter 59;1288;621;667
09180;      Garmisch-Partenkirchen (Lkr);59 bis unter 60;1266;619;647
09180;      Garmisch-Partenkirchen (Lkr);60 bis unter 61;1191;579;612
09180;      Garmisch-Partenkirchen (Lkr);61 bis unter 62;1192;573;619
09180;      Garmisch-Partenkirchen (Lkr);62 bis unter 63;1065;514;551
09180;      Garmisch-Partenkirchen (Lkr);63 bis unter 64;1059;494;565
09180;      Garmisch-Partenkirchen (Lkr);64 bis unter 65;1049;478;571
09180;      Garmisch-Partenkirchen (Lkr);65 bis unter 66;1015;494;521
09180;      Garmisch-Partenkirchen (Lkr);66 bis unter 67;1042;509;533
09180;      Garmisch-Partenkirchen (Lkr);67 bis unter 68;1021;456;565
09180;      Garmisch-Partenkirchen (Lkr);68 bis unter 69;1000;473;527
09180;      Garmisch-Partenkirchen (Lkr);69 bis unter 70;1086;469;617
09180;      Garmisch-Partenkirchen (Lkr);70 bis unter 71;1040;485;555
09180;      Garmisch-Partenkirchen (Lkr);71 bis unter 72;1077;493;584
09180;      Garmisch-Partenkirchen (Lkr);72 bis unter 73;899;427;472
09180;      Garmisch-Partenkirchen (Lkr);73 bis unter 74;780;385;395
09180;      Garmisch-Partenkirchen (Lkr);74 bis unter 75;1059;460;599
09180;      Garmisch-Partenkirchen (Lkr);75 bis unter 76;1035;453;582
09180;      Garmisch-Partenkirchen (Lkr);76 bis unter 77;949;425;524
09180;      Garmisch-Partenkirchen (Lkr);77 bis unter 78;1123;457;666
09180;      Garmisch-Partenkirchen (Lkr);78 bis unter 79;1136;511;625
09180;      Garmisch-Partenkirchen (Lkr);79 bis unter 80;1117;487;630
09180;      Garmisch-Partenkirchen (Lkr);80 bis unter 81;987;424;563
09180;      Garmisch-Partenkirchen (Lkr);81 bis unter 82;890;364;526
09180;      Garmisch-Partenkirchen (Lkr);82 bis unter 83;766;327;439
09180;      Garmisch-Partenkirchen (Lkr);83 bis unter 84;708;289;419
09180;      Garmisch-Partenkirchen (Lkr);84 bis unter 85;609;245;364
09180;      Garmisch-Partenkirchen (Lkr);85 bis unter 90;1804;704;1100
09180;      Garmisch-Partenkirchen (Lkr);90 bis unter 95;804;230;574
09180;      Garmisch-Partenkirchen (Lkr);95 oder älter;226;42;184
09180;      Garmisch-Partenkirchen (Lkr);Insgesamt;88467;42969;45498
09181;      Landsberg am Lech (Lkr);unter 1;1077;546;531
09181;      Landsberg am Lech (Lkr);1 bis unter 2;1132;559;573
09181;      Landsberg am Lech (Lkr);2 bis unter 3;1180;607;573
09181;      Landsberg am Lech (Lkr);3 bis unter 4;1157;593;564
09181;      Landsberg am Lech (Lkr);4 bis unter 5;1137;579;558
09181;      Landsberg am Lech (Lkr);5 bis unter 6;1117;555;562
09181;      Landsberg am Lech (Lkr);6 bis unter 7;1115;594;521
09181;      Landsberg am Lech (Lkr);7 bis unter 8;1131;570;561
09181;      Landsberg am Lech (Lkr);8 bis unter 9;1130;578;552
09181;      Landsberg am Lech (Lkr);9 bis unter 10;1112;591;521
09181;      Landsberg am Lech (Lkr);10 bis unter 11;1199;590;609
09181;      Landsberg am Lech (Lkr);11 bis unter 12;1187;621;566
09181;      Landsberg am Lech (Lkr);12 bis unter 13;1143;562;581
09181;      Landsberg am Lech (Lkr);13 bis unter 14;1184;582;602
09181;      Landsberg am Lech (Lkr);14 bis unter 15;1256;671;585
09181;      Landsberg am Lech (Lkr);15 bis unter 16;1210;609;601
09181;      Landsberg am Lech (Lkr);16 bis unter 17;1299;659;640
09181;      Landsberg am Lech (Lkr);17 bis unter 18;1311;661;650
09181;      Landsberg am Lech (Lkr);18 bis unter 19;1443;760;683
09181;      Landsberg am Lech (Lkr);19 bis unter 20;1356;742;614
09181;      Landsberg am Lech (Lkr);20 bis unter 21;1409;782;627
09181;      Landsberg am Lech (Lkr);21 bis unter 22;1443;785;658
09181;      Landsberg am Lech (Lkr);22 bis unter 23;1374;734;640
09181;      Landsberg am Lech (Lkr);23 bis unter 24;1386;802;584
09181;      Landsberg am Lech (Lkr);24 bis unter 25;1247;706;541
09181;      Landsberg am Lech (Lkr);25 bis unter 26;1291;725;566
09181;      Landsberg am Lech (Lkr);26 bis unter 27;1317;737;580
09181;      Landsberg am Lech (Lkr);27 bis unter 28;1286;668;618
09181;      Landsberg am Lech (Lkr);28 bis unter 29;1369;748;621
09181;      Landsberg am Lech (Lkr);29 bis unter 30;1406;768;638
09181;      Landsberg am Lech (Lkr);30 bis unter 31;1357;703;654
09181;      Landsberg am Lech (Lkr);31 bis unter 32;1313;708;605
09181;      Landsberg am Lech (Lkr);32 bis unter 33;1398;744;654
09181;      Landsberg am Lech (Lkr);33 bis unter 34;1308;693;615
09181;      Landsberg am Lech (Lkr);34 bis unter 35;1301;659;642
09181;      Landsberg am Lech (Lkr);35 bis unter 36;1437;749;688
09181;      Landsberg am Lech (Lkr);36 bis unter 37;1512;794;718
09181;      Landsberg am Lech (Lkr);37 bis unter 38;1451;717;734
09181;      Landsberg am Lech (Lkr);38 bis unter 39;1457;726;731
09181;      Landsberg am Lech (Lkr);39 bis unter 40;1509;773;736
09181;      Landsberg am Lech (Lkr);40 bis unter 41;1464;739;725
09181;      Landsberg am Lech (Lkr);41 bis unter 42;1399;725;674
09181;      Landsberg am Lech (Lkr);42 bis unter 43;1509;746;763
09181;      Landsberg am Lech (Lkr);43 bis unter 44;1338;672;666
09181;      Landsberg am Lech (Lkr);44 bis unter 45;1427;659;768
09181;      Landsberg am Lech (Lkr);45 bis unter 46;1492;708;784
09181;      Landsberg am Lech (Lkr);46 bis unter 47;1580;780;800
09181;      Landsberg am Lech (Lkr);47 bis unter 48;1792;952;840
09181;      Landsberg am Lech (Lkr);48 bis unter 49;1853;910;943
09181;      Landsberg am Lech (Lkr);49 bis unter 50;2065;1016;1049
09181;      Landsberg am Lech (Lkr);50 bis unter 51;2204;1118;1086
09181;      Landsberg am Lech (Lkr);51 bis unter 52;2223;1093;1130
09181;      Landsberg am Lech (Lkr);52 bis unter 53;2312;1169;1143
09181;      Landsberg am Lech (Lkr);53 bis unter 54;2180;1090;1090
09181;      Landsberg am Lech (Lkr);54 bis unter 55;2219;1086;1133
09181;      Landsberg am Lech (Lkr);55 bis unter 56;2239;1090;1149
09181;      Landsberg am Lech (Lkr);56 bis unter 57;2072;1023;1049
09181;      Landsberg am Lech (Lkr);57 bis unter 58;2040;1003;1037
09181;      Landsberg am Lech (Lkr);58 bis unter 59;1916;964;952
09181;      Landsberg am Lech (Lkr);59 bis unter 60;1807;905;902
09181;      Landsberg am Lech (Lkr);60 bis unter 61;1676;864;812
09181;      Landsberg am Lech (Lkr);61 bis unter 62;1626;810;816
09181;      Landsberg am Lech (Lkr);62 bis unter 63;1501;760;741
09181;      Landsberg am Lech (Lkr);63 bis unter 64;1446;703;743
09181;      Landsberg am Lech (Lkr);64 bis unter 65;1283;630;653
09181;      Landsberg am Lech (Lkr);65 bis unter 66;1392;645;747
09181;      Landsberg am Lech (Lkr);66 bis unter 67;1226;587;639
09181;      Landsberg am Lech (Lkr);67 bis unter 68;1264;604;660
09181;      Landsberg am Lech (Lkr);68 bis unter 69;1280;621;659
09181;      Landsberg am Lech (Lkr);69 bis unter 70;1281;650;631
09181;      Landsberg am Lech (Lkr);70 bis unter 71;1182;564;618
09181;      Landsberg am Lech (Lkr);71 bis unter 72;1193;565;628
09181;      Landsberg am Lech (Lkr);72 bis unter 73;1071;484;587
09181;      Landsberg am Lech (Lkr);73 bis unter 74;839;417;422
09181;      Landsberg am Lech (Lkr);74 bis unter 75;1080;523;557
09181;      Landsberg am Lech (Lkr);75 bis unter 76;1071;552;519
09181;      Landsberg am Lech (Lkr);76 bis unter 77;961;431;530
09181;      Landsberg am Lech (Lkr);77 bis unter 78;1158;552;606
09181;      Landsberg am Lech (Lkr);78 bis unter 79;1131;526;605
09181;      Landsberg am Lech (Lkr);79 bis unter 80;1151;546;605
09181;      Landsberg am Lech (Lkr);80 bis unter 81;990;461;529
09181;      Landsberg am Lech (Lkr);81 bis unter 82;824;377;447
09181;      Landsberg am Lech (Lkr);82 bis unter 83;761;323;438
09181;      Landsberg am Lech (Lkr);83 bis unter 84;704;286;418
09181;      Landsberg am Lech (Lkr);84 bis unter 85;559;218;341
09181;      Landsberg am Lech (Lkr);85 bis unter 90;1787;672;1115
09181;      Landsberg am Lech (Lkr);90 bis unter 95;823;260;563
09181;      Landsberg am Lech (Lkr);95 oder älter;233;48;185
09181;      Landsberg am Lech (Lkr);Insgesamt;120071;60077;59994
09182;      Miesbach (Lkr);unter 1;911;448;463
09182;      Miesbach (Lkr);1 bis unter 2;936;496;440
09182;      Miesbach (Lkr);2 bis unter 3;945;492;453
09182;      Miesbach (Lkr);3 bis unter 4;924;466;458
09182;      Miesbach (Lkr);4 bis unter 5;910;478;432
09182;      Miesbach (Lkr);5 bis unter 6;898;467;431
09182;      Miesbach (Lkr);6 bis unter 7;832;433;399
09182;      Miesbach (Lkr);7 bis unter 8;864;423;441
09182;      Miesbach (Lkr);8 bis unter 9;876;455;421
09182;      Miesbach (Lkr);9 bis unter 10;925;485;440
09182;      Miesbach (Lkr);10 bis unter 11;936;498;438
09182;      Miesbach (Lkr);11 bis unter 12;939;466;473
09182;      Miesbach (Lkr);12 bis unter 13;921;506;415
09182;      Miesbach (Lkr);13 bis unter 14;847;421;426
09182;      Miesbach (Lkr);14 bis unter 15;961;477;484
09182;      Miesbach (Lkr);15 bis unter 16;900;456;444
09182;      Miesbach (Lkr);16 bis unter 17;945;472;473
09182;      Miesbach (Lkr);17 bis unter 18;954;510;444
09182;      Miesbach (Lkr);18 bis unter 19;1010;543;467
09182;      Miesbach (Lkr);19 bis unter 20;966;524;442
09182;      Miesbach (Lkr);20 bis unter 21;1037;584;453
09182;      Miesbach (Lkr);21 bis unter 22;1112;630;482
09182;      Miesbach (Lkr);22 bis unter 23;1008;559;449
09182;      Miesbach (Lkr);23 bis unter 24;1074;573;501
09182;      Miesbach (Lkr);24 bis unter 25;1045;530;515
09182;      Miesbach (Lkr);25 bis unter 26;1089;572;517
09182;      Miesbach (Lkr);26 bis unter 27;1112;588;524
09182;      Miesbach (Lkr);27 bis unter 28;1085;580;505
09182;      Miesbach (Lkr);28 bis unter 29;1134;592;542
09182;      Miesbach (Lkr);29 bis unter 30;1129;587;542
09182;      Miesbach (Lkr);30 bis unter 31;1173;594;579
09182;      Miesbach (Lkr);31 bis unter 32;1153;569;584
09182;      Miesbach (Lkr);32 bis unter 33;1141;601;540
09182;      Miesbach (Lkr);33 bis unter 34;1084;560;524
09182;      Miesbach (Lkr);34 bis unter 35;1139;568;571
09182;      Miesbach (Lkr);35 bis unter 36;1139;556;583
09182;      Miesbach (Lkr);36 bis unter 37;1179;588;591
09182;      Miesbach (Lkr);37 bis unter 38;1170;590;580
09182;      Miesbach (Lkr);38 bis unter 39;1218;591;627
09182;      Miesbach (Lkr);39 bis unter 40;1203;596;607
09182;      Miesbach (Lkr);40 bis unter 41;1217;577;640
09182;      Miesbach (Lkr);41 bis unter 42;1209;582;627
09182;      Miesbach (Lkr);42 bis unter 43;1182;575;607
09182;      Miesbach (Lkr);43 bis unter 44;1181;575;606
09182;      Miesbach (Lkr);44 bis unter 45;1228;616;612
09182;      Miesbach (Lkr);45 bis unter 46;1235;595;640
09182;      Miesbach (Lkr);46 bis unter 47;1248;612;636
09182;      Miesbach (Lkr);47 bis unter 48;1407;713;694
09182;      Miesbach (Lkr);48 bis unter 49;1559;762;797
09182;      Miesbach (Lkr);49 bis unter 50;1670;834;836
09182;      Miesbach (Lkr);50 bis unter 51;1839;919;920
09182;      Miesbach (Lkr);51 bis unter 52;1792;909;883
09182;      Miesbach (Lkr);52 bis unter 53;1825;910;915
09182;      Miesbach (Lkr);53 bis unter 54;1798;857;941
09182;      Miesbach (Lkr);54 bis unter 55;1811;853;958
09182;      Miesbach (Lkr);55 bis unter 56;1724;847;877
09182;      Miesbach (Lkr);56 bis unter 57;1663;824;839
09182;      Miesbach (Lkr);57 bis unter 58;1667;825;842
09182;      Miesbach (Lkr);58 bis unter 59;1519;777;742
09182;      Miesbach (Lkr);59 bis unter 60;1469;719;750
09182;      Miesbach (Lkr);60 bis unter 61;1420;719;701
09182;      Miesbach (Lkr);61 bis unter 62;1265;617;648
09182;      Miesbach (Lkr);62 bis unter 63;1232;629;603
09182;      Miesbach (Lkr);63 bis unter 64;1133;542;591
09182;      Miesbach (Lkr);64 bis unter 65;1057;524;533
09182;      Miesbach (Lkr);65 bis unter 66;1026;481;545
09182;      Miesbach (Lkr);66 bis unter 67;1051;487;564
09182;      Miesbach (Lkr);67 bis unter 68;1000;445;555
09182;      Miesbach (Lkr);68 bis unter 69;1061;485;576
09182;      Miesbach (Lkr);69 bis unter 70;1073;457;616
09182;      Miesbach (Lkr);70 bis unter 71;1073;489;584
09182;      Miesbach (Lkr);71 bis unter 72;1129;546;583
09182;      Miesbach (Lkr);72 bis unter 73;972;439;533
09182;      Miesbach (Lkr);73 bis unter 74;861;390;471
09182;      Miesbach (Lkr);74 bis unter 75;1119;521;598
09182;      Miesbach (Lkr);75 bis unter 76;1031;467;564
09182;      Miesbach (Lkr);76 bis unter 77;1032;467;565
09182;      Miesbach (Lkr);77 bis unter 78;1166;522;644
09182;      Miesbach (Lkr);78 bis unter 79;1232;526;706
09182;      Miesbach (Lkr);79 bis unter 80;1076;487;589
09182;      Miesbach (Lkr);80 bis unter 81;987;438;549
09182;      Miesbach (Lkr);81 bis unter 82;900;402;498
09182;      Miesbach (Lkr);82 bis unter 83;765;327;438
09182;      Miesbach (Lkr);83 bis unter 84;644;282;362
09182;      Miesbach (Lkr);84 bis unter 85;586;253;333
09182;      Miesbach (Lkr);85 bis unter 90;1780;661;1119
09182;      Miesbach (Lkr);90 bis unter 95;770;213;557
09182;      Miesbach (Lkr);95 oder älter;218;49;169
09182;      Miesbach (Lkr);Insgesamt;99726;48870;50856
09183;      Mühldorf a.Inn (Lkr);unter 1;1134;596;538
09183;      Mühldorf a.Inn (Lkr);1 bis unter 2;1125;599;526
09183;      Mühldorf a.Inn (Lkr);2 bis unter 3;1178;602;576
09183;      Mühldorf a.Inn (Lkr);3 bis unter 4;1085;572;513
09183;      Mühldorf a.Inn (Lkr);4 bis unter 5;1146;603;543
09183;      Mühldorf a.Inn (Lkr);5 bis unter 6;1073;584;489
09183;      Mühldorf a.Inn (Lkr);6 bis unter 7;1078;554;524
09183;      Mühldorf a.Inn (Lkr);7 bis unter 8;1048;537;511
09183;      Mühldorf a.Inn (Lkr);8 bis unter 9;1064;574;490
09183;      Mühldorf a.Inn (Lkr);9 bis unter 10;1036;516;520
09183;      Mühldorf a.Inn (Lkr);10 bis unter 11;1055;521;534
09183;      Mühldorf a.Inn (Lkr);11 bis unter 12;1037;529;508
09183;      Mühldorf a.Inn (Lkr);12 bis unter 13;1052;585;467
09183;      Mühldorf a.Inn (Lkr);13 bis unter 14;1046;556;490
09183;      Mühldorf a.Inn (Lkr);14 bis unter 15;1102;541;561
09183;      Mühldorf a.Inn (Lkr);15 bis unter 16;1088;569;519
09183;      Mühldorf a.Inn (Lkr);16 bis unter 17;1165;584;581
09183;      Mühldorf a.Inn (Lkr);17 bis unter 18;1153;570;583
09183;      Mühldorf a.Inn (Lkr);18 bis unter 19;1220;618;602
09183;      Mühldorf a.Inn (Lkr);19 bis unter 20;1295;695;600
09183;      Mühldorf a.Inn (Lkr);20 bis unter 21;1316;677;639
09183;      Mühldorf a.Inn (Lkr);21 bis unter 22;1363;756;607
09183;      Mühldorf a.Inn (Lkr);22 bis unter 23;1415;790;625
09183;      Mühldorf a.Inn (Lkr);23 bis unter 24;1402;767;635
09183;      Mühldorf a.Inn (Lkr);24 bis unter 25;1301;697;604
09183;      Mühldorf a.Inn (Lkr);25 bis unter 26;1365;733;632
09183;      Mühldorf a.Inn (Lkr);26 bis unter 27;1449;776;673
09183;      Mühldorf a.Inn (Lkr);27 bis unter 28;1429;798;631
09183;      Mühldorf a.Inn (Lkr);28 bis unter 29;1551;850;701
09183;      Mühldorf a.Inn (Lkr);29 bis unter 30;1518;814;704
09183;      Mühldorf a.Inn (Lkr);30 bis unter 31;1444;766;678
09183;      Mühldorf a.Inn (Lkr);31 bis unter 32;1403;752;651
09183;      Mühldorf a.Inn (Lkr);32 bis unter 33;1470;795;675
09183;      Mühldorf a.Inn (Lkr);33 bis unter 34;1353;737;616
09183;      Mühldorf a.Inn (Lkr);34 bis unter 35;1418;755;663
09183;      Mühldorf a.Inn (Lkr);35 bis unter 36;1337;715;622
09183;      Mühldorf a.Inn (Lkr);36 bis unter 37;1446;730;716
09183;      Mühldorf a.Inn (Lkr);37 bis unter 38;1432;793;639
09183;      Mühldorf a.Inn (Lkr);38 bis unter 39;1416;747;669
09183;      Mühldorf a.Inn (Lkr);39 bis unter 40;1390;725;665
09183;      Mühldorf a.Inn (Lkr);40 bis unter 41;1432;707;725
09183;      Mühldorf a.Inn (Lkr);41 bis unter 42;1420;714;706
09183;      Mühldorf a.Inn (Lkr);42 bis unter 43;1421;733;688
09183;      Mühldorf a.Inn (Lkr);43 bis unter 44;1389;761;628
09183;      Mühldorf a.Inn (Lkr);44 bis unter 45;1437;703;734
09183;      Mühldorf a.Inn (Lkr);45 bis unter 46;1379;735;644
09183;      Mühldorf a.Inn (Lkr);46 bis unter 47;1529;779;750
09183;      Mühldorf a.Inn (Lkr);47 bis unter 48;1648;875;773
09183;      Mühldorf a.Inn (Lkr);48 bis unter 49;1683;876;807
09183;      Mühldorf a.Inn (Lkr);49 bis unter 50;1920;983;937
09183;      Mühldorf a.Inn (Lkr);50 bis unter 51;1888;970;918
09183;      Mühldorf a.Inn (Lkr);51 bis unter 52;1968;1021;947
09183;      Mühldorf a.Inn (Lkr);52 bis unter 53;1964;1033;931
09183;      Mühldorf a.Inn (Lkr);53 bis unter 54;1931;984;947
09183;      Mühldorf a.Inn (Lkr);54 bis unter 55;1971;1016;955
09183;      Mühldorf a.Inn (Lkr);55 bis unter 56;1936;1004;932
09183;      Mühldorf a.Inn (Lkr);56 bis unter 57;1960;979;981
09183;      Mühldorf a.Inn (Lkr);57 bis unter 58;1889;939;950
09183;      Mühldorf a.Inn (Lkr);58 bis unter 59;1792;926;866
09183;      Mühldorf a.Inn (Lkr);59 bis unter 60;1787;889;898
09183;      Mühldorf a.Inn (Lkr);60 bis unter 61;1691;857;834
09183;      Mühldorf a.Inn (Lkr);61 bis unter 62;1542;788;754
09183;      Mühldorf a.Inn (Lkr);62 bis unter 63;1586;818;768
09183;      Mühldorf a.Inn (Lkr);63 bis unter 64;1409;695;714
09183;      Mühldorf a.Inn (Lkr);64 bis unter 65;1359;680;679
09183;      Mühldorf a.Inn (Lkr);65 bis unter 66;1293;651;642
09183;      Mühldorf a.Inn (Lkr);66 bis unter 67;1348;680;668
09183;      Mühldorf a.Inn (Lkr);67 bis unter 68;1293;629;664
09183;      Mühldorf a.Inn (Lkr);68 bis unter 69;1204;543;661
09183;      Mühldorf a.Inn (Lkr);69 bis unter 70;1246;580;666
09183;      Mühldorf a.Inn (Lkr);70 bis unter 71;1135;556;579
09183;      Mühldorf a.Inn (Lkr);71 bis unter 72;1106;504;602
09183;      Mühldorf a.Inn (Lkr);72 bis unter 73;951;442;509
09183;      Mühldorf a.Inn (Lkr);73 bis unter 74;742;367;375
09183;      Mühldorf a.Inn (Lkr);74 bis unter 75;968;458;510
09183;      Mühldorf a.Inn (Lkr);75 bis unter 76;956;462;494
09183;      Mühldorf a.Inn (Lkr);76 bis unter 77;952;453;499
09183;      Mühldorf a.Inn (Lkr);77 bis unter 78;1122;506;616
09183;      Mühldorf a.Inn (Lkr);78 bis unter 79;1151;510;641
09183;      Mühldorf a.Inn (Lkr);79 bis unter 80;1058;472;586
09183;      Mühldorf a.Inn (Lkr);80 bis unter 81;852;376;476
09183;      Mühldorf a.Inn (Lkr);81 bis unter 82;843;368;475
09183;      Mühldorf a.Inn (Lkr);82 bis unter 83;724;292;432
09183;      Mühldorf a.Inn (Lkr);83 bis unter 84;670;265;405
09183;      Mühldorf a.Inn (Lkr);84 bis unter 85;582;221;361
09183;      Mühldorf a.Inn (Lkr);85 bis unter 90;1837;635;1202
09183;      Mühldorf a.Inn (Lkr);90 bis unter 95;741;224;517
09183;      Mühldorf a.Inn (Lkr);95 oder älter;147;23;124
09183;      Mühldorf a.Inn (Lkr);Insgesamt;115250;58360;56890
09184;      München (Lkr);unter 1;3254;1618;1636
09184;      München (Lkr);1 bis unter 2;3323;1707;1616
09184;      München (Lkr);2 bis unter 3;3573;1857;1716
09184;      München (Lkr);3 bis unter 4;3615;1879;1736
09184;      München (Lkr);4 bis unter 5;3552;1828;1724
09184;      München (Lkr);5 bis unter 6;3455;1714;1741
09184;      München (Lkr);6 bis unter 7;3577;1808;1769
09184;      München (Lkr);7 bis unter 8;3387;1785;1602
09184;      München (Lkr);8 bis unter 9;3646;1894;1752
09184;      München (Lkr);9 bis unter 10;3692;1919;1773
09184;      München (Lkr);10 bis unter 11;3741;1908;1833
09184;      München (Lkr);11 bis unter 12;3672;1864;1808
09184;      München (Lkr);12 bis unter 13;3539;1809;1730
09184;      München (Lkr);13 bis unter 14;3584;1848;1736
09184;      München (Lkr);14 bis unter 15;3614;1888;1726
09184;      München (Lkr);15 bis unter 16;3437;1766;1671
09184;      München (Lkr);16 bis unter 17;3344;1767;1577
09184;      München (Lkr);17 bis unter 18;3325;1722;1603
09184;      München (Lkr);18 bis unter 19;3489;1843;1646
09184;      München (Lkr);19 bis unter 20;3699;1934;1765
09184;      München (Lkr);20 bis unter 21;3920;2156;1764
09184;      München (Lkr);21 bis unter 22;4410;2512;1898
09184;      München (Lkr);22 bis unter 23;4069;2350;1719
09184;      München (Lkr);23 bis unter 24;4040;2309;1731
09184;      München (Lkr);24 bis unter 25;3858;2119;1739
09184;      München (Lkr);25 bis unter 26;4063;2234;1829
09184;      München (Lkr);26 bis unter 27;3834;2073;1761
09184;      München (Lkr);27 bis unter 28;3860;2040;1820
09184;      München (Lkr);28 bis unter 29;4238;2313;1925
09184;      München (Lkr);29 bis unter 30;4164;2118;2046
09184;      München (Lkr);30 bis unter 31;4119;2230;1889
09184;      München (Lkr);31 bis unter 32;4202;2176;2026
09184;      München (Lkr);32 bis unter 33;4167;2118;2049
09184;      München (Lkr);33 bis unter 34;4117;2099;2018
09184;      München (Lkr);34 bis unter 35;4135;2051;2084
09184;      München (Lkr);35 bis unter 36;4327;2220;2107
09184;      München (Lkr);36 bis unter 37;4601;2259;2342
09184;      München (Lkr);37 bis unter 38;4663;2274;2389
09184;      München (Lkr);38 bis unter 39;4807;2321;2486
09184;      München (Lkr);39 bis unter 40;4840;2409;2431
09184;      München (Lkr);40 bis unter 41;4636;2233;2403
09184;      München (Lkr);41 bis unter 42;4757;2385;2372
09184;      München (Lkr);42 bis unter 43;4682;2333;2349
09184;      München (Lkr);43 bis unter 44;4772;2362;2410
09184;      München (Lkr);44 bis unter 45;4567;2214;2353
09184;      München (Lkr);45 bis unter 46;4548;2226;2322
09184;      München (Lkr);46 bis unter 47;4868;2463;2405
09184;      München (Lkr);47 bis unter 48;5312;2603;2709
09184;      München (Lkr);48 bis unter 49;5402;2656;2746
09184;      München (Lkr);49 bis unter 50;5781;3013;2768
09184;      München (Lkr);50 bis unter 51;6146;3130;3016
09184;      München (Lkr);51 bis unter 52;6366;3269;3097
09184;      München (Lkr);52 bis unter 53;5975;3023;2952
09184;      München (Lkr);53 bis unter 54;5963;3034;2929
09184;      München (Lkr);54 bis unter 55;5714;2847;2867
09184;      München (Lkr);55 bis unter 56;5514;2792;2722
09184;      München (Lkr);56 bis unter 57;5174;2581;2593
09184;      München (Lkr);57 bis unter 58;4896;2486;2410
09184;      München (Lkr);58 bis unter 59;4565;2276;2289
09184;      München (Lkr);59 bis unter 60;4325;2176;2149
09184;      München (Lkr);60 bis unter 61;4162;2051;2111
09184;      München (Lkr);61 bis unter 62;3979;1969;2010
09184;      München (Lkr);62 bis unter 63;3717;1853;1864
09184;      München (Lkr);63 bis unter 64;3512;1711;1801
09184;      München (Lkr);64 bis unter 65;3264;1553;1711
09184;      München (Lkr);65 bis unter 66;3213;1491;1722
09184;      München (Lkr);66 bis unter 67;3208;1458;1750
09184;      München (Lkr);67 bis unter 68;3097;1433;1664
09184;      München (Lkr);68 bis unter 69;3148;1434;1714
09184;      München (Lkr);69 bis unter 70;3253;1442;1811
09184;      München (Lkr);70 bis unter 71;3237;1427;1810
09184;      München (Lkr);71 bis unter 72;3363;1540;1823
09184;      München (Lkr);72 bis unter 73;3086;1380;1706
09184;      München (Lkr);73 bis unter 74;2750;1263;1487
09184;      München (Lkr);74 bis unter 75;3575;1628;1947
09184;      München (Lkr);75 bis unter 76;3559;1649;1910
09184;      München (Lkr);76 bis unter 77;3438;1558;1880
09184;      München (Lkr);77 bis unter 78;3905;1756;2149
09184;      München (Lkr);78 bis unter 79;3912;1773;2139
09184;      München (Lkr);79 bis unter 80;3693;1656;2037
09184;      München (Lkr);80 bis unter 81;3076;1404;1672
09184;      München (Lkr);81 bis unter 82;2647;1201;1446
09184;      München (Lkr);82 bis unter 83;2458;1091;1367
09184;      München (Lkr);83 bis unter 84;2211;1014;1197
09184;      München (Lkr);84 bis unter 85;1757;809;948
09184;      München (Lkr);85 bis unter 90;5515;2255;3260
09184;      München (Lkr);90 bis unter 95;2497;781;1716
09184;      München (Lkr);95 oder älter;724;180;544
09184;      München (Lkr);Insgesamt;348871;173601;175270
09185;      Neuburg-Schrobenhausen (Lkr);unter 1;981;494;487
09185;      Neuburg-Schrobenhausen (Lkr);1 bis unter 2;1005;502;503
09185;      Neuburg-Schrobenhausen (Lkr);2 bis unter 3;1002;515;487
09185;      Neuburg-Schrobenhausen (Lkr);3 bis unter 4;982;494;488
09185;      Neuburg-Schrobenhausen (Lkr);4 bis unter 5;952;495;457
09185;      Neuburg-Schrobenhausen (Lkr);5 bis unter 6;974;472;502
09185;      Neuburg-Schrobenhausen (Lkr);6 bis unter 7;958;474;484
09185;      Neuburg-Schrobenhausen (Lkr);7 bis unter 8;869;487;382
09185;      Neuburg-Schrobenhausen (Lkr);8 bis unter 9;971;498;473
09185;      Neuburg-Schrobenhausen (Lkr);9 bis unter 10;844;459;385
09185;      Neuburg-Schrobenhausen (Lkr);10 bis unter 11;926;446;480
09185;      Neuburg-Schrobenhausen (Lkr);11 bis unter 12;926;451;475
09185;      Neuburg-Schrobenhausen (Lkr);12 bis unter 13;868;453;415
09185;      Neuburg-Schrobenhausen (Lkr);13 bis unter 14;918;479;439
09185;      Neuburg-Schrobenhausen (Lkr);14 bis unter 15;919;481;438
09185;      Neuburg-Schrobenhausen (Lkr);15 bis unter 16;1010;526;484
09185;      Neuburg-Schrobenhausen (Lkr);16 bis unter 17;962;479;483
09185;      Neuburg-Schrobenhausen (Lkr);17 bis unter 18;1028;525;503
09185;      Neuburg-Schrobenhausen (Lkr);18 bis unter 19;1071;563;508
09185;      Neuburg-Schrobenhausen (Lkr);19 bis unter 20;1032;551;481
09185;      Neuburg-Schrobenhausen (Lkr);20 bis unter 21;1129;580;549
09185;      Neuburg-Schrobenhausen (Lkr);21 bis unter 22;1167;651;516
09185;      Neuburg-Schrobenhausen (Lkr);22 bis unter 23;1076;599;477
09185;      Neuburg-Schrobenhausen (Lkr);23 bis unter 24;1055;572;483
09185;      Neuburg-Schrobenhausen (Lkr);24 bis unter 25;1076;574;502
09185;      Neuburg-Schrobenhausen (Lkr);25 bis unter 26;1132;583;549
09185;      Neuburg-Schrobenhausen (Lkr);26 bis unter 27;1158;608;550
09185;      Neuburg-Schrobenhausen (Lkr);27 bis unter 28;1180;629;551
09185;      Neuburg-Schrobenhausen (Lkr);28 bis unter 29;1224;669;555
09185;      Neuburg-Schrobenhausen (Lkr);29 bis unter 30;1149;612;537
09185;      Neuburg-Schrobenhausen (Lkr);30 bis unter 31;1192;594;598
09185;      Neuburg-Schrobenhausen (Lkr);31 bis unter 32;1287;708;579
09185;      Neuburg-Schrobenhausen (Lkr);32 bis unter 33;1194;634;560
09185;      Neuburg-Schrobenhausen (Lkr);33 bis unter 34;1242;624;618
09185;      Neuburg-Schrobenhausen (Lkr);34 bis unter 35;1262;651;611
09185;      Neuburg-Schrobenhausen (Lkr);35 bis unter 36;1255;620;635
09185;      Neuburg-Schrobenhausen (Lkr);36 bis unter 37;1229;634;595
09185;      Neuburg-Schrobenhausen (Lkr);37 bis unter 38;1342;695;647
09185;      Neuburg-Schrobenhausen (Lkr);38 bis unter 39;1292;641;651
09185;      Neuburg-Schrobenhausen (Lkr);39 bis unter 40;1288;678;610
09185;      Neuburg-Schrobenhausen (Lkr);40 bis unter 41;1232;643;589
09185;      Neuburg-Schrobenhausen (Lkr);41 bis unter 42;1231;655;576
09185;      Neuburg-Schrobenhausen (Lkr);42 bis unter 43;1234;692;542
09185;      Neuburg-Schrobenhausen (Lkr);43 bis unter 44;1190;598;592
09185;      Neuburg-Schrobenhausen (Lkr);44 bis unter 45;1186;586;600
09185;      Neuburg-Schrobenhausen (Lkr);45 bis unter 46;1197;610;587
09185;      Neuburg-Schrobenhausen (Lkr);46 bis unter 47;1271;679;592
09185;      Neuburg-Schrobenhausen (Lkr);47 bis unter 48;1381;699;682
09185;      Neuburg-Schrobenhausen (Lkr);48 bis unter 49;1415;714;701
09185;      Neuburg-Schrobenhausen (Lkr);49 bis unter 50;1556;820;736
09185;      Neuburg-Schrobenhausen (Lkr);50 bis unter 51;1567;827;740
09185;      Neuburg-Schrobenhausen (Lkr);51 bis unter 52;1618;821;797
09185;      Neuburg-Schrobenhausen (Lkr);52 bis unter 53;1579;802;777
09185;      Neuburg-Schrobenhausen (Lkr);53 bis unter 54;1614;847;767
09185;      Neuburg-Schrobenhausen (Lkr);54 bis unter 55;1653;838;815
09185;      Neuburg-Schrobenhausen (Lkr);55 bis unter 56;1604;847;757
09185;      Neuburg-Schrobenhausen (Lkr);56 bis unter 57;1628;804;824
09185;      Neuburg-Schrobenhausen (Lkr);57 bis unter 58;1604;813;791
09185;      Neuburg-Schrobenhausen (Lkr);58 bis unter 59;1543;774;769
09185;      Neuburg-Schrobenhausen (Lkr);59 bis unter 60;1455;732;723
09185;      Neuburg-Schrobenhausen (Lkr);60 bis unter 61;1414;719;695
09185;      Neuburg-Schrobenhausen (Lkr);61 bis unter 62;1392;681;711
09185;      Neuburg-Schrobenhausen (Lkr);62 bis unter 63;1257;630;627
09185;      Neuburg-Schrobenhausen (Lkr);63 bis unter 64;1193;584;609
09185;      Neuburg-Schrobenhausen (Lkr);64 bis unter 65;1147;578;569
09185;      Neuburg-Schrobenhausen (Lkr);65 bis unter 66;1068;508;560
09185;      Neuburg-Schrobenhausen (Lkr);66 bis unter 67;1033;519;514
09185;      Neuburg-Schrobenhausen (Lkr);67 bis unter 68;1037;522;515
09185;      Neuburg-Schrobenhausen (Lkr);68 bis unter 69;1005;499;506
09185;      Neuburg-Schrobenhausen (Lkr);69 bis unter 70;960;455;505
09185;      Neuburg-Schrobenhausen (Lkr);70 bis unter 71;928;456;472
09185;      Neuburg-Schrobenhausen (Lkr);71 bis unter 72;837;411;426
09185;      Neuburg-Schrobenhausen (Lkr);72 bis unter 73;729;336;393
09185;      Neuburg-Schrobenhausen (Lkr);73 bis unter 74;559;272;287
09185;      Neuburg-Schrobenhausen (Lkr);74 bis unter 75;746;352;394
09185;      Neuburg-Schrobenhausen (Lkr);75 bis unter 76;798;400;398
09185;      Neuburg-Schrobenhausen (Lkr);76 bis unter 77;759;357;402
09185;      Neuburg-Schrobenhausen (Lkr);77 bis unter 78;863;412;451
09185;      Neuburg-Schrobenhausen (Lkr);78 bis unter 79;935;410;525
09185;      Neuburg-Schrobenhausen (Lkr);79 bis unter 80;881;413;468
09185;      Neuburg-Schrobenhausen (Lkr);80 bis unter 81;764;351;413
09185;      Neuburg-Schrobenhausen (Lkr);81 bis unter 82;686;279;407
09185;      Neuburg-Schrobenhausen (Lkr);82 bis unter 83;561;248;313
09185;      Neuburg-Schrobenhausen (Lkr);83 bis unter 84;556;208;348
09185;      Neuburg-Schrobenhausen (Lkr);84 bis unter 85;480;185;295
09185;      Neuburg-Schrobenhausen (Lkr);85 bis unter 90;1531;518;1013
09185;      Neuburg-Schrobenhausen (Lkr);90 bis unter 95;581;147;434
09185;      Neuburg-Schrobenhausen (Lkr);95 oder älter;95;28;67
09185;      Neuburg-Schrobenhausen (Lkr);Insgesamt;96680;48679;48001
09186;      Pfaffenhofen a.d.Ilm (Lkr);unter 1;1302;699;603
09186;      Pfaffenhofen a.d.Ilm (Lkr);1 bis unter 2;1392;713;679
09186;      Pfaffenhofen a.d.Ilm (Lkr);2 bis unter 3;1340;655;685
09186;      Pfaffenhofen a.d.Ilm (Lkr);3 bis unter 4;1275;670;605
09186;      Pfaffenhofen a.d.Ilm (Lkr);4 bis unter 5;1296;674;622
09186;      Pfaffenhofen a.d.Ilm (Lkr);5 bis unter 6;1254;596;658
09186;      Pfaffenhofen a.d.Ilm (Lkr);6 bis unter 7;1242;630;612
09186;      Pfaffenhofen a.d.Ilm (Lkr);7 bis unter 8;1209;605;604
09186;      Pfaffenhofen a.d.Ilm (Lkr);8 bis unter 9;1201;602;599
09186;      Pfaffenhofen a.d.Ilm (Lkr);9 bis unter 10;1146;584;562
09186;      Pfaffenhofen a.d.Ilm (Lkr);10 bis unter 11;1196;649;547
09186;      Pfaffenhofen a.d.Ilm (Lkr);11 bis unter 12;1159;594;565
09186;      Pfaffenhofen a.d.Ilm (Lkr);12 bis unter 13;1177;609;568
09186;      Pfaffenhofen a.d.Ilm (Lkr);13 bis unter 14;1140;571;569
09186;      Pfaffenhofen a.d.Ilm (Lkr);14 bis unter 15;1243;631;612
09186;      Pfaffenhofen a.d.Ilm (Lkr);15 bis unter 16;1205;595;610
09186;      Pfaffenhofen a.d.Ilm (Lkr);16 bis unter 17;1210;618;592
09186;      Pfaffenhofen a.d.Ilm (Lkr);17 bis unter 18;1253;656;597
09186;      Pfaffenhofen a.d.Ilm (Lkr);18 bis unter 19;1354;692;662
09186;      Pfaffenhofen a.d.Ilm (Lkr);19 bis unter 20;1295;694;601
09186;      Pfaffenhofen a.d.Ilm (Lkr);20 bis unter 21;1424;777;647
09186;      Pfaffenhofen a.d.Ilm (Lkr);21 bis unter 22;1442;778;664
09186;      Pfaffenhofen a.d.Ilm (Lkr);22 bis unter 23;1441;783;658
09186;      Pfaffenhofen a.d.Ilm (Lkr);23 bis unter 24;1403;758;645
09186;      Pfaffenhofen a.d.Ilm (Lkr);24 bis unter 25;1415;770;645
09186;      Pfaffenhofen a.d.Ilm (Lkr);25 bis unter 26;1532;829;703
09186;      Pfaffenhofen a.d.Ilm (Lkr);26 bis unter 27;1575;842;733
09186;      Pfaffenhofen a.d.Ilm (Lkr);27 bis unter 28;1515;840;675
09186;      Pfaffenhofen a.d.Ilm (Lkr);28 bis unter 29;1665;890;775
09186;      Pfaffenhofen a.d.Ilm (Lkr);29 bis unter 30;1703;932;771
09186;      Pfaffenhofen a.d.Ilm (Lkr);30 bis unter 31;1725;925;800
09186;      Pfaffenhofen a.d.Ilm (Lkr);31 bis unter 32;1693;898;795
09186;      Pfaffenhofen a.d.Ilm (Lkr);32 bis unter 33;1750;935;815
09186;      Pfaffenhofen a.d.Ilm (Lkr);33 bis unter 34;1762;906;856
09186;      Pfaffenhofen a.d.Ilm (Lkr);34 bis unter 35;1816;929;887
09186;      Pfaffenhofen a.d.Ilm (Lkr);35 bis unter 36;1700;871;829
09186;      Pfaffenhofen a.d.Ilm (Lkr);36 bis unter 37;1847;939;908
09186;      Pfaffenhofen a.d.Ilm (Lkr);37 bis unter 38;1811;929;882
09186;      Pfaffenhofen a.d.Ilm (Lkr);38 bis unter 39;1746;937;809
09186;      Pfaffenhofen a.d.Ilm (Lkr);39 bis unter 40;1736;873;863
09186;      Pfaffenhofen a.d.Ilm (Lkr);40 bis unter 41;1649;875;774
09186;      Pfaffenhofen a.d.Ilm (Lkr);41 bis unter 42;1707;918;789
09186;      Pfaffenhofen a.d.Ilm (Lkr);42 bis unter 43;1641;894;747
09186;      Pfaffenhofen a.d.Ilm (Lkr);43 bis unter 44;1563;846;717
09186;      Pfaffenhofen a.d.Ilm (Lkr);44 bis unter 45;1564;800;764
09186;      Pfaffenhofen a.d.Ilm (Lkr);45 bis unter 46;1586;793;793
09186;      Pfaffenhofen a.d.Ilm (Lkr);46 bis unter 47;1617;856;761
09186;      Pfaffenhofen a.d.Ilm (Lkr);47 bis unter 48;1845;959;886
09186;      Pfaffenhofen a.d.Ilm (Lkr);48 bis unter 49;1811;934;877
09186;      Pfaffenhofen a.d.Ilm (Lkr);49 bis unter 50;2076;1097;979
09186;      Pfaffenhofen a.d.Ilm (Lkr);50 bis unter 51;2122;1108;1014
09186;      Pfaffenhofen a.d.Ilm (Lkr);51 bis unter 52;2159;1122;1037
09186;      Pfaffenhofen a.d.Ilm (Lkr);52 bis unter 53;2221;1171;1050
09186;      Pfaffenhofen a.d.Ilm (Lkr);53 bis unter 54;2193;1120;1073
09186;      Pfaffenhofen a.d.Ilm (Lkr);54 bis unter 55;2218;1123;1095
09186;      Pfaffenhofen a.d.Ilm (Lkr);55 bis unter 56;2171;1079;1092
09186;      Pfaffenhofen a.d.Ilm (Lkr);56 bis unter 57;2147;1134;1013
09186;      Pfaffenhofen a.d.Ilm (Lkr);57 bis unter 58;2121;1098;1023
09186;      Pfaffenhofen a.d.Ilm (Lkr);58 bis unter 59;1984;998;986
09186;      Pfaffenhofen a.d.Ilm (Lkr);59 bis unter 60;1891;945;946
09186;      Pfaffenhofen a.d.Ilm (Lkr);60 bis unter 61;1853;976;877
09186;      Pfaffenhofen a.d.Ilm (Lkr);61 bis unter 62;1738;876;862
09186;      Pfaffenhofen a.d.Ilm (Lkr);62 bis unter 63;1620;808;812
09186;      Pfaffenhofen a.d.Ilm (Lkr);63 bis unter 64;1492;747;745
09186;      Pfaffenhofen a.d.Ilm (Lkr);64 bis unter 65;1485;750;735
09186;      Pfaffenhofen a.d.Ilm (Lkr);65 bis unter 66;1421;697;724
09186;      Pfaffenhofen a.d.Ilm (Lkr);66 bis unter 67;1328;632;696
09186;      Pfaffenhofen a.d.Ilm (Lkr);67 bis unter 68;1285;636;649
09186;      Pfaffenhofen a.d.Ilm (Lkr);68 bis unter 69;1207;578;629
09186;      Pfaffenhofen a.d.Ilm (Lkr);69 bis unter 70;1173;570;603
09186;      Pfaffenhofen a.d.Ilm (Lkr);70 bis unter 71;1153;554;599
09186;      Pfaffenhofen a.d.Ilm (Lkr);71 bis unter 72;1063;514;549
09186;      Pfaffenhofen a.d.Ilm (Lkr);72 bis unter 73;950;462;488
09186;      Pfaffenhofen a.d.Ilm (Lkr);73 bis unter 74;810;382;428
09186;      Pfaffenhofen a.d.Ilm (Lkr);74 bis unter 75;949;445;504
09186;      Pfaffenhofen a.d.Ilm (Lkr);75 bis unter 76;917;453;464
09186;      Pfaffenhofen a.d.Ilm (Lkr);76 bis unter 77;928;447;481
09186;      Pfaffenhofen a.d.Ilm (Lkr);77 bis unter 78;1057;479;578
09186;      Pfaffenhofen a.d.Ilm (Lkr);78 bis unter 79;1160;548;612
09186;      Pfaffenhofen a.d.Ilm (Lkr);79 bis unter 80;1087;488;599
09186;      Pfaffenhofen a.d.Ilm (Lkr);80 bis unter 81;971;470;501
09186;      Pfaffenhofen a.d.Ilm (Lkr);81 bis unter 82;871;369;502
09186;      Pfaffenhofen a.d.Ilm (Lkr);82 bis unter 83;742;316;426
09186;      Pfaffenhofen a.d.Ilm (Lkr);83 bis unter 84;649;287;362
09186;      Pfaffenhofen a.d.Ilm (Lkr);84 bis unter 85;599;247;352
09186;      Pfaffenhofen a.d.Ilm (Lkr);85 bis unter 90;1854;686;1168
09186;      Pfaffenhofen a.d.Ilm (Lkr);90 bis unter 95;750;230;520
09186;      Pfaffenhofen a.d.Ilm (Lkr);95 oder älter;163;44;119
09186;      Pfaffenhofen a.d.Ilm (Lkr);Insgesamt;127151;64639;62512
09187;      Rosenheim (Lkr);unter 1;2464;1284;1180
09187;      Rosenheim (Lkr);1 bis unter 2;2517;1288;1229
09187;      Rosenheim (Lkr);2 bis unter 3;2463;1224;1239
09187;      Rosenheim (Lkr);3 bis unter 4;2429;1286;1143
09187;      Rosenheim (Lkr);4 bis unter 5;2467;1287;1180
09187;      Rosenheim (Lkr);5 bis unter 6;2412;1177;1235
09187;      Rosenheim (Lkr);6 bis unter 7;2452;1252;1200
09187;      Rosenheim (Lkr);7 bis unter 8;2369;1201;1168
09187;      Rosenheim (Lkr);8 bis unter 9;2391;1222;1169
09187;      Rosenheim (Lkr);9 bis unter 10;2366;1243;1123
09187;      Rosenheim (Lkr);10 bis unter 11;2299;1220;1079
09187;      Rosenheim (Lkr);11 bis unter 12;2443;1255;1188
09187;      Rosenheim (Lkr);12 bis unter 13;2384;1261;1123
09187;      Rosenheim (Lkr);13 bis unter 14;2469;1295;1174
09187;      Rosenheim (Lkr);14 bis unter 15;2625;1345;1280
09187;      Rosenheim (Lkr);15 bis unter 16;2617;1321;1296
09187;      Rosenheim (Lkr);16 bis unter 17;2721;1451;1270
09187;      Rosenheim (Lkr);17 bis unter 18;2659;1376;1283
09187;      Rosenheim (Lkr);18 bis unter 19;2838;1448;1390
09187;      Rosenheim (Lkr);19 bis unter 20;2826;1556;1270
09187;      Rosenheim (Lkr);20 bis unter 21;2926;1560;1366
09187;      Rosenheim (Lkr);21 bis unter 22;2942;1617;1325
09187;      Rosenheim (Lkr);22 bis unter 23;2828;1519;1309
09187;      Rosenheim (Lkr);23 bis unter 24;2829;1539;1290
09187;      Rosenheim (Lkr);24 bis unter 25;2849;1616;1233
09187;      Rosenheim (Lkr);25 bis unter 26;2968;1544;1424
09187;      Rosenheim (Lkr);26 bis unter 27;3042;1591;1451
09187;      Rosenheim (Lkr);27 bis unter 28;3032;1652;1380
09187;      Rosenheim (Lkr);28 bis unter 29;3086;1605;1481
09187;      Rosenheim (Lkr);29 bis unter 30;3013;1579;1434
09187;      Rosenheim (Lkr);30 bis unter 31;3207;1680;1527
09187;      Rosenheim (Lkr);31 bis unter 32;2968;1548;1420
09187;      Rosenheim (Lkr);32 bis unter 33;3139;1645;1494
09187;      Rosenheim (Lkr);33 bis unter 34;2966;1534;1432
09187;      Rosenheim (Lkr);34 bis unter 35;3004;1526;1478
09187;      Rosenheim (Lkr);35 bis unter 36;3017;1564;1453
09187;      Rosenheim (Lkr);36 bis unter 37;3242;1660;1582
09187;      Rosenheim (Lkr);37 bis unter 38;3208;1591;1617
09187;      Rosenheim (Lkr);38 bis unter 39;3167;1630;1537
09187;      Rosenheim (Lkr);39 bis unter 40;3070;1513;1557
09187;      Rosenheim (Lkr);40 bis unter 41;2922;1403;1519
09187;      Rosenheim (Lkr);41 bis unter 42;3094;1534;1560
09187;      Rosenheim (Lkr);42 bis unter 43;3019;1483;1536
09187;      Rosenheim (Lkr);43 bis unter 44;3069;1485;1584
09187;      Rosenheim (Lkr);44 bis unter 45;3090;1532;1558
09187;      Rosenheim (Lkr);45 bis unter 46;3066;1501;1565
09187;      Rosenheim (Lkr);46 bis unter 47;3438;1723;1715
09187;      Rosenheim (Lkr);47 bis unter 48;3812;1871;1941
09187;      Rosenheim (Lkr);48 bis unter 49;3965;1948;2017
09187;      Rosenheim (Lkr);49 bis unter 50;4331;2181;2150
09187;      Rosenheim (Lkr);50 bis unter 51;4479;2239;2240
09187;      Rosenheim (Lkr);51 bis unter 52;4597;2262;2335
09187;      Rosenheim (Lkr);52 bis unter 53;4765;2332;2433
09187;      Rosenheim (Lkr);53 bis unter 54;4559;2284;2275
09187;      Rosenheim (Lkr);54 bis unter 55;4565;2243;2322
09187;      Rosenheim (Lkr);55 bis unter 56;4466;2156;2310
09187;      Rosenheim (Lkr);56 bis unter 57;4444;2219;2225
09187;      Rosenheim (Lkr);57 bis unter 58;4272;2067;2205
09187;      Rosenheim (Lkr);58 bis unter 59;4019;2006;2013
09187;      Rosenheim (Lkr);59 bis unter 60;3902;1934;1968
09187;      Rosenheim (Lkr);60 bis unter 61;3728;1849;1879
09187;      Rosenheim (Lkr);61 bis unter 62;3622;1790;1832
09187;      Rosenheim (Lkr);62 bis unter 63;3226;1593;1633
09187;      Rosenheim (Lkr);63 bis unter 64;3226;1584;1642
09187;      Rosenheim (Lkr);64 bis unter 65;3040;1427;1613
09187;      Rosenheim (Lkr);65 bis unter 66;2913;1388;1525
09187;      Rosenheim (Lkr);66 bis unter 67;2920;1389;1531
09187;      Rosenheim (Lkr);67 bis unter 68;2896;1399;1497
09187;      Rosenheim (Lkr);68 bis unter 69;2881;1390;1491
09187;      Rosenheim (Lkr);69 bis unter 70;2893;1338;1555
09187;      Rosenheim (Lkr);70 bis unter 71;2770;1282;1488
09187;      Rosenheim (Lkr);71 bis unter 72;2831;1352;1479
09187;      Rosenheim (Lkr);72 bis unter 73;2512;1162;1350
09187;      Rosenheim (Lkr);73 bis unter 74;1937;927;1010
09187;      Rosenheim (Lkr);74 bis unter 75;2567;1198;1369
09187;      Rosenheim (Lkr);75 bis unter 76;2405;1107;1298
09187;      Rosenheim (Lkr);76 bis unter 77;2381;1132;1249
09187;      Rosenheim (Lkr);77 bis unter 78;2743;1277;1466
09187;      Rosenheim (Lkr);78 bis unter 79;2776;1279;1497
09187;      Rosenheim (Lkr);79 bis unter 80;2643;1195;1448
09187;      Rosenheim (Lkr);80 bis unter 81;2303;1033;1270
09187;      Rosenheim (Lkr);81 bis unter 82;1982;892;1090
09187;      Rosenheim (Lkr);82 bis unter 83;1708;769;939
09187;      Rosenheim (Lkr);83 bis unter 84;1598;668;930
09187;      Rosenheim (Lkr);84 bis unter 85;1292;508;784
09187;      Rosenheim (Lkr);85 bis unter 90;4176;1572;2604
09187;      Rosenheim (Lkr);90 bis unter 95;1878;544;1334
09187;      Rosenheim (Lkr);95 oder älter;548;101;447
09187;      Rosenheim (Lkr);Insgesamt;260983;129253;131730
09188;      Starnberg (Lkr);unter 1;1207;595;612
09188;      Starnberg (Lkr);1 bis unter 2;1214;626;588
09188;      Starnberg (Lkr);2 bis unter 3;1265;646;619
09188;      Starnberg (Lkr);3 bis unter 4;1318;703;615
09188;      Starnberg (Lkr);4 bis unter 5;1297;635;662
09188;      Starnberg (Lkr);5 bis unter 6;1261;655;606
09188;      Starnberg (Lkr);6 bis unter 7;1387;710;677
09188;      Starnberg (Lkr);7 bis unter 8;1320;672;648
09188;      Starnberg (Lkr);8 bis unter 9;1350;694;656
09188;      Starnberg (Lkr);9 bis unter 10;1394;689;705
09188;      Starnberg (Lkr);10 bis unter 11;1407;735;672
09188;      Starnberg (Lkr);11 bis unter 12;1423;735;688
09188;      Starnberg (Lkr);12 bis unter 13;1357;704;653
09188;      Starnberg (Lkr);13 bis unter 14;1434;727;707
09188;      Starnberg (Lkr);14 bis unter 15;1440;764;676
09188;      Starnberg (Lkr);15 bis unter 16;1437;716;721
09188;      Starnberg (Lkr);16 bis unter 17;1434;732;702
09188;      Starnberg (Lkr);17 bis unter 18;1540;799;741
09188;      Starnberg (Lkr);18 bis unter 19;1494;766;728
09188;      Starnberg (Lkr);19 bis unter 20;1435;765;670
09188;      Starnberg (Lkr);20 bis unter 21;1473;782;691
09188;      Starnberg (Lkr);21 bis unter 22;1494;824;670
09188;      Starnberg (Lkr);22 bis unter 23;1354;683;671
09188;      Starnberg (Lkr);23 bis unter 24;1293;702;591
09188;      Starnberg (Lkr);24 bis unter 25;1335;737;598
09188;      Starnberg (Lkr);25 bis unter 26;1290;690;600
09188;      Starnberg (Lkr);26 bis unter 27;1241;703;538
09188;      Starnberg (Lkr);27 bis unter 28;1324;691;633
09188;      Starnberg (Lkr);28 bis unter 29;1408;715;693
09188;      Starnberg (Lkr);29 bis unter 30;1276;638;638
09188;      Starnberg (Lkr);30 bis unter 31;1343;691;652
09188;      Starnberg (Lkr);31 bis unter 32;1263;631;632
09188;      Starnberg (Lkr);32 bis unter 33;1248;615;633
09188;      Starnberg (Lkr);33 bis unter 34;1322;651;671
09188;      Starnberg (Lkr);34 bis unter 35;1363;648;715
09188;      Starnberg (Lkr);35 bis unter 36;1434;685;749
09188;      Starnberg (Lkr);36 bis unter 37;1469;688;781
09188;      Starnberg (Lkr);37 bis unter 38;1613;773;840
09188;      Starnberg (Lkr);38 bis unter 39;1725;819;906
09188;      Starnberg (Lkr);39 bis unter 40;1548;722;826
09188;      Starnberg (Lkr);40 bis unter 41;1566;756;810
09188;      Starnberg (Lkr);41 bis unter 42;1687;825;862
09188;      Starnberg (Lkr);42 bis unter 43;1675;770;905
09188;      Starnberg (Lkr);43 bis unter 44;1672;766;906
09188;      Starnberg (Lkr);44 bis unter 45;1713;799;914
09188;      Starnberg (Lkr);45 bis unter 46;1742;860;882
09188;      Starnberg (Lkr);46 bis unter 47;1794;826;968
09188;      Starnberg (Lkr);47 bis unter 48;2003;968;1035
09188;      Starnberg (Lkr);48 bis unter 49;2146;1031;1115
09188;      Starnberg (Lkr);49 bis unter 50;2217;1134;1083
09188;      Starnberg (Lkr);50 bis unter 51;2464;1228;1236
09188;      Starnberg (Lkr);51 bis unter 52;2504;1240;1264
09188;      Starnberg (Lkr);52 bis unter 53;2598;1232;1366
09188;      Starnberg (Lkr);53 bis unter 54;2543;1235;1308
09188;      Starnberg (Lkr);54 bis unter 55;2534;1288;1246
09188;      Starnberg (Lkr);55 bis unter 56;2348;1145;1203
09188;      Starnberg (Lkr);56 bis unter 57;2165;1049;1116
09188;      Starnberg (Lkr);57 bis unter 58;2141;1027;1114
09188;      Starnberg (Lkr);58 bis unter 59;1971;997;974
09188;      Starnberg (Lkr);59 bis unter 60;1951;945;1006
09188;      Starnberg (Lkr);60 bis unter 61;1787;866;921
09188;      Starnberg (Lkr);61 bis unter 62;1796;851;945
09188;      Starnberg (Lkr);62 bis unter 63;1672;789;883
09188;      Starnberg (Lkr);63 bis unter 64;1520;695;825
09188;      Starnberg (Lkr);64 bis unter 65;1477;693;784
09188;      Starnberg (Lkr);65 bis unter 66;1365;638;727
09188;      Starnberg (Lkr);66 bis unter 67;1384;652;732
09188;      Starnberg (Lkr);67 bis unter 68;1410;612;798
09188;      Starnberg (Lkr);68 bis unter 69;1433;670;763
09188;      Starnberg (Lkr);69 bis unter 70;1436;635;801
09188;      Starnberg (Lkr);70 bis unter 71;1434;627;807
09188;      Starnberg (Lkr);71 bis unter 72;1449;685;764
09188;      Starnberg (Lkr);72 bis unter 73;1323;590;733
09188;      Starnberg (Lkr);73 bis unter 74;1197;528;669
09188;      Starnberg (Lkr);74 bis unter 75;1554;700;854
09188;      Starnberg (Lkr);75 bis unter 76;1620;746;874
09188;      Starnberg (Lkr);76 bis unter 77;1488;670;818
09188;      Starnberg (Lkr);77 bis unter 78;1763;825;938
09188;      Starnberg (Lkr);78 bis unter 79;1680;777;903
09188;      Starnberg (Lkr);79 bis unter 80;1597;739;858
09188;      Starnberg (Lkr);80 bis unter 81;1288;591;697
09188;      Starnberg (Lkr);81 bis unter 82;1157;508;649
09188;      Starnberg (Lkr);82 bis unter 83;971;438;533
09188;      Starnberg (Lkr);83 bis unter 84;930;434;496
09188;      Starnberg (Lkr);84 bis unter 85;774;345;429
09188;      Starnberg (Lkr);85 bis unter 90;2376;973;1403
09188;      Starnberg (Lkr);90 bis unter 95;1206;393;813
09188;      Starnberg (Lkr);95 oder älter;341;73;268
09188;      Starnberg (Lkr);Insgesamt;136092;66020;70072
09189;      Traunstein (Lkr);unter 1;1613;808;805
09189;      Traunstein (Lkr);1 bis unter 2;1663;874;789
09189;      Traunstein (Lkr);2 bis unter 3;1619;827;792
09189;      Traunstein (Lkr);3 bis unter 4;1577;801;776
09189;      Traunstein (Lkr);4 bis unter 5;1601;820;781
09189;      Traunstein (Lkr);5 bis unter 6;1495;738;757
09189;      Traunstein (Lkr);6 bis unter 7;1520;796;724
09189;      Traunstein (Lkr);7 bis unter 8;1494;771;723
09189;      Traunstein (Lkr);8 bis unter 9;1458;730;728
09189;      Traunstein (Lkr);9 bis unter 10;1547;811;736
09189;      Traunstein (Lkr);10 bis unter 11;1688;875;813
09189;      Traunstein (Lkr);11 bis unter 12;1531;759;772
09189;      Traunstein (Lkr);12 bis unter 13;1605;777;828
09189;      Traunstein (Lkr);13 bis unter 14;1588;791;797
09189;      Traunstein (Lkr);14 bis unter 15;1641;817;824
09189;      Traunstein (Lkr);15 bis unter 16;1651;878;773
09189;      Traunstein (Lkr);16 bis unter 17;1724;904;820
09189;      Traunstein (Lkr);17 bis unter 18;1690;890;800
09189;      Traunstein (Lkr);18 bis unter 19;1843;935;908
09189;      Traunstein (Lkr);19 bis unter 20;1924;1027;897
09189;      Traunstein (Lkr);20 bis unter 21;1891;983;908
09189;      Traunstein (Lkr);21 bis unter 22;2041;1147;894
09189;      Traunstein (Lkr);22 bis unter 23;1984;1088;896
09189;      Traunstein (Lkr);23 bis unter 24;2003;1067;936
09189;      Traunstein (Lkr);24 bis unter 25;1970;1079;891
09189;      Traunstein (Lkr);25 bis unter 26;2099;1109;990
09189;      Traunstein (Lkr);26 bis unter 27;2144;1144;1000
09189;      Traunstein (Lkr);27 bis unter 28;2118;1108;1010
09189;      Traunstein (Lkr);28 bis unter 29;2167;1120;1047
09189;      Traunstein (Lkr);29 bis unter 30;2109;1076;1033
09189;      Traunstein (Lkr);30 bis unter 31;2127;1163;964
09189;      Traunstein (Lkr);31 bis unter 32;2084;1118;966
09189;      Traunstein (Lkr);32 bis unter 33;2101;1062;1039
09189;      Traunstein (Lkr);33 bis unter 34;2036;1012;1024
09189;      Traunstein (Lkr);34 bis unter 35;2014;1082;932
09189;      Traunstein (Lkr);35 bis unter 36;2041;1068;973
09189;      Traunstein (Lkr);36 bis unter 37;2124;1099;1025
09189;      Traunstein (Lkr);37 bis unter 38;2104;1062;1042
09189;      Traunstein (Lkr);38 bis unter 39;2075;1047;1028
09189;      Traunstein (Lkr);39 bis unter 40;2011;1025;986
09189;      Traunstein (Lkr);40 bis unter 41;2050;1023;1027
09189;      Traunstein (Lkr);41 bis unter 42;1985;1012;973
09189;      Traunstein (Lkr);42 bis unter 43;2044;1013;1031
09189;      Traunstein (Lkr);43 bis unter 44;1977;956;1021
09189;      Traunstein (Lkr);44 bis unter 45;2140;1088;1052
09189;      Traunstein (Lkr);45 bis unter 46;2054;1038;1016
09189;      Traunstein (Lkr);46 bis unter 47;2265;1159;1106
09189;      Traunstein (Lkr);47 bis unter 48;2357;1139;1218
09189;      Traunstein (Lkr);48 bis unter 49;2478;1243;1235
09189;      Traunstein (Lkr);49 bis unter 50;2700;1349;1351
09189;      Traunstein (Lkr);50 bis unter 51;2826;1396;1430
09189;      Traunstein (Lkr);51 bis unter 52;3062;1552;1510
09189;      Traunstein (Lkr);52 bis unter 53;3006;1486;1520
09189;      Traunstein (Lkr);53 bis unter 54;2903;1435;1468
09189;      Traunstein (Lkr);54 bis unter 55;3060;1505;1555
09189;      Traunstein (Lkr);55 bis unter 56;3105;1534;1571
09189;      Traunstein (Lkr);56 bis unter 57;3039;1522;1517
09189;      Traunstein (Lkr);57 bis unter 58;2976;1484;1492
09189;      Traunstein (Lkr);58 bis unter 59;2789;1398;1391
09189;      Traunstein (Lkr);59 bis unter 60;2671;1322;1349
09189;      Traunstein (Lkr);60 bis unter 61;2631;1304;1327
09189;      Traunstein (Lkr);61 bis unter 62;2495;1228;1267
09189;      Traunstein (Lkr);62 bis unter 63;2295;1150;1145
09189;      Traunstein (Lkr);63 bis unter 64;2147;1005;1142
09189;      Traunstein (Lkr);64 bis unter 65;2186;1055;1131
09189;      Traunstein (Lkr);65 bis unter 66;1991;960;1031
09189;      Traunstein (Lkr);66 bis unter 67;2085;1016;1069
09189;      Traunstein (Lkr);67 bis unter 68;2043;985;1058
09189;      Traunstein (Lkr);68 bis unter 69;2126;1006;1120
09189;      Traunstein (Lkr);69 bis unter 70;2053;977;1076
09189;      Traunstein (Lkr);70 bis unter 71;1987;924;1063
09189;      Traunstein (Lkr);71 bis unter 72;1927;903;1024
09189;      Traunstein (Lkr);72 bis unter 73;1704;808;896
09189;      Traunstein (Lkr);73 bis unter 74;1383;651;732
09189;      Traunstein (Lkr);74 bis unter 75;1708;797;911
09189;      Traunstein (Lkr);75 bis unter 76;1670;737;933
09189;      Traunstein (Lkr);76 bis unter 77;1610;727;883
09189;      Traunstein (Lkr);77 bis unter 78;1977;854;1123
09189;      Traunstein (Lkr);78 bis unter 79;2033;917;1116
09189;      Traunstein (Lkr);79 bis unter 80;1932;912;1020
09189;      Traunstein (Lkr);80 bis unter 81;1671;721;950
09189;      Traunstein (Lkr);81 bis unter 82;1524;680;844
09189;      Traunstein (Lkr);82 bis unter 83;1352;598;754
09189;      Traunstein (Lkr);83 bis unter 84;1169;474;695
09189;      Traunstein (Lkr);84 bis unter 85;1016;429;587
09189;      Traunstein (Lkr);85 bis unter 90;3342;1294;2048
09189;      Traunstein (Lkr);90 bis unter 95;1466;445;1021
09189;      Traunstein (Lkr);95 oder älter;364;65;299
09189;      Traunstein (Lkr);Insgesamt;177089;87564;89525
09190;      Weilheim-Schongau (Lkr);unter 1;1309;648;661
09190;      Weilheim-Schongau (Lkr);1 bis unter 2;1278;650;628
09190;      Weilheim-Schongau (Lkr);2 bis unter 3;1316;695;621
09190;      Weilheim-Schongau (Lkr);3 bis unter 4;1363;696;667
09190;      Weilheim-Schongau (Lkr);4 bis unter 5;1280;651;629
09190;      Weilheim-Schongau (Lkr);5 bis unter 6;1266;643;623
09190;      Weilheim-Schongau (Lkr);6 bis unter 7;1274;654;620
09190;      Weilheim-Schongau (Lkr);7 bis unter 8;1268;656;612
09190;      Weilheim-Schongau (Lkr);8 bis unter 9;1226;616;610
09190;      Weilheim-Schongau (Lkr);9 bis unter 10;1247;640;607
09190;      Weilheim-Schongau (Lkr);10 bis unter 11;1256;635;621
09190;      Weilheim-Schongau (Lkr);11 bis unter 12;1276;701;575
09190;      Weilheim-Schongau (Lkr);12 bis unter 13;1335;665;670
09190;      Weilheim-Schongau (Lkr);13 bis unter 14;1232;630;602
09190;      Weilheim-Schongau (Lkr);14 bis unter 15;1281;662;619
09190;      Weilheim-Schongau (Lkr);15 bis unter 16;1343;711;632
09190;      Weilheim-Schongau (Lkr);16 bis unter 17;1373;691;682
09190;      Weilheim-Schongau (Lkr);17 bis unter 18;1451;756;695
09190;      Weilheim-Schongau (Lkr);18 bis unter 19;1485;770;715
09190;      Weilheim-Schongau (Lkr);19 bis unter 20;1393;742;651
09190;      Weilheim-Schongau (Lkr);20 bis unter 21;1466;781;685
09190;      Weilheim-Schongau (Lkr);21 bis unter 22;1566;895;671
09190;      Weilheim-Schongau (Lkr);22 bis unter 23;1474;783;691
09190;      Weilheim-Schongau (Lkr);23 bis unter 24;1419;796;623
09190;      Weilheim-Schongau (Lkr);24 bis unter 25;1489;790;699
09190;      Weilheim-Schongau (Lkr);25 bis unter 26;1543;820;723
09190;      Weilheim-Schongau (Lkr);26 bis unter 27;1521;825;696
09190;      Weilheim-Schongau (Lkr);27 bis unter 28;1448;788;660
09190;      Weilheim-Schongau (Lkr);28 bis unter 29;1591;805;786
09190;      Weilheim-Schongau (Lkr);29 bis unter 30;1596;856;740
09190;      Weilheim-Schongau (Lkr);30 bis unter 31;1583;846;737
09190;      Weilheim-Schongau (Lkr);31 bis unter 32;1538;780;758
09190;      Weilheim-Schongau (Lkr);32 bis unter 33;1635;852;783
09190;      Weilheim-Schongau (Lkr);33 bis unter 34;1515;776;739
09190;      Weilheim-Schongau (Lkr);34 bis unter 35;1575;774;801
09190;      Weilheim-Schongau (Lkr);35 bis unter 36;1638;864;774
09190;      Weilheim-Schongau (Lkr);36 bis unter 37;1651;831;820
09190;      Weilheim-Schongau (Lkr);37 bis unter 38;1569;808;761
09190;      Weilheim-Schongau (Lkr);38 bis unter 39;1636;821;815
09190;      Weilheim-Schongau (Lkr);39 bis unter 40;1568;757;811
09190;      Weilheim-Schongau (Lkr);40 bis unter 41;1580;777;803
09190;      Weilheim-Schongau (Lkr);41 bis unter 42;1552;769;783
09190;      Weilheim-Schongau (Lkr);42 bis unter 43;1590;816;774
09190;      Weilheim-Schongau (Lkr);43 bis unter 44;1466;758;708
09190;      Weilheim-Schongau (Lkr);44 bis unter 45;1551;796;755
09190;      Weilheim-Schongau (Lkr);45 bis unter 46;1548;719;829
09190;      Weilheim-Schongau (Lkr);46 bis unter 47;1675;808;867
09190;      Weilheim-Schongau (Lkr);47 bis unter 48;1808;900;908
09190;      Weilheim-Schongau (Lkr);48 bis unter 49;2001;955;1046
09190;      Weilheim-Schongau (Lkr);49 bis unter 50;2241;1089;1152
09190;      Weilheim-Schongau (Lkr);50 bis unter 51;2265;1057;1208
09190;      Weilheim-Schongau (Lkr);51 bis unter 52;2393;1216;1177
09190;      Weilheim-Schongau (Lkr);52 bis unter 53;2418;1201;1217
09190;      Weilheim-Schongau (Lkr);53 bis unter 54;2357;1221;1136
09190;      Weilheim-Schongau (Lkr);54 bis unter 55;2439;1192;1247
09190;      Weilheim-Schongau (Lkr);55 bis unter 56;2364;1184;1180
09190;      Weilheim-Schongau (Lkr);56 bis unter 57;2304;1144;1160
09190;      Weilheim-Schongau (Lkr);57 bis unter 58;2303;1154;1149
09190;      Weilheim-Schongau (Lkr);58 bis unter 59;2087;1030;1057
09190;      Weilheim-Schongau (Lkr);59 bis unter 60;1990;976;1014
09190;      Weilheim-Schongau (Lkr);60 bis unter 61;1942;957;985
09190;      Weilheim-Schongau (Lkr);61 bis unter 62;1922;989;933
09190;      Weilheim-Schongau (Lkr);62 bis unter 63;1764;909;855
09190;      Weilheim-Schongau (Lkr);63 bis unter 64;1707;818;889
09190;      Weilheim-Schongau (Lkr);64 bis unter 65;1629;807;822
09190;      Weilheim-Schongau (Lkr);65 bis unter 66;1554;734;820
09190;      Weilheim-Schongau (Lkr);66 bis unter 67;1562;781;781
09190;      Weilheim-Schongau (Lkr);67 bis unter 68;1473;710;763
09190;      Weilheim-Schongau (Lkr);68 bis unter 69;1463;728;735
09190;      Weilheim-Schongau (Lkr);69 bis unter 70;1465;695;770
09190;      Weilheim-Schongau (Lkr);70 bis unter 71;1349;635;714
09190;      Weilheim-Schongau (Lkr);71 bis unter 72;1381;659;722
09190;      Weilheim-Schongau (Lkr);72 bis unter 73;1218;570;648
09190;      Weilheim-Schongau (Lkr);73 bis unter 74;989;475;514
09190;      Weilheim-Schongau (Lkr);74 bis unter 75;1346;662;684
09190;      Weilheim-Schongau (Lkr);75 bis unter 76;1302;598;704
09190;      Weilheim-Schongau (Lkr);76 bis unter 77;1235;587;648
09190;      Weilheim-Schongau (Lkr);77 bis unter 78;1490;709;781
09190;      Weilheim-Schongau (Lkr);78 bis unter 79;1456;667;789
09190;      Weilheim-Schongau (Lkr);79 bis unter 80;1396;671;725
09190;      Weilheim-Schongau (Lkr);80 bis unter 81;1247;611;636
09190;      Weilheim-Schongau (Lkr);81 bis unter 82;1126;510;616
09190;      Weilheim-Schongau (Lkr);82 bis unter 83;927;388;539
09190;      Weilheim-Schongau (Lkr);83 bis unter 84;873;370;503
09190;      Weilheim-Schongau (Lkr);84 bis unter 85;757;315;442
09190;      Weilheim-Schongau (Lkr);85 bis unter 90;2317;896;1421
09190;      Weilheim-Schongau (Lkr);90 bis unter 95;1027;298;729
09190;      Weilheim-Schongau (Lkr);95 oder älter;226;50;176
09190;      Weilheim-Schongau (Lkr);Insgesamt;135348;67321;68027
LK091;    Landkreise Oberbayern;unter 1;29422;15000;14422
LK091;    Landkreise Oberbayern;1 bis unter 2;29847;15211;14636
LK091;    Landkreise Oberbayern;2 bis unter 3;30077;15369;14708
LK091;    Landkreise Oberbayern;3 bis unter 4;29562;15214;14348
LK091;    Landkreise Oberbayern;4 bis unter 5;29317;15135;14182
LK091;    Landkreise Oberbayern;5 bis unter 6;28758;14509;14249
LK091;    Landkreise Oberbayern;6 bis unter 7;28780;14875;13905
LK091;    Landkreise Oberbayern;7 bis unter 8;27961;14402;13559
LK091;    Landkreise Oberbayern;8 bis unter 9;28411;14630;13781
LK091;    Landkreise Oberbayern;9 bis unter 10;28215;14552;13663
LK091;    Landkreise Oberbayern;10 bis unter 11;28705;14731;13974
LK091;    Landkreise Oberbayern;11 bis unter 12;28992;14899;14093
LK091;    Landkreise Oberbayern;12 bis unter 13;28317;14643;13674
LK091;    Landkreise Oberbayern;13 bis unter 14;28523;14694;13829
LK091;    Landkreise Oberbayern;14 bis unter 15;29853;15302;14551
LK091;    Landkreise Oberbayern;15 bis unter 16;29294;14948;14346
LK091;    Landkreise Oberbayern;16 bis unter 17;29914;15375;14539
LK091;    Landkreise Oberbayern;17 bis unter 18;30455;15751;14704
LK091;    Landkreise Oberbayern;18 bis unter 19;31940;16565;15375
LK091;    Landkreise Oberbayern;19 bis unter 20;32316;17300;15016
LK091;    Landkreise Oberbayern;20 bis unter 21;34008;18284;15724
LK091;    Landkreise Oberbayern;21 bis unter 22;35662;19592;16070
LK091;    Landkreise Oberbayern;22 bis unter 23;34380;18668;15712
LK091;    Landkreise Oberbayern;23 bis unter 24;34016;18480;15536
LK091;    Landkreise Oberbayern;24 bis unter 25;33737;18231;15506
LK091;    Landkreise Oberbayern;25 bis unter 26;34734;18516;16218
LK091;    Landkreise Oberbayern;26 bis unter 27;35300;18847;16453
LK091;    Landkreise Oberbayern;27 bis unter 28;35089;18825;16264
LK091;    Landkreise Oberbayern;28 bis unter 29;37281;19805;17476
LK091;    Landkreise Oberbayern;29 bis unter 30;36554;19187;17367
LK091;    Landkreise Oberbayern;30 bis unter 31;37057;19435;17622
LK091;    Landkreise Oberbayern;31 bis unter 32;36248;18754;17494
LK091;    Landkreise Oberbayern;32 bis unter 33;36888;19139;17749
LK091;    Landkreise Oberbayern;33 bis unter 34;36267;18611;17656
LK091;    Landkreise Oberbayern;34 bis unter 35;36415;18462;17953
LK091;    Landkreise Oberbayern;35 bis unter 36;36908;18830;18078
LK091;    Landkreise Oberbayern;36 bis unter 37;38860;19528;19332
LK091;    Landkreise Oberbayern;37 bis unter 38;38753;19522;19231
LK091;    Landkreise Oberbayern;38 bis unter 39;39482;19674;19808
LK091;    Landkreise Oberbayern;39 bis unter 40;38500;19364;19136
LK091;    Landkreise Oberbayern;40 bis unter 41;37898;18799;19099
LK091;    Landkreise Oberbayern;41 bis unter 42;38080;19311;18769
LK091;    Landkreise Oberbayern;42 bis unter 43;37633;19048;18585
LK091;    Landkreise Oberbayern;43 bis unter 44;37048;18625;18423
LK091;    Landkreise Oberbayern;44 bis unter 45;37413;18687;18726
LK091;    Landkreise Oberbayern;45 bis unter 46;37313;18710;18603
LK091;    Landkreise Oberbayern;46 bis unter 47;39866;19944;19922
LK091;    Landkreise Oberbayern;47 bis unter 48;43619;21950;21669
LK091;    Landkreise Oberbayern;48 bis unter 49;45471;22782;22689
LK091;    Landkreise Oberbayern;49 bis unter 50;49396;25129;24267
LK091;    Landkreise Oberbayern;50 bis unter 51;51922;26291;25631
LK091;    Landkreise Oberbayern;51 bis unter 52;53272;26930;26342
LK091;    Landkreise Oberbayern;52 bis unter 53;53254;26891;26363
LK091;    Landkreise Oberbayern;53 bis unter 54;52135;26283;25852
LK091;    Landkreise Oberbayern;54 bis unter 55;52427;26196;26231
LK091;    Landkreise Oberbayern;55 bis unter 56;50866;25485;25381
LK091;    Landkreise Oberbayern;56 bis unter 57;48910;24539;24371
LK091;    Landkreise Oberbayern;57 bis unter 58;47695;23892;23803
LK091;    Landkreise Oberbayern;58 bis unter 59;44850;22500;22350
LK091;    Landkreise Oberbayern;59 bis unter 60;43005;21541;21464
LK091;    Landkreise Oberbayern;60 bis unter 61;40943;20589;20354
LK091;    Landkreise Oberbayern;61 bis unter 62;39099;19395;19704
LK091;    Landkreise Oberbayern;62 bis unter 63;36485;18220;18265
LK091;    Landkreise Oberbayern;63 bis unter 64;34256;16799;17457
LK091;    Landkreise Oberbayern;64 bis unter 65;33004;15954;17050
LK091;    Landkreise Oberbayern;65 bis unter 66;31650;15066;16584
LK091;    Landkreise Oberbayern;66 bis unter 67;31392;14967;16425
LK091;    Landkreise Oberbayern;67 bis unter 68;30608;14467;16141
LK091;    Landkreise Oberbayern;68 bis unter 69;30939;14639;16300
LK091;    Landkreise Oberbayern;69 bis unter 70;30646;14194;16452
LK091;    Landkreise Oberbayern;70 bis unter 71;29452;13743;15709
LK091;    Landkreise Oberbayern;71 bis unter 72;29369;13818;15551
LK091;    Landkreise Oberbayern;72 bis unter 73;26023;11984;14039
LK091;    Landkreise Oberbayern;73 bis unter 74;21682;10164;11518
LK091;    Landkreise Oberbayern;74 bis unter 75;27696;12895;14801
LK091;    Landkreise Oberbayern;75 bis unter 76;27393;12810;14583
LK091;    Landkreise Oberbayern;76 bis unter 77;26503;12287;14216
LK091;    Landkreise Oberbayern;77 bis unter 78;31004;14090;16914
LK091;    Landkreise Oberbayern;78 bis unter 79;31502;14284;17218
LK091;    Landkreise Oberbayern;79 bis unter 80;30130;13599;16531
LK091;    Landkreise Oberbayern;80 bis unter 81;26027;11736;14291
LK091;    Landkreise Oberbayern;81 bis unter 82;22691;9983;12708
LK091;    Landkreise Oberbayern;82 bis unter 83;20029;8616;11413
LK091;    Landkreise Oberbayern;83 bis unter 84;18094;7601;10493
LK091;    Landkreise Oberbayern;84 bis unter 85;15489;6486;9003
LK091;    Landkreise Oberbayern;85 bis unter 90;48820;18601;30219
LK091;    Landkreise Oberbayern;90 bis unter 95;21040;6370;14670
LK091;    Landkreise Oberbayern;95 oder älter;5513;1147;4366
LK091;    Landkreise Oberbayern;Insgesamt;3014350;1500896;1513454
091;  Oberbayern;unter 1;48901;25076;23825
091;  Oberbayern;1 bis unter 2;48536;24627;23909
091;  Oberbayern;2 bis unter 3;48137;24611;23526
091;  Oberbayern;3 bis unter 4;46355;23737;22618
091;  Oberbayern;4 bis unter 5;45508;23457;22051
091;  Oberbayern;5 bis unter 6;44506;22568;21938
091;  Oberbayern;6 bis unter 7;43681;22516;21165
091;  Oberbayern;7 bis unter 8;41978;21539;20439
091;  Oberbayern;8 bis unter 9;42365;21762;20603
091;  Oberbayern;9 bis unter 10;41839;21551;20288
091;  Oberbayern;10 bis unter 11;42496;21713;20783
091;  Oberbayern;11 bis unter 12;42481;21787;20694
091;  Oberbayern;12 bis unter 13;41397;21438;19959
091;  Oberbayern;13 bis unter 14;41512;21289;20223
091;  Oberbayern;14 bis unter 15;42543;21769;20774
091;  Oberbayern;15 bis unter 16;42012;21498;20514
091;  Oberbayern;16 bis unter 17;42457;21752;20705
091;  Oberbayern;17 bis unter 18;43020;22432;20588
091;  Oberbayern;18 bis unter 19;45739;23642;22097
091;  Oberbayern;19 bis unter 20;48005;25384;22621
091;  Oberbayern;20 bis unter 21;52088;27717;24371
091;  Oberbayern;21 bis unter 22;55504;29951;25553
091;  Oberbayern;22 bis unter 23;55260;29250;26010
091;  Oberbayern;23 bis unter 24;56264;29593;26671
091;  Oberbayern;24 bis unter 25;57768;30029;27739
091;  Oberbayern;25 bis unter 26;61148;31492;29656
091;  Oberbayern;26 bis unter 27;63529;32479;31050
091;  Oberbayern;27 bis unter 28;65476;33740;31736
091;  Oberbayern;28 bis unter 29;69850;36051;33799
091;  Oberbayern;29 bis unter 30;68859;34945;33914
091;  Oberbayern;30 bis unter 31;70459;36152;34307
091;  Oberbayern;31 bis unter 32;68575;35201;33374
091;  Oberbayern;32 bis unter 33;67708;34807;32901
091;  Oberbayern;33 bis unter 34;65812;33625;32187
091;  Oberbayern;34 bis unter 35;65155;33041;32114
091;  Oberbayern;35 bis unter 36;64648;32620;32028
091;  Oberbayern;36 bis unter 37;66608;33435;33173
091;  Oberbayern;37 bis unter 38;65634;32857;32777
091;  Oberbayern;38 bis unter 39;65593;32632;32961
091;  Oberbayern;39 bis unter 40;63370;31728;31642
091;  Oberbayern;40 bis unter 41;61553;30573;30980
091;  Oberbayern;41 bis unter 42;61310;30963;30347
091;  Oberbayern;42 bis unter 43;60334;30424;29910
091;  Oberbayern;43 bis unter 44;59133;29575;29558
091;  Oberbayern;44 bis unter 45;59535;29785;29750
091;  Oberbayern;45 bis unter 46;58426;29373;29053
091;  Oberbayern;46 bis unter 47;61937;30950;30987
091;  Oberbayern;47 bis unter 48;66650;33720;32930
091;  Oberbayern;48 bis unter 49;68721;34660;34061
091;  Oberbayern;49 bis unter 50;73760;37648;36112
091;  Oberbayern;50 bis unter 51;76956;39248;37708
091;  Oberbayern;51 bis unter 52;78439;39775;38664
091;  Oberbayern;52 bis unter 53;78012;39596;38416
091;  Oberbayern;53 bis unter 54;76384;38611;37773
091;  Oberbayern;54 bis unter 55;76370;38176;38194
091;  Oberbayern;55 bis unter 56;73922;37058;36864
091;  Oberbayern;56 bis unter 57;70355;35195;35160
091;  Oberbayern;57 bis unter 58;68416;34163;34253
091;  Oberbayern;58 bis unter 59;64529;32144;32385
091;  Oberbayern;59 bis unter 60;61829;30791;31038
091;  Oberbayern;60 bis unter 61;58670;29126;29544
091;  Oberbayern;61 bis unter 62;56272;27795;28477
091;  Oberbayern;62 bis unter 63;53139;26233;26906
091;  Oberbayern;63 bis unter 64;50053;24180;25873
091;  Oberbayern;64 bis unter 65;47830;22708;25122
091;  Oberbayern;65 bis unter 66;45975;21430;24545
091;  Oberbayern;66 bis unter 67;46157;21514;24643
091;  Oberbayern;67 bis unter 68;44430;20649;23781
091;  Oberbayern;68 bis unter 69;45795;21234;24561
091;  Oberbayern;69 bis unter 70;45344;20839;24505
091;  Oberbayern;70 bis unter 71;43735;20297;23438
091;  Oberbayern;71 bis unter 72;43825;20491;23334
091;  Oberbayern;72 bis unter 73;39165;17916;21249
091;  Oberbayern;73 bis unter 74;33123;15322;17801
091;  Oberbayern;74 bis unter 75;41788;19348;22440
091;  Oberbayern;75 bis unter 76;41508;19133;22375
091;  Oberbayern;76 bis unter 77;39817;18271;21546
091;  Oberbayern;77 bis unter 78;45824;20642;25182
091;  Oberbayern;78 bis unter 79;46426;20755;25671
091;  Oberbayern;79 bis unter 80;44070;19589;24481
091;  Oberbayern;80 bis unter 81;38188;16914;21274
091;  Oberbayern;81 bis unter 82;33627;14524;19103
091;  Oberbayern;82 bis unter 83;30017;12681;17336
091;  Oberbayern;83 bis unter 84;26677;11010;15667
091;  Oberbayern;84 bis unter 85;23034;9485;13549
091;  Oberbayern;85 bis unter 90;72586;27465;45121
091;  Oberbayern;90 bis unter 95;31555;9539;22016
091;  Oberbayern;95 oder älter;8186;1766;6420
091;  Oberbayern;Insgesamt;4686163;2318777;2367386
09261;      Landshut (Krfr.St);unter 1;734;367;367
09261;      Landshut (Krfr.St);1 bis unter 2;652;318;334
09261;      Landshut (Krfr.St);2 bis unter 3;688;358;330
09261;      Landshut (Krfr.St);3 bis unter 4;664;352;312
09261;      Landshut (Krfr.St);4 bis unter 5;645;343;302
09261;      Landshut (Krfr.St);5 bis unter 6;579;275;304
09261;      Landshut (Krfr.St);6 bis unter 7;617;320;297
09261;      Landshut (Krfr.St);7 bis unter 8;584;281;303
09261;      Landshut (Krfr.St);8 bis unter 9;632;326;306
09261;      Landshut (Krfr.St);9 bis unter 10;638;302;336
09261;      Landshut (Krfr.St);10 bis unter 11;619;320;299
09261;      Landshut (Krfr.St);11 bis unter 12;618;347;271
09261;      Landshut (Krfr.St);12 bis unter 13;562;296;266
09261;      Landshut (Krfr.St);13 bis unter 14;570;284;286
09261;      Landshut (Krfr.St);14 bis unter 15;600;302;298
09261;      Landshut (Krfr.St);15 bis unter 16;568;283;285
09261;      Landshut (Krfr.St);16 bis unter 17;642;320;322
09261;      Landshut (Krfr.St);17 bis unter 18;591;313;278
09261;      Landshut (Krfr.St);18 bis unter 19;667;335;332
09261;      Landshut (Krfr.St);19 bis unter 20;767;428;339
09261;      Landshut (Krfr.St);20 bis unter 21;834;447;387
09261;      Landshut (Krfr.St);21 bis unter 22;910;471;439
09261;      Landshut (Krfr.St);22 bis unter 23;924;470;454
09261;      Landshut (Krfr.St);23 bis unter 24;1003;503;500
09261;      Landshut (Krfr.St);24 bis unter 25;982;524;458
09261;      Landshut (Krfr.St);25 bis unter 26;1069;550;519
09261;      Landshut (Krfr.St);26 bis unter 27;1163;586;577
09261;      Landshut (Krfr.St);27 bis unter 28;1131;614;517
09261;      Landshut (Krfr.St);28 bis unter 29;1146;601;545
09261;      Landshut (Krfr.St);29 bis unter 30;1163;618;545
09261;      Landshut (Krfr.St);30 bis unter 31;1121;572;549
09261;      Landshut (Krfr.St);31 bis unter 32;1132;588;544
09261;      Landshut (Krfr.St);32 bis unter 33;1088;565;523
09261;      Landshut (Krfr.St);33 bis unter 34;1019;522;497
09261;      Landshut (Krfr.St);34 bis unter 35;962;493;469
09261;      Landshut (Krfr.St);35 bis unter 36;970;524;446
09261;      Landshut (Krfr.St);36 bis unter 37;957;486;471
09261;      Landshut (Krfr.St);37 bis unter 38;991;505;486
09261;      Landshut (Krfr.St);38 bis unter 39;992;490;502
09261;      Landshut (Krfr.St);39 bis unter 40;930;459;471
09261;      Landshut (Krfr.St);40 bis unter 41;933;457;476
09261;      Landshut (Krfr.St);41 bis unter 42;970;517;453
09261;      Landshut (Krfr.St);42 bis unter 43;917;449;468
09261;      Landshut (Krfr.St);43 bis unter 44;985;479;506
09261;      Landshut (Krfr.St);44 bis unter 45;940;485;455
09261;      Landshut (Krfr.St);45 bis unter 46;909;437;472
09261;      Landshut (Krfr.St);46 bis unter 47;911;484;427
09261;      Landshut (Krfr.St);47 bis unter 48;944;484;460
09261;      Landshut (Krfr.St);48 bis unter 49;1032;509;523
09261;      Landshut (Krfr.St);49 bis unter 50;1142;578;564
09261;      Landshut (Krfr.St);50 bis unter 51;1213;640;573
09261;      Landshut (Krfr.St);51 bis unter 52;1187;607;580
09261;      Landshut (Krfr.St);52 bis unter 53;1108;557;551
09261;      Landshut (Krfr.St);53 bis unter 54;988;514;474
09261;      Landshut (Krfr.St);54 bis unter 55;1101;559;542
09261;      Landshut (Krfr.St);55 bis unter 56;1130;589;541
09261;      Landshut (Krfr.St);56 bis unter 57;1009;496;513
09261;      Landshut (Krfr.St);57 bis unter 58;1015;501;514
09261;      Landshut (Krfr.St);58 bis unter 59;920;446;474
09261;      Landshut (Krfr.St);59 bis unter 60;938;432;506
09261;      Landshut (Krfr.St);60 bis unter 61;904;421;483
09261;      Landshut (Krfr.St);61 bis unter 62;846;375;471
09261;      Landshut (Krfr.St);62 bis unter 63;857;409;448
09261;      Landshut (Krfr.St);63 bis unter 64;779;358;421
09261;      Landshut (Krfr.St);64 bis unter 65;802;369;433
09261;      Landshut (Krfr.St);65 bis unter 66;748;343;405
09261;      Landshut (Krfr.St);66 bis unter 67;753;345;408
09261;      Landshut (Krfr.St);67 bis unter 68;783;360;423
09261;      Landshut (Krfr.St);68 bis unter 69;783;363;420
09261;      Landshut (Krfr.St);69 bis unter 70;722;324;398
09261;      Landshut (Krfr.St);70 bis unter 71;674;287;387
09261;      Landshut (Krfr.St);71 bis unter 72;715;292;423
09261;      Landshut (Krfr.St);72 bis unter 73;626;280;346
09261;      Landshut (Krfr.St);73 bis unter 74;486;193;293
09261;      Landshut (Krfr.St);74 bis unter 75;650;298;352
09261;      Landshut (Krfr.St);75 bis unter 76;667;296;371
09261;      Landshut (Krfr.St);76 bis unter 77;590;262;328
09261;      Landshut (Krfr.St);77 bis unter 78;699;311;388
09261;      Landshut (Krfr.St);78 bis unter 79;703;299;404
09261;      Landshut (Krfr.St);79 bis unter 80;681;294;387
09261;      Landshut (Krfr.St);80 bis unter 81;611;274;337
09261;      Landshut (Krfr.St);81 bis unter 82;581;221;360
09261;      Landshut (Krfr.St);82 bis unter 83;469;222;247
09261;      Landshut (Krfr.St);83 bis unter 84;422;171;251
09261;      Landshut (Krfr.St);84 bis unter 85;365;122;243
09261;      Landshut (Krfr.St);85 bis unter 90;1278;431;847
09261;      Landshut (Krfr.St);90 bis unter 95;625;169;456
09261;      Landshut (Krfr.St);95 oder älter;169;36;133
09261;      Landshut (Krfr.St);Insgesamt;72404;35403;37001
09262;      Passau (Krfr.St);unter 1;434;212;222
09262;      Passau (Krfr.St);1 bis unter 2;381;195;186
09262;      Passau (Krfr.St);2 bis unter 3;422;203;219
09262;      Passau (Krfr.St);3 bis unter 4;374;185;189
09262;      Passau (Krfr.St);4 bis unter 5;383;205;178
09262;      Passau (Krfr.St);5 bis unter 6;373;186;187
09262;      Passau (Krfr.St);6 bis unter 7;374;173;201
09262;      Passau (Krfr.St);7 bis unter 8;343;163;180
09262;      Passau (Krfr.St);8 bis unter 9;359;190;169
09262;      Passau (Krfr.St);9 bis unter 10;379;202;177
09262;      Passau (Krfr.St);10 bis unter 11;349;170;179
09262;      Passau (Krfr.St);11 bis unter 12;358;185;173
09262;      Passau (Krfr.St);12 bis unter 13;364;179;185
09262;      Passau (Krfr.St);13 bis unter 14;339;166;173
09262;      Passau (Krfr.St);14 bis unter 15;359;191;168
09262;      Passau (Krfr.St);15 bis unter 16;405;212;193
09262;      Passau (Krfr.St);16 bis unter 17;407;191;216
09262;      Passau (Krfr.St);17 bis unter 18;376;203;173
09262;      Passau (Krfr.St);18 bis unter 19;490;234;256
09262;      Passau (Krfr.St);19 bis unter 20;677;303;374
09262;      Passau (Krfr.St);20 bis unter 21;989;445;544
09262;      Passau (Krfr.St);21 bis unter 22;1165;513;652
09262;      Passau (Krfr.St);22 bis unter 23;1109;515;594
09262;      Passau (Krfr.St);23 bis unter 24;1019;507;512
09262;      Passau (Krfr.St);24 bis unter 25;1080;564;516
09262;      Passau (Krfr.St);25 bis unter 26;1034;519;515
09262;      Passau (Krfr.St);26 bis unter 27;1008;528;480
09262;      Passau (Krfr.St);27 bis unter 28;1049;564;485
09262;      Passau (Krfr.St);28 bis unter 29;1005;516;489
09262;      Passau (Krfr.St);29 bis unter 30;968;544;424
09262;      Passau (Krfr.St);30 bis unter 31;907;458;449
09262;      Passau (Krfr.St);31 bis unter 32;804;439;365
09262;      Passau (Krfr.St);32 bis unter 33;793;476;317
09262;      Passau (Krfr.St);33 bis unter 34;701;393;308
09262;      Passau (Krfr.St);34 bis unter 35;716;372;344
09262;      Passau (Krfr.St);35 bis unter 36;684;356;328
09262;      Passau (Krfr.St);36 bis unter 37;685;369;316
09262;      Passau (Krfr.St);37 bis unter 38;629;322;307
09262;      Passau (Krfr.St);38 bis unter 39;592;284;308
09262;      Passau (Krfr.St);39 bis unter 40;545;266;279
09262;      Passau (Krfr.St);40 bis unter 41;560;286;274
09262;      Passau (Krfr.St);41 bis unter 42;558;275;283
09262;      Passau (Krfr.St);42 bis unter 43;511;272;239
09262;      Passau (Krfr.St);43 bis unter 44;520;266;254
09262;      Passau (Krfr.St);44 bis unter 45;563;273;290
09262;      Passau (Krfr.St);45 bis unter 46;528;277;251
09262;      Passau (Krfr.St);46 bis unter 47;531;279;252
09262;      Passau (Krfr.St);47 bis unter 48;580;311;269
09262;      Passau (Krfr.St);48 bis unter 49;638;313;325
09262;      Passau (Krfr.St);49 bis unter 50;646;305;341
09262;      Passau (Krfr.St);50 bis unter 51;696;363;333
09262;      Passau (Krfr.St);51 bis unter 52;705;355;350
09262;      Passau (Krfr.St);52 bis unter 53;696;340;356
09262;      Passau (Krfr.St);53 bis unter 54;692;359;333
09262;      Passau (Krfr.St);54 bis unter 55;717;378;339
09262;      Passau (Krfr.St);55 bis unter 56;733;369;364
09262;      Passau (Krfr.St);56 bis unter 57;708;338;370
09262;      Passau (Krfr.St);57 bis unter 58;710;338;372
09262;      Passau (Krfr.St);58 bis unter 59;719;343;376
09262;      Passau (Krfr.St);59 bis unter 60;657;297;360
09262;      Passau (Krfr.St);60 bis unter 61;677;331;346
09262;      Passau (Krfr.St);61 bis unter 62;673;308;365
09262;      Passau (Krfr.St);62 bis unter 63;637;307;330
09262;      Passau (Krfr.St);63 bis unter 64;585;274;311
09262;      Passau (Krfr.St);64 bis unter 65;583;263;320
09262;      Passau (Krfr.St);65 bis unter 66;560;253;307
09262;      Passau (Krfr.St);66 bis unter 67;585;252;333
09262;      Passau (Krfr.St);67 bis unter 68;546;237;309
09262;      Passau (Krfr.St);68 bis unter 69;591;251;340
09262;      Passau (Krfr.St);69 bis unter 70;567;266;301
09262;      Passau (Krfr.St);70 bis unter 71;558;263;295
09262;      Passau (Krfr.St);71 bis unter 72;519;242;277
09262;      Passau (Krfr.St);72 bis unter 73;479;206;273
09262;      Passau (Krfr.St);73 bis unter 74;407;178;229
09262;      Passau (Krfr.St);74 bis unter 75;471;211;260
09262;      Passau (Krfr.St);75 bis unter 76;470;189;281
09262;      Passau (Krfr.St);76 bis unter 77;471;200;271
09262;      Passau (Krfr.St);77 bis unter 78;576;247;329
09262;      Passau (Krfr.St);78 bis unter 79;587;248;339
09262;      Passau (Krfr.St);79 bis unter 80;548;241;307
09262;      Passau (Krfr.St);80 bis unter 81;437;175;262
09262;      Passau (Krfr.St);81 bis unter 82;389;150;239
09262;      Passau (Krfr.St);82 bis unter 83;374;155;219
09262;      Passau (Krfr.St);83 bis unter 84;320;127;193
09262;      Passau (Krfr.St);84 bis unter 85;254;111;143
09262;      Passau (Krfr.St);85 bis unter 90;945;300;645
09262;      Passau (Krfr.St);90 bis unter 95;469;112;357
09262;      Passau (Krfr.St);95 oder älter;95;12;83
09262;      Passau (Krfr.St);Insgesamt;52469;25344;27125
09263;      Straubing (Krfr.St);unter 1;443;236;207
09263;      Straubing (Krfr.St);1 bis unter 2;422;217;205
09263;      Straubing (Krfr.St);2 bis unter 3;405;196;209
09263;      Straubing (Krfr.St);3 bis unter 4;381;190;191
09263;      Straubing (Krfr.St);4 bis unter 5;383;192;191
09263;      Straubing (Krfr.St);5 bis unter 6;345;189;156
09263;      Straubing (Krfr.St);6 bis unter 7;356;198;158
09263;      Straubing (Krfr.St);7 bis unter 8;341;167;174
09263;      Straubing (Krfr.St);8 bis unter 9;367;184;183
09263;      Straubing (Krfr.St);9 bis unter 10;379;194;185
09263;      Straubing (Krfr.St);10 bis unter 11;373;199;174
09263;      Straubing (Krfr.St);11 bis unter 12;368;200;168
09263;      Straubing (Krfr.St);12 bis unter 13;387;195;192
09263;      Straubing (Krfr.St);13 bis unter 14;415;222;193
09263;      Straubing (Krfr.St);14 bis unter 15;378;196;182
09263;      Straubing (Krfr.St);15 bis unter 16;375;184;191
09263;      Straubing (Krfr.St);16 bis unter 17;379;206;173
09263;      Straubing (Krfr.St);17 bis unter 18;410;219;191
09263;      Straubing (Krfr.St);18 bis unter 19;459;253;206
09263;      Straubing (Krfr.St);19 bis unter 20;521;279;242
09263;      Straubing (Krfr.St);20 bis unter 21;467;236;231
09263;      Straubing (Krfr.St);21 bis unter 22;547;308;239
09263;      Straubing (Krfr.St);22 bis unter 23;570;292;278
09263;      Straubing (Krfr.St);23 bis unter 24;590;319;271
09263;      Straubing (Krfr.St);24 bis unter 25;604;298;306
09263;      Straubing (Krfr.St);25 bis unter 26;667;366;301
09263;      Straubing (Krfr.St);26 bis unter 27;745;425;320
09263;      Straubing (Krfr.St);27 bis unter 28;708;398;310
09263;      Straubing (Krfr.St);28 bis unter 29;776;442;334
09263;      Straubing (Krfr.St);29 bis unter 30;754;451;303
09263;      Straubing (Krfr.St);30 bis unter 31;716;406;310
09263;      Straubing (Krfr.St);31 bis unter 32;696;378;318
09263;      Straubing (Krfr.St);32 bis unter 33;656;344;312
09263;      Straubing (Krfr.St);33 bis unter 34;648;343;305
09263;      Straubing (Krfr.St);34 bis unter 35;610;357;253
09263;      Straubing (Krfr.St);35 bis unter 36;624;330;294
09263;      Straubing (Krfr.St);36 bis unter 37;635;353;282
09263;      Straubing (Krfr.St);37 bis unter 38;637;342;295
09263;      Straubing (Krfr.St);38 bis unter 39;652;343;309
09263;      Straubing (Krfr.St);39 bis unter 40;566;298;268
09263;      Straubing (Krfr.St);40 bis unter 41;609;341;268
09263;      Straubing (Krfr.St);41 bis unter 42;618;345;273
09263;      Straubing (Krfr.St);42 bis unter 43;561;291;270
09263;      Straubing (Krfr.St);43 bis unter 44;543;268;275
09263;      Straubing (Krfr.St);44 bis unter 45;582;302;280
09263;      Straubing (Krfr.St);45 bis unter 46;543;289;254
09263;      Straubing (Krfr.St);46 bis unter 47;619;348;271
09263;      Straubing (Krfr.St);47 bis unter 48;642;320;322
09263;      Straubing (Krfr.St);48 bis unter 49;700;361;339
09263;      Straubing (Krfr.St);49 bis unter 50;770;404;366
09263;      Straubing (Krfr.St);50 bis unter 51;731;391;340
09263;      Straubing (Krfr.St);51 bis unter 52;751;404;347
09263;      Straubing (Krfr.St);52 bis unter 53;698;362;336
09263;      Straubing (Krfr.St);53 bis unter 54;755;391;364
09263;      Straubing (Krfr.St);54 bis unter 55;781;393;388
09263;      Straubing (Krfr.St);55 bis unter 56;827;428;399
09263;      Straubing (Krfr.St);56 bis unter 57;735;366;369
09263;      Straubing (Krfr.St);57 bis unter 58;806;392;414
09263;      Straubing (Krfr.St);58 bis unter 59;736;373;363
09263;      Straubing (Krfr.St);59 bis unter 60;712;367;345
09263;      Straubing (Krfr.St);60 bis unter 61;682;327;355
09263;      Straubing (Krfr.St);61 bis unter 62;670;347;323
09263;      Straubing (Krfr.St);62 bis unter 63;596;279;317
09263;      Straubing (Krfr.St);63 bis unter 64;574;269;305
09263;      Straubing (Krfr.St);64 bis unter 65;626;285;341
09263;      Straubing (Krfr.St);65 bis unter 66;527;241;286
09263;      Straubing (Krfr.St);66 bis unter 67;563;261;302
09263;      Straubing (Krfr.St);67 bis unter 68;574;280;294
09263;      Straubing (Krfr.St);68 bis unter 69;608;277;331
09263;      Straubing (Krfr.St);69 bis unter 70;541;257;284
09263;      Straubing (Krfr.St);70 bis unter 71;530;256;274
09263;      Straubing (Krfr.St);71 bis unter 72;464;223;241
09263;      Straubing (Krfr.St);72 bis unter 73;420;194;226
09263;      Straubing (Krfr.St);73 bis unter 74;314;142;172
09263;      Straubing (Krfr.St);74 bis unter 75;426;194;232
09263;      Straubing (Krfr.St);75 bis unter 76;383;185;198
09263;      Straubing (Krfr.St);76 bis unter 77;390;148;242
09263;      Straubing (Krfr.St);77 bis unter 78;475;225;250
09263;      Straubing (Krfr.St);78 bis unter 79;499;220;279
09263;      Straubing (Krfr.St);79 bis unter 80;489;212;277
09263;      Straubing (Krfr.St);80 bis unter 81;426;169;257
09263;      Straubing (Krfr.St);81 bis unter 82;362;133;229
09263;      Straubing (Krfr.St);82 bis unter 83;328;126;202
09263;      Straubing (Krfr.St);83 bis unter 84;305;116;189
09263;      Straubing (Krfr.St);84 bis unter 85;246;81;165
09263;      Straubing (Krfr.St);85 bis unter 90;850;278;572
09263;      Straubing (Krfr.St);90 bis unter 95;371;100;271
09263;      Straubing (Krfr.St);95 oder älter;81;11;70
09263;      Straubing (Krfr.St);Insgesamt;47794;24117;23677
KS092;    Kreisfreie Städte Niederbayern;unter 1;1611;815;796
KS092;    Kreisfreie Städte Niederbayern;1 bis unter 2;1455;730;725
KS092;    Kreisfreie Städte Niederbayern;2 bis unter 3;1515;757;758
KS092;    Kreisfreie Städte Niederbayern;3 bis unter 4;1419;727;692
KS092;    Kreisfreie Städte Niederbayern;4 bis unter 5;1411;740;671
KS092;    Kreisfreie Städte Niederbayern;5 bis unter 6;1297;650;647
KS092;    Kreisfreie Städte Niederbayern;6 bis unter 7;1347;691;656
KS092;    Kreisfreie Städte Niederbayern;7 bis unter 8;1268;611;657
KS092;    Kreisfreie Städte Niederbayern;8 bis unter 9;1358;700;658
KS092;    Kreisfreie Städte Niederbayern;9 bis unter 10;1396;698;698
KS092;    Kreisfreie Städte Niederbayern;10 bis unter 11;1341;689;652
KS092;    Kreisfreie Städte Niederbayern;11 bis unter 12;1344;732;612
KS092;    Kreisfreie Städte Niederbayern;12 bis unter 13;1313;670;643
KS092;    Kreisfreie Städte Niederbayern;13 bis unter 14;1324;672;652
KS092;    Kreisfreie Städte Niederbayern;14 bis unter 15;1337;689;648
KS092;    Kreisfreie Städte Niederbayern;15 bis unter 16;1348;679;669
KS092;    Kreisfreie Städte Niederbayern;16 bis unter 17;1428;717;711
KS092;    Kreisfreie Städte Niederbayern;17 bis unter 18;1377;735;642
KS092;    Kreisfreie Städte Niederbayern;18 bis unter 19;1616;822;794
KS092;    Kreisfreie Städte Niederbayern;19 bis unter 20;1965;1010;955
KS092;    Kreisfreie Städte Niederbayern;20 bis unter 21;2290;1128;1162
KS092;    Kreisfreie Städte Niederbayern;21 bis unter 22;2622;1292;1330
KS092;    Kreisfreie Städte Niederbayern;22 bis unter 23;2603;1277;1326
KS092;    Kreisfreie Städte Niederbayern;23 bis unter 24;2612;1329;1283
KS092;    Kreisfreie Städte Niederbayern;24 bis unter 25;2666;1386;1280
KS092;    Kreisfreie Städte Niederbayern;25 bis unter 26;2770;1435;1335
KS092;    Kreisfreie Städte Niederbayern;26 bis unter 27;2916;1539;1377
KS092;    Kreisfreie Städte Niederbayern;27 bis unter 28;2888;1576;1312
KS092;    Kreisfreie Städte Niederbayern;28 bis unter 29;2927;1559;1368
KS092;    Kreisfreie Städte Niederbayern;29 bis unter 30;2885;1613;1272
KS092;    Kreisfreie Städte Niederbayern;30 bis unter 31;2744;1436;1308
KS092;    Kreisfreie Städte Niederbayern;31 bis unter 32;2632;1405;1227
KS092;    Kreisfreie Städte Niederbayern;32 bis unter 33;2537;1385;1152
KS092;    Kreisfreie Städte Niederbayern;33 bis unter 34;2368;1258;1110
KS092;    Kreisfreie Städte Niederbayern;34 bis unter 35;2288;1222;1066
KS092;    Kreisfreie Städte Niederbayern;35 bis unter 36;2278;1210;1068
KS092;    Kreisfreie Städte Niederbayern;36 bis unter 37;2277;1208;1069
KS092;    Kreisfreie Städte Niederbayern;37 bis unter 38;2257;1169;1088
KS092;    Kreisfreie Städte Niederbayern;38 bis unter 39;2236;1117;1119
KS092;    Kreisfreie Städte Niederbayern;39 bis unter 40;2041;1023;1018
KS092;    Kreisfreie Städte Niederbayern;40 bis unter 41;2102;1084;1018
KS092;    Kreisfreie Städte Niederbayern;41 bis unter 42;2146;1137;1009
KS092;    Kreisfreie Städte Niederbayern;42 bis unter 43;1989;1012;977
KS092;    Kreisfreie Städte Niederbayern;43 bis unter 44;2048;1013;1035
KS092;    Kreisfreie Städte Niederbayern;44 bis unter 45;2085;1060;1025
KS092;    Kreisfreie Städte Niederbayern;45 bis unter 46;1980;1003;977
KS092;    Kreisfreie Städte Niederbayern;46 bis unter 47;2061;1111;950
KS092;    Kreisfreie Städte Niederbayern;47 bis unter 48;2166;1115;1051
KS092;    Kreisfreie Städte Niederbayern;48 bis unter 49;2370;1183;1187
KS092;    Kreisfreie Städte Niederbayern;49 bis unter 50;2558;1287;1271
KS092;    Kreisfreie Städte Niederbayern;50 bis unter 51;2640;1394;1246
KS092;    Kreisfreie Städte Niederbayern;51 bis unter 52;2643;1366;1277
KS092;    Kreisfreie Städte Niederbayern;52 bis unter 53;2502;1259;1243
KS092;    Kreisfreie Städte Niederbayern;53 bis unter 54;2435;1264;1171
KS092;    Kreisfreie Städte Niederbayern;54 bis unter 55;2599;1330;1269
KS092;    Kreisfreie Städte Niederbayern;55 bis unter 56;2690;1386;1304
KS092;    Kreisfreie Städte Niederbayern;56 bis unter 57;2452;1200;1252
KS092;    Kreisfreie Städte Niederbayern;57 bis unter 58;2531;1231;1300
KS092;    Kreisfreie Städte Niederbayern;58 bis unter 59;2375;1162;1213
KS092;    Kreisfreie Städte Niederbayern;59 bis unter 60;2307;1096;1211
KS092;    Kreisfreie Städte Niederbayern;60 bis unter 61;2263;1079;1184
KS092;    Kreisfreie Städte Niederbayern;61 bis unter 62;2189;1030;1159
KS092;    Kreisfreie Städte Niederbayern;62 bis unter 63;2090;995;1095
KS092;    Kreisfreie Städte Niederbayern;63 bis unter 64;1938;901;1037
KS092;    Kreisfreie Städte Niederbayern;64 bis unter 65;2011;917;1094
KS092;    Kreisfreie Städte Niederbayern;65 bis unter 66;1835;837;998
KS092;    Kreisfreie Städte Niederbayern;66 bis unter 67;1901;858;1043
KS092;    Kreisfreie Städte Niederbayern;67 bis unter 68;1903;877;1026
KS092;    Kreisfreie Städte Niederbayern;68 bis unter 69;1982;891;1091
KS092;    Kreisfreie Städte Niederbayern;69 bis unter 70;1830;847;983
KS092;    Kreisfreie Städte Niederbayern;70 bis unter 71;1762;806;956
KS092;    Kreisfreie Städte Niederbayern;71 bis unter 72;1698;757;941
KS092;    Kreisfreie Städte Niederbayern;72 bis unter 73;1525;680;845
KS092;    Kreisfreie Städte Niederbayern;73 bis unter 74;1207;513;694
KS092;    Kreisfreie Städte Niederbayern;74 bis unter 75;1547;703;844
KS092;    Kreisfreie Städte Niederbayern;75 bis unter 76;1520;670;850
KS092;    Kreisfreie Städte Niederbayern;76 bis unter 77;1451;610;841
KS092;    Kreisfreie Städte Niederbayern;77 bis unter 78;1750;783;967
KS092;    Kreisfreie Städte Niederbayern;78 bis unter 79;1789;767;1022
KS092;    Kreisfreie Städte Niederbayern;79 bis unter 80;1718;747;971
KS092;    Kreisfreie Städte Niederbayern;80 bis unter 81;1474;618;856
KS092;    Kreisfreie Städte Niederbayern;81 bis unter 82;1332;504;828
KS092;    Kreisfreie Städte Niederbayern;82 bis unter 83;1171;503;668
KS092;    Kreisfreie Städte Niederbayern;83 bis unter 84;1047;414;633
KS092;    Kreisfreie Städte Niederbayern;84 bis unter 85;865;314;551
KS092;    Kreisfreie Städte Niederbayern;85 bis unter 90;3073;1009;2064
KS092;    Kreisfreie Städte Niederbayern;90 bis unter 95;1465;381;1084
KS092;    Kreisfreie Städte Niederbayern;95 oder älter;345;59;286
KS092;    Kreisfreie Städte Niederbayern;Insgesamt;172667;84864;87803
09271;      Deggendorf (Lkr);unter 1;995;530;465
09271;      Deggendorf (Lkr);1 bis unter 2;1042;529;513
09271;      Deggendorf (Lkr);2 bis unter 3;1047;538;509
09271;      Deggendorf (Lkr);3 bis unter 4;1056;515;541
09271;      Deggendorf (Lkr);4 bis unter 5;989;509;480
09271;      Deggendorf (Lkr);5 bis unter 6;1038;536;502
09271;      Deggendorf (Lkr);6 bis unter 7;1084;590;494
09271;      Deggendorf (Lkr);7 bis unter 8;975;515;460
09271;      Deggendorf (Lkr);8 bis unter 9;1037;529;508
09271;      Deggendorf (Lkr);9 bis unter 10;977;490;487
09271;      Deggendorf (Lkr);10 bis unter 11;950;472;478
09271;      Deggendorf (Lkr);11 bis unter 12;1025;511;514
09271;      Deggendorf (Lkr);12 bis unter 13;1033;523;510
09271;      Deggendorf (Lkr);13 bis unter 14;1049;518;531
09271;      Deggendorf (Lkr);14 bis unter 15;1156;584;572
09271;      Deggendorf (Lkr);15 bis unter 16;1101;584;517
09271;      Deggendorf (Lkr);16 bis unter 17;1178;604;574
09271;      Deggendorf (Lkr);17 bis unter 18;1200;628;572
09271;      Deggendorf (Lkr);18 bis unter 19;1294;673;621
09271;      Deggendorf (Lkr);19 bis unter 20;1400;764;636
09271;      Deggendorf (Lkr);20 bis unter 21;1433;772;661
09271;      Deggendorf (Lkr);21 bis unter 22;1481;776;705
09271;      Deggendorf (Lkr);22 bis unter 23;1497;838;659
09271;      Deggendorf (Lkr);23 bis unter 24;1430;748;682
09271;      Deggendorf (Lkr);24 bis unter 25;1512;842;670
09271;      Deggendorf (Lkr);25 bis unter 26;1565;822;743
09271;      Deggendorf (Lkr);26 bis unter 27;1518;836;682
09271;      Deggendorf (Lkr);27 bis unter 28;1556;845;711
09271;      Deggendorf (Lkr);28 bis unter 29;1569;832;737
09271;      Deggendorf (Lkr);29 bis unter 30;1442;758;684
09271;      Deggendorf (Lkr);30 bis unter 31;1455;776;679
09271;      Deggendorf (Lkr);31 bis unter 32;1464;744;720
09271;      Deggendorf (Lkr);32 bis unter 33;1487;771;716
09271;      Deggendorf (Lkr);33 bis unter 34;1386;739;647
09271;      Deggendorf (Lkr);34 bis unter 35;1441;793;648
09271;      Deggendorf (Lkr);35 bis unter 36;1456;742;714
09271;      Deggendorf (Lkr);36 bis unter 37;1474;774;700
09271;      Deggendorf (Lkr);37 bis unter 38;1547;798;749
09271;      Deggendorf (Lkr);38 bis unter 39;1543;772;771
09271;      Deggendorf (Lkr);39 bis unter 40;1417;723;694
09271;      Deggendorf (Lkr);40 bis unter 41;1380;693;687
09271;      Deggendorf (Lkr);41 bis unter 42;1445;744;701
09271;      Deggendorf (Lkr);42 bis unter 43;1440;729;711
09271;      Deggendorf (Lkr);43 bis unter 44;1349;675;674
09271;      Deggendorf (Lkr);44 bis unter 45;1513;789;724
09271;      Deggendorf (Lkr);45 bis unter 46;1434;713;721
09271;      Deggendorf (Lkr);46 bis unter 47;1598;814;784
09271;      Deggendorf (Lkr);47 bis unter 48;1708;849;859
09271;      Deggendorf (Lkr);48 bis unter 49;1739;856;883
09271;      Deggendorf (Lkr);49 bis unter 50;1840;985;855
09271;      Deggendorf (Lkr);50 bis unter 51;1908;959;949
09271;      Deggendorf (Lkr);51 bis unter 52;1975;944;1031
09271;      Deggendorf (Lkr);52 bis unter 53;2002;1051;951
09271;      Deggendorf (Lkr);53 bis unter 54;2031;1063;968
09271;      Deggendorf (Lkr);54 bis unter 55;1991;994;997
09271;      Deggendorf (Lkr);55 bis unter 56;2074;1036;1038
09271;      Deggendorf (Lkr);56 bis unter 57;2055;991;1064
09271;      Deggendorf (Lkr);57 bis unter 58;2088;1070;1018
09271;      Deggendorf (Lkr);58 bis unter 59;1971;989;982
09271;      Deggendorf (Lkr);59 bis unter 60;1967;984;983
09271;      Deggendorf (Lkr);60 bis unter 61;1791;851;940
09271;      Deggendorf (Lkr);61 bis unter 62;1690;825;865
09271;      Deggendorf (Lkr);62 bis unter 63;1656;845;811
09271;      Deggendorf (Lkr);63 bis unter 64;1569;773;796
09271;      Deggendorf (Lkr);64 bis unter 65;1554;740;814
09271;      Deggendorf (Lkr);65 bis unter 66;1488;741;747
09271;      Deggendorf (Lkr);66 bis unter 67;1462;698;764
09271;      Deggendorf (Lkr);67 bis unter 68;1427;710;717
09271;      Deggendorf (Lkr);68 bis unter 69;1439;708;731
09271;      Deggendorf (Lkr);69 bis unter 70;1275;610;665
09271;      Deggendorf (Lkr);70 bis unter 71;1195;566;629
09271;      Deggendorf (Lkr);71 bis unter 72;1192;581;611
09271;      Deggendorf (Lkr);72 bis unter 73;1045;497;548
09271;      Deggendorf (Lkr);73 bis unter 74;754;330;424
09271;      Deggendorf (Lkr);74 bis unter 75;975;472;503
09271;      Deggendorf (Lkr);75 bis unter 76;981;454;527
09271;      Deggendorf (Lkr);76 bis unter 77;925;435;490
09271;      Deggendorf (Lkr);77 bis unter 78;1050;493;557
09271;      Deggendorf (Lkr);78 bis unter 79;1109;464;645
09271;      Deggendorf (Lkr);79 bis unter 80;1124;507;617
09271;      Deggendorf (Lkr);80 bis unter 81;978;418;560
09271;      Deggendorf (Lkr);81 bis unter 82;832;365;467
09271;      Deggendorf (Lkr);82 bis unter 83;786;313;473
09271;      Deggendorf (Lkr);83 bis unter 84;682;260;422
09271;      Deggendorf (Lkr);84 bis unter 85;645;236;409
09271;      Deggendorf (Lkr);85 bis unter 90;1963;652;1311
09271;      Deggendorf (Lkr);90 bis unter 95;767;204;563
09271;      Deggendorf (Lkr);95 oder älter;165;28;137
09271;      Deggendorf (Lkr);Insgesamt;119326;59547;59779
09272;      Freyung-Grafenau (Lkr);unter 1;639;308;331
09272;      Freyung-Grafenau (Lkr);1 bis unter 2;708;340;368
09272;      Freyung-Grafenau (Lkr);2 bis unter 3;653;312;341
09272;      Freyung-Grafenau (Lkr);3 bis unter 4;654;342;312
09272;      Freyung-Grafenau (Lkr);4 bis unter 5;680;364;316
09272;      Freyung-Grafenau (Lkr);5 bis unter 6;631;339;292
09272;      Freyung-Grafenau (Lkr);6 bis unter 7;582;294;288
09272;      Freyung-Grafenau (Lkr);7 bis unter 8;628;317;311
09272;      Freyung-Grafenau (Lkr);8 bis unter 9;570;281;289
09272;      Freyung-Grafenau (Lkr);9 bis unter 10;583;303;280
09272;      Freyung-Grafenau (Lkr);10 bis unter 11;641;348;293
09272;      Freyung-Grafenau (Lkr);11 bis unter 12;614;320;294
09272;      Freyung-Grafenau (Lkr);12 bis unter 13;650;339;311
09272;      Freyung-Grafenau (Lkr);13 bis unter 14;642;335;307
09272;      Freyung-Grafenau (Lkr);14 bis unter 15;701;348;353
09272;      Freyung-Grafenau (Lkr);15 bis unter 16;743;390;353
09272;      Freyung-Grafenau (Lkr);16 bis unter 17;830;445;385
09272;      Freyung-Grafenau (Lkr);17 bis unter 18;820;428;392
09272;      Freyung-Grafenau (Lkr);18 bis unter 19;800;451;349
09272;      Freyung-Grafenau (Lkr);19 bis unter 20;884;459;425
09272;      Freyung-Grafenau (Lkr);20 bis unter 21;919;483;436
09272;      Freyung-Grafenau (Lkr);21 bis unter 22;918;504;414
09272;      Freyung-Grafenau (Lkr);22 bis unter 23;877;470;407
09272;      Freyung-Grafenau (Lkr);23 bis unter 24;877;446;431
09272;      Freyung-Grafenau (Lkr);24 bis unter 25;852;470;382
09272;      Freyung-Grafenau (Lkr);25 bis unter 26;907;461;446
09272;      Freyung-Grafenau (Lkr);26 bis unter 27;920;469;451
09272;      Freyung-Grafenau (Lkr);27 bis unter 28;896;480;416
09272;      Freyung-Grafenau (Lkr);28 bis unter 29;941;520;421
09272;      Freyung-Grafenau (Lkr);29 bis unter 30;876;461;415
09272;      Freyung-Grafenau (Lkr);30 bis unter 31;866;440;426
09272;      Freyung-Grafenau (Lkr);31 bis unter 32;858;446;412
09272;      Freyung-Grafenau (Lkr);32 bis unter 33;875;445;430
09272;      Freyung-Grafenau (Lkr);33 bis unter 34;826;409;417
09272;      Freyung-Grafenau (Lkr);34 bis unter 35;899;475;424
09272;      Freyung-Grafenau (Lkr);35 bis unter 36;870;454;416
09272;      Freyung-Grafenau (Lkr);36 bis unter 37;944;474;470
09272;      Freyung-Grafenau (Lkr);37 bis unter 38;893;468;425
09272;      Freyung-Grafenau (Lkr);38 bis unter 39;858;438;420
09272;      Freyung-Grafenau (Lkr);39 bis unter 40;850;448;402
09272;      Freyung-Grafenau (Lkr);40 bis unter 41;851;425;426
09272;      Freyung-Grafenau (Lkr);41 bis unter 42;841;442;399
09272;      Freyung-Grafenau (Lkr);42 bis unter 43;872;433;439
09272;      Freyung-Grafenau (Lkr);43 bis unter 44;862;433;429
09272;      Freyung-Grafenau (Lkr);44 bis unter 45;963;471;492
09272;      Freyung-Grafenau (Lkr);45 bis unter 46;987;494;493
09272;      Freyung-Grafenau (Lkr);46 bis unter 47;1069;538;531
09272;      Freyung-Grafenau (Lkr);47 bis unter 48;1111;570;541
09272;      Freyung-Grafenau (Lkr);48 bis unter 49;1160;586;574
09272;      Freyung-Grafenau (Lkr);49 bis unter 50;1229;610;619
09272;      Freyung-Grafenau (Lkr);50 bis unter 51;1235;635;600
09272;      Freyung-Grafenau (Lkr);51 bis unter 52;1360;697;663
09272;      Freyung-Grafenau (Lkr);52 bis unter 53;1337;668;669
09272;      Freyung-Grafenau (Lkr);53 bis unter 54;1388;697;691
09272;      Freyung-Grafenau (Lkr);54 bis unter 55;1446;728;718
09272;      Freyung-Grafenau (Lkr);55 bis unter 56;1406;670;736
09272;      Freyung-Grafenau (Lkr);56 bis unter 57;1409;677;732
09272;      Freyung-Grafenau (Lkr);57 bis unter 58;1491;738;753
09272;      Freyung-Grafenau (Lkr);58 bis unter 59;1397;698;699
09272;      Freyung-Grafenau (Lkr);59 bis unter 60;1383;700;683
09272;      Freyung-Grafenau (Lkr);60 bis unter 61;1353;689;664
09272;      Freyung-Grafenau (Lkr);61 bis unter 62;1299;661;638
09272;      Freyung-Grafenau (Lkr);62 bis unter 63;1203;596;607
09272;      Freyung-Grafenau (Lkr);63 bis unter 64;1162;603;559
09272;      Freyung-Grafenau (Lkr);64 bis unter 65;1196;596;600
09272;      Freyung-Grafenau (Lkr);65 bis unter 66;1126;542;584
09272;      Freyung-Grafenau (Lkr);66 bis unter 67;1115;586;529
09272;      Freyung-Grafenau (Lkr);67 bis unter 68;975;493;482
09272;      Freyung-Grafenau (Lkr);68 bis unter 69;1016;510;506
09272;      Freyung-Grafenau (Lkr);69 bis unter 70;973;532;441
09272;      Freyung-Grafenau (Lkr);70 bis unter 71;880;461;419
09272;      Freyung-Grafenau (Lkr);71 bis unter 72;837;424;413
09272;      Freyung-Grafenau (Lkr);72 bis unter 73;689;362;327
09272;      Freyung-Grafenau (Lkr);73 bis unter 74;489;227;262
09272;      Freyung-Grafenau (Lkr);74 bis unter 75;662;317;345
09272;      Freyung-Grafenau (Lkr);75 bis unter 76;543;243;300
09272;      Freyung-Grafenau (Lkr);76 bis unter 77;619;284;335
09272;      Freyung-Grafenau (Lkr);77 bis unter 78;744;346;398
09272;      Freyung-Grafenau (Lkr);78 bis unter 79;803;364;439
09272;      Freyung-Grafenau (Lkr);79 bis unter 80;738;308;430
09272;      Freyung-Grafenau (Lkr);80 bis unter 81;654;282;372
09272;      Freyung-Grafenau (Lkr);81 bis unter 82;581;220;361
09272;      Freyung-Grafenau (Lkr);82 bis unter 83;548;233;315
09272;      Freyung-Grafenau (Lkr);83 bis unter 84;491;193;298
09272;      Freyung-Grafenau (Lkr);84 bis unter 85;445;163;282
09272;      Freyung-Grafenau (Lkr);85 bis unter 90;1366;460;906
09272;      Freyung-Grafenau (Lkr);90 bis unter 95;562;148;414
09272;      Freyung-Grafenau (Lkr);95 oder älter;114;26;88
09272;      Freyung-Grafenau (Lkr);Insgesamt;78355;39103;39252
09273;      Kelheim (Lkr);unter 1;1232;633;599
09273;      Kelheim (Lkr);1 bis unter 2;1163;592;571
09273;      Kelheim (Lkr);2 bis unter 3;1265;657;608
09273;      Kelheim (Lkr);3 bis unter 4;1130;599;531
09273;      Kelheim (Lkr);4 bis unter 5;1178;598;580
09273;      Kelheim (Lkr);5 bis unter 6;1172;600;572
09273;      Kelheim (Lkr);6 bis unter 7;1178;597;581
09273;      Kelheim (Lkr);7 bis unter 8;1116;563;553
09273;      Kelheim (Lkr);8 bis unter 9;1154;578;576
09273;      Kelheim (Lkr);9 bis unter 10;1145;602;543
09273;      Kelheim (Lkr);10 bis unter 11;1215;643;572
09273;      Kelheim (Lkr);11 bis unter 12;1154;602;552
09273;      Kelheim (Lkr);12 bis unter 13;1170;607;563
09273;      Kelheim (Lkr);13 bis unter 14;1232;628;604
09273;      Kelheim (Lkr);14 bis unter 15;1199;599;600
09273;      Kelheim (Lkr);15 bis unter 16;1262;613;649
09273;      Kelheim (Lkr);16 bis unter 17;1253;651;602
09273;      Kelheim (Lkr);17 bis unter 18;1268;654;614
09273;      Kelheim (Lkr);18 bis unter 19;1405;720;685
09273;      Kelheim (Lkr);19 bis unter 20;1436;784;652
09273;      Kelheim (Lkr);20 bis unter 21;1432;783;649
09273;      Kelheim (Lkr);21 bis unter 22;1424;790;634
09273;      Kelheim (Lkr);22 bis unter 23;1496;814;682
09273;      Kelheim (Lkr);23 bis unter 24;1460;796;664
09273;      Kelheim (Lkr);24 bis unter 25;1394;751;643
09273;      Kelheim (Lkr);25 bis unter 26;1498;814;684
09273;      Kelheim (Lkr);26 bis unter 27;1539;815;724
09273;      Kelheim (Lkr);27 bis unter 28;1535;836;699
09273;      Kelheim (Lkr);28 bis unter 29;1632;913;719
09273;      Kelheim (Lkr);29 bis unter 30;1529;825;704
09273;      Kelheim (Lkr);30 bis unter 31;1611;879;732
09273;      Kelheim (Lkr);31 bis unter 32;1559;841;718
09273;      Kelheim (Lkr);32 bis unter 33;1579;818;761
09273;      Kelheim (Lkr);33 bis unter 34;1504;831;673
09273;      Kelheim (Lkr);34 bis unter 35;1535;811;724
09273;      Kelheim (Lkr);35 bis unter 36;1557;793;764
09273;      Kelheim (Lkr);36 bis unter 37;1676;881;795
09273;      Kelheim (Lkr);37 bis unter 38;1528;809;719
09273;      Kelheim (Lkr);38 bis unter 39;1650;841;809
09273;      Kelheim (Lkr);39 bis unter 40;1532;796;736
09273;      Kelheim (Lkr);40 bis unter 41;1554;778;776
09273;      Kelheim (Lkr);41 bis unter 42;1483;764;719
09273;      Kelheim (Lkr);42 bis unter 43;1641;820;821
09273;      Kelheim (Lkr);43 bis unter 44;1514;784;730
09273;      Kelheim (Lkr);44 bis unter 45;1517;766;751
09273;      Kelheim (Lkr);45 bis unter 46;1524;784;740
09273;      Kelheim (Lkr);46 bis unter 47;1677;895;782
09273;      Kelheim (Lkr);47 bis unter 48;1844;967;877
09273;      Kelheim (Lkr);48 bis unter 49;1801;936;865
09273;      Kelheim (Lkr);49 bis unter 50;2038;1069;969
09273;      Kelheim (Lkr);50 bis unter 51;2032;1030;1002
09273;      Kelheim (Lkr);51 bis unter 52;1972;989;983
09273;      Kelheim (Lkr);52 bis unter 53;2106;1115;991
09273;      Kelheim (Lkr);53 bis unter 54;2087;1081;1006
09273;      Kelheim (Lkr);54 bis unter 55;2142;1109;1033
09273;      Kelheim (Lkr);55 bis unter 56;2054;1055;999
09273;      Kelheim (Lkr);56 bis unter 57;1986;1040;946
09273;      Kelheim (Lkr);57 bis unter 58;1929;999;930
09273;      Kelheim (Lkr);58 bis unter 59;1898;985;913
09273;      Kelheim (Lkr);59 bis unter 60;1831;944;887
09273;      Kelheim (Lkr);60 bis unter 61;1726;877;849
09273;      Kelheim (Lkr);61 bis unter 62;1637;826;811
09273;      Kelheim (Lkr);62 bis unter 63;1622;849;773
09273;      Kelheim (Lkr);63 bis unter 64;1505;773;732
09273;      Kelheim (Lkr);64 bis unter 65;1439;730;709
09273;      Kelheim (Lkr);65 bis unter 66;1357;614;743
09273;      Kelheim (Lkr);66 bis unter 67;1452;692;760
09273;      Kelheim (Lkr);67 bis unter 68;1272;614;658
09273;      Kelheim (Lkr);68 bis unter 69;1255;621;634
09273;      Kelheim (Lkr);69 bis unter 70;1252;622;630
09273;      Kelheim (Lkr);70 bis unter 71;1098;539;559
09273;      Kelheim (Lkr);71 bis unter 72;1064;513;551
09273;      Kelheim (Lkr);72 bis unter 73;965;476;489
09273;      Kelheim (Lkr);73 bis unter 74;684;314;370
09273;      Kelheim (Lkr);74 bis unter 75;896;441;455
09273;      Kelheim (Lkr);75 bis unter 76;883;429;454
09273;      Kelheim (Lkr);76 bis unter 77;821;389;432
09273;      Kelheim (Lkr);77 bis unter 78;1038;503;535
09273;      Kelheim (Lkr);78 bis unter 79;1100;506;594
09273;      Kelheim (Lkr);79 bis unter 80;1084;474;610
09273;      Kelheim (Lkr);80 bis unter 81;966;427;539
09273;      Kelheim (Lkr);81 bis unter 82;795;346;449
09273;      Kelheim (Lkr);82 bis unter 83;752;310;442
09273;      Kelheim (Lkr);83 bis unter 84;618;250;368
09273;      Kelheim (Lkr);84 bis unter 85;555;225;330
09273;      Kelheim (Lkr);85 bis unter 90;1889;680;1209
09273;      Kelheim (Lkr);90 bis unter 95;735;198;537
09273;      Kelheim (Lkr);95 oder älter;171;32;139
09273;      Kelheim (Lkr);Insgesamt;122258;62137;60121
09274;      Landshut (Lkr);unter 1;1465;776;689
09274;      Landshut (Lkr);1 bis unter 2;1678;848;830
09274;      Landshut (Lkr);2 bis unter 3;1607;813;794
09274;      Landshut (Lkr);3 bis unter 4;1649;855;794
09274;      Landshut (Lkr);4 bis unter 5;1556;800;756
09274;      Landshut (Lkr);5 bis unter 6;1471;746;725
09274;      Landshut (Lkr);6 bis unter 7;1558;816;742
09274;      Landshut (Lkr);7 bis unter 8;1461;769;692
09274;      Landshut (Lkr);8 bis unter 9;1562;817;745
09274;      Landshut (Lkr);9 bis unter 10;1499;762;737
09274;      Landshut (Lkr);10 bis unter 11;1591;823;768
09274;      Landshut (Lkr);11 bis unter 12;1554;794;760
09274;      Landshut (Lkr);12 bis unter 13;1478;749;729
09274;      Landshut (Lkr);13 bis unter 14;1547;814;733
09274;      Landshut (Lkr);14 bis unter 15;1575;796;779
09274;      Landshut (Lkr);15 bis unter 16;1594;823;771
09274;      Landshut (Lkr);16 bis unter 17;1557;781;776
09274;      Landshut (Lkr);17 bis unter 18;1655;865;790
09274;      Landshut (Lkr);18 bis unter 19;1758;904;854
09274;      Landshut (Lkr);19 bis unter 20;1820;964;856
09274;      Landshut (Lkr);20 bis unter 21;1816;985;831
09274;      Landshut (Lkr);21 bis unter 22;1783;944;839
09274;      Landshut (Lkr);22 bis unter 23;1814;989;825
09274;      Landshut (Lkr);23 bis unter 24;1755;966;789
09274;      Landshut (Lkr);24 bis unter 25;1700;953;747
09274;      Landshut (Lkr);25 bis unter 26;1756;960;796
09274;      Landshut (Lkr);26 bis unter 27;1784;939;845
09274;      Landshut (Lkr);27 bis unter 28;1829;1020;809
09274;      Landshut (Lkr);28 bis unter 29;1946;1086;860
09274;      Landshut (Lkr);29 bis unter 30;1873;996;877
09274;      Landshut (Lkr);30 bis unter 31;1940;997;943
09274;      Landshut (Lkr);31 bis unter 32;1908;1029;879
09274;      Landshut (Lkr);32 bis unter 33;1908;996;912
09274;      Landshut (Lkr);33 bis unter 34;1895;1007;888
09274;      Landshut (Lkr);34 bis unter 35;1938;995;943
09274;      Landshut (Lkr);35 bis unter 36;2007;1023;984
09274;      Landshut (Lkr);36 bis unter 37;2070;1079;991
09274;      Landshut (Lkr);37 bis unter 38;2018;1036;982
09274;      Landshut (Lkr);38 bis unter 39;2055;1054;1001
09274;      Landshut (Lkr);39 bis unter 40;2049;1078;971
09274;      Landshut (Lkr);40 bis unter 41;2058;1066;992
09274;      Landshut (Lkr);41 bis unter 42;2044;1032;1012
09274;      Landshut (Lkr);42 bis unter 43;2059;1098;961
09274;      Landshut (Lkr);43 bis unter 44;1978;981;997
09274;      Landshut (Lkr);44 bis unter 45;2063;1061;1002
09274;      Landshut (Lkr);45 bis unter 46;2084;1049;1035
09274;      Landshut (Lkr);46 bis unter 47;2221;1108;1113
09274;      Landshut (Lkr);47 bis unter 48;2397;1229;1168
09274;      Landshut (Lkr);48 bis unter 49;2484;1271;1213
09274;      Landshut (Lkr);49 bis unter 50;2697;1393;1304
09274;      Landshut (Lkr);50 bis unter 51;2732;1415;1317
09274;      Landshut (Lkr);51 bis unter 52;2751;1446;1305
09274;      Landshut (Lkr);52 bis unter 53;2797;1441;1356
09274;      Landshut (Lkr);53 bis unter 54;2914;1491;1423
09274;      Landshut (Lkr);54 bis unter 55;2826;1452;1374
09274;      Landshut (Lkr);55 bis unter 56;2820;1425;1395
09274;      Landshut (Lkr);56 bis unter 57;2738;1385;1353
09274;      Landshut (Lkr);57 bis unter 58;2631;1347;1284
09274;      Landshut (Lkr);58 bis unter 59;2504;1286;1218
09274;      Landshut (Lkr);59 bis unter 60;2549;1316;1233
09274;      Landshut (Lkr);60 bis unter 61;2198;1115;1083
09274;      Landshut (Lkr);61 bis unter 62;2232;1163;1069
09274;      Landshut (Lkr);62 bis unter 63;2059;1035;1024
09274;      Landshut (Lkr);63 bis unter 64;1892;941;951
09274;      Landshut (Lkr);64 bis unter 65;1961;1002;959
09274;      Landshut (Lkr);65 bis unter 66;1724;863;861
09274;      Landshut (Lkr);66 bis unter 67;1796;820;976
09274;      Landshut (Lkr);67 bis unter 68;1661;825;836
09274;      Landshut (Lkr);68 bis unter 69;1725;837;888
09274;      Landshut (Lkr);69 bis unter 70;1646;796;850
09274;      Landshut (Lkr);70 bis unter 71;1525;786;739
09274;      Landshut (Lkr);71 bis unter 72;1510;759;751
09274;      Landshut (Lkr);72 bis unter 73;1243;602;641
09274;      Landshut (Lkr);73 bis unter 74;971;480;491
09274;      Landshut (Lkr);74 bis unter 75;1171;570;601
09274;      Landshut (Lkr);75 bis unter 76;1177;569;608
09274;      Landshut (Lkr);76 bis unter 77;1120;534;586
09274;      Landshut (Lkr);77 bis unter 78;1409;698;711
09274;      Landshut (Lkr);78 bis unter 79;1381;641;740
09274;      Landshut (Lkr);79 bis unter 80;1339;582;757
09274;      Landshut (Lkr);80 bis unter 81;1232;558;674
09274;      Landshut (Lkr);81 bis unter 82;1047;452;595
09274;      Landshut (Lkr);82 bis unter 83;922;381;541
09274;      Landshut (Lkr);83 bis unter 84;812;337;475
09274;      Landshut (Lkr);84 bis unter 85;706;270;436
09274;      Landshut (Lkr);85 bis unter 90;2298;863;1435
09274;      Landshut (Lkr);90 bis unter 95;904;251;653
09274;      Landshut (Lkr);95 oder älter;211;50;161
09274;      Landshut (Lkr);Insgesamt;158698;80519;78179
09275;      Passau (Lkr);unter 1;1539;805;734
09275;      Passau (Lkr);1 bis unter 2;1613;815;798
09275;      Passau (Lkr);2 bis unter 3;1671;842;829
09275;      Passau (Lkr);3 bis unter 4;1708;879;829
09275;      Passau (Lkr);4 bis unter 5;1632;838;794
09275;      Passau (Lkr);5 bis unter 6;1655;820;835
09275;      Passau (Lkr);6 bis unter 7;1695;877;818
09275;      Passau (Lkr);7 bis unter 8;1632;815;817
09275;      Passau (Lkr);8 bis unter 9;1588;823;765
09275;      Passau (Lkr);9 bis unter 10;1561;796;765
09275;      Passau (Lkr);10 bis unter 11;1679;871;808
09275;      Passau (Lkr);11 bis unter 12;1591;826;765
09275;      Passau (Lkr);12 bis unter 13;1618;867;751
09275;      Passau (Lkr);13 bis unter 14;1724;887;837
09275;      Passau (Lkr);14 bis unter 15;1754;933;821
09275;      Passau (Lkr);15 bis unter 16;1818;915;903
09275;      Passau (Lkr);16 bis unter 17;1913;1029;884
09275;      Passau (Lkr);17 bis unter 18;1893;1000;893
09275;      Passau (Lkr);18 bis unter 19;2034;1043;991
09275;      Passau (Lkr);19 bis unter 20;2134;1136;998
09275;      Passau (Lkr);20 bis unter 21;2052;1082;970
09275;      Passau (Lkr);21 bis unter 22;2180;1176;1004
09275;      Passau (Lkr);22 bis unter 23;2152;1147;1005
09275;      Passau (Lkr);23 bis unter 24;2108;1143;965
09275;      Passau (Lkr);24 bis unter 25;2067;1091;976
09275;      Passau (Lkr);25 bis unter 26;2192;1189;1003
09275;      Passau (Lkr);26 bis unter 27;2142;1111;1031
09275;      Passau (Lkr);27 bis unter 28;2197;1166;1031
09275;      Passau (Lkr);28 bis unter 29;2270;1206;1064
09275;      Passau (Lkr);29 bis unter 30;2208;1150;1058
09275;      Passau (Lkr);30 bis unter 31;2124;1085;1039
09275;      Passau (Lkr);31 bis unter 32;2214;1169;1045
09275;      Passau (Lkr);32 bis unter 33;2184;1103;1081
09275;      Passau (Lkr);33 bis unter 34;2095;1039;1056
09275;      Passau (Lkr);34 bis unter 35;2164;1117;1047
09275;      Passau (Lkr);35 bis unter 36;2192;1143;1049
09275;      Passau (Lkr);36 bis unter 37;2286;1148;1138
09275;      Passau (Lkr);37 bis unter 38;2457;1265;1192
09275;      Passau (Lkr);38 bis unter 39;2296;1200;1096
09275;      Passau (Lkr);39 bis unter 40;2280;1212;1068
09275;      Passau (Lkr);40 bis unter 41;2247;1152;1095
09275;      Passau (Lkr);41 bis unter 42;2212;1093;1119
09275;      Passau (Lkr);42 bis unter 43;2232;1155;1077
09275;      Passau (Lkr);43 bis unter 44;2211;1118;1093
09275;      Passau (Lkr);44 bis unter 45;2328;1180;1148
09275;      Passau (Lkr);45 bis unter 46;2369;1210;1159
09275;      Passau (Lkr);46 bis unter 47;2610;1307;1303
09275;      Passau (Lkr);47 bis unter 48;2770;1458;1312
09275;      Passau (Lkr);48 bis unter 49;2881;1459;1422
09275;      Passau (Lkr);49 bis unter 50;3147;1605;1542
09275;      Passau (Lkr);50 bis unter 51;3165;1610;1555
09275;      Passau (Lkr);51 bis unter 52;3176;1617;1559
09275;      Passau (Lkr);52 bis unter 53;3258;1629;1629
09275;      Passau (Lkr);53 bis unter 54;3185;1646;1539
09275;      Passau (Lkr);54 bis unter 55;3369;1670;1699
09275;      Passau (Lkr);55 bis unter 56;3343;1615;1728
09275;      Passau (Lkr);56 bis unter 57;3324;1654;1670
09275;      Passau (Lkr);57 bis unter 58;3289;1589;1700
09275;      Passau (Lkr);58 bis unter 59;3206;1605;1601
09275;      Passau (Lkr);59 bis unter 60;3201;1645;1556
09275;      Passau (Lkr);60 bis unter 61;2986;1471;1515
09275;      Passau (Lkr);61 bis unter 62;2841;1396;1445
09275;      Passau (Lkr);62 bis unter 63;2851;1475;1376
09275;      Passau (Lkr);63 bis unter 64;2604;1263;1341
09275;      Passau (Lkr);64 bis unter 65;2662;1285;1377
09275;      Passau (Lkr);65 bis unter 66;2483;1192;1291
09275;      Passau (Lkr);66 bis unter 67;2501;1171;1330
09275;      Passau (Lkr);67 bis unter 68;2437;1188;1249
09275;      Passau (Lkr);68 bis unter 69;2430;1226;1204
09275;      Passau (Lkr);69 bis unter 70;2300;1106;1194
09275;      Passau (Lkr);70 bis unter 71;2166;1073;1093
09275;      Passau (Lkr);71 bis unter 72;2054;984;1070
09275;      Passau (Lkr);72 bis unter 73;1819;888;931
09275;      Passau (Lkr);73 bis unter 74;1347;623;724
09275;      Passau (Lkr);74 bis unter 75;1694;790;904
09275;      Passau (Lkr);75 bis unter 76;1688;807;881
09275;      Passau (Lkr);76 bis unter 77;1606;803;803
09275;      Passau (Lkr);77 bis unter 78;1969;878;1091
09275;      Passau (Lkr);78 bis unter 79;2042;907;1135
09275;      Passau (Lkr);79 bis unter 80;1957;857;1100
09275;      Passau (Lkr);80 bis unter 81;1624;676;948
09275;      Passau (Lkr);81 bis unter 82;1527;641;886
09275;      Passau (Lkr);82 bis unter 83;1323;524;799
09275;      Passau (Lkr);83 bis unter 84;1276;490;786
09275;      Passau (Lkr);84 bis unter 85;961;381;580
09275;      Passau (Lkr);85 bis unter 90;3396;1189;2207
09275;      Passau (Lkr);90 bis unter 95;1360;348;1012
09275;      Passau (Lkr);95 oder älter;304;63;241
09275;      Passau (Lkr);Insgesamt;192043;95471;96572
09276;      Regen (Lkr);unter 1;624;321;303
09276;      Regen (Lkr);1 bis unter 2;714;354;360
09276;      Regen (Lkr);2 bis unter 3;682;351;331
09276;      Regen (Lkr);3 bis unter 4;695;362;333
09276;      Regen (Lkr);4 bis unter 5;631;311;320
09276;      Regen (Lkr);5 bis unter 6;628;344;284
09276;      Regen (Lkr);6 bis unter 7;617;326;291
09276;      Regen (Lkr);7 bis unter 8;615;336;279
09276;      Regen (Lkr);8 bis unter 9;640;358;282
09276;      Regen (Lkr);9 bis unter 10;574;294;280
09276;      Regen (Lkr);10 bis unter 11;644;342;302
09276;      Regen (Lkr);11 bis unter 12;641;345;296
09276;      Regen (Lkr);12 bis unter 13;621;318;303
09276;      Regen (Lkr);13 bis unter 14;720;346;374
09276;      Regen (Lkr);14 bis unter 15;709;354;355
09276;      Regen (Lkr);15 bis unter 16;731;394;337
09276;      Regen (Lkr);16 bis unter 17;691;380;311
09276;      Regen (Lkr);17 bis unter 18;809;401;408
09276;      Regen (Lkr);18 bis unter 19;908;457;451
09276;      Regen (Lkr);19 bis unter 20;796;421;375
09276;      Regen (Lkr);20 bis unter 21;844;474;370
09276;      Regen (Lkr);21 bis unter 22;867;465;402
09276;      Regen (Lkr);22 bis unter 23;864;456;408
09276;      Regen (Lkr);23 bis unter 24;862;458;404
09276;      Regen (Lkr);24 bis unter 25;845;475;370
09276;      Regen (Lkr);25 bis unter 26;860;454;406
09276;      Regen (Lkr);26 bis unter 27;872;475;397
09276;      Regen (Lkr);27 bis unter 28;925;502;423
09276;      Regen (Lkr);28 bis unter 29;990;540;450
09276;      Regen (Lkr);29 bis unter 30;919;498;421
09276;      Regen (Lkr);30 bis unter 31;952;541;411
09276;      Regen (Lkr);31 bis unter 32;939;506;433
09276;      Regen (Lkr);32 bis unter 33;916;462;454
09276;      Regen (Lkr);33 bis unter 34;863;454;409
09276;      Regen (Lkr);34 bis unter 35;864;478;386
09276;      Regen (Lkr);35 bis unter 36;913;462;451
09276;      Regen (Lkr);36 bis unter 37;870;440;430
09276;      Regen (Lkr);37 bis unter 38;880;457;423
09276;      Regen (Lkr);38 bis unter 39;911;469;442
09276;      Regen (Lkr);39 bis unter 40;871;439;432
09276;      Regen (Lkr);40 bis unter 41;864;421;443
09276;      Regen (Lkr);41 bis unter 42;900;440;460
09276;      Regen (Lkr);42 bis unter 43;867;445;422
09276;      Regen (Lkr);43 bis unter 44;880;417;463
09276;      Regen (Lkr);44 bis unter 45;854;448;406
09276;      Regen (Lkr);45 bis unter 46;948;495;453
09276;      Regen (Lkr);46 bis unter 47;1025;514;511
09276;      Regen (Lkr);47 bis unter 48;1164;574;590
09276;      Regen (Lkr);48 bis unter 49;1090;559;531
09276;      Regen (Lkr);49 bis unter 50;1162;587;575
09276;      Regen (Lkr);50 bis unter 51;1242;613;629
09276;      Regen (Lkr);51 bis unter 52;1291;665;626
09276;      Regen (Lkr);52 bis unter 53;1412;702;710
09276;      Regen (Lkr);53 bis unter 54;1279;640;639
09276;      Regen (Lkr);54 bis unter 55;1312;660;652
09276;      Regen (Lkr);55 bis unter 56;1353;677;676
09276;      Regen (Lkr);56 bis unter 57;1350;647;703
09276;      Regen (Lkr);57 bis unter 58;1341;694;647
09276;      Regen (Lkr);58 bis unter 59;1345;655;690
09276;      Regen (Lkr);59 bis unter 60;1339;691;648
09276;      Regen (Lkr);60 bis unter 61;1269;650;619
09276;      Regen (Lkr);61 bis unter 62;1239;613;626
09276;      Regen (Lkr);62 bis unter 63;1154;584;570
09276;      Regen (Lkr);63 bis unter 64;1118;532;586
09276;      Regen (Lkr);64 bis unter 65;1069;529;540
09276;      Regen (Lkr);65 bis unter 66;1045;521;524
09276;      Regen (Lkr);66 bis unter 67;1106;556;550
09276;      Regen (Lkr);67 bis unter 68;1063;539;524
09276;      Regen (Lkr);68 bis unter 69;1060;503;557
09276;      Regen (Lkr);69 bis unter 70;979;507;472
09276;      Regen (Lkr);70 bis unter 71;860;415;445
09276;      Regen (Lkr);71 bis unter 72;920;461;459
09276;      Regen (Lkr);72 bis unter 73;739;373;366
09276;      Regen (Lkr);73 bis unter 74;472;248;224
09276;      Regen (Lkr);74 bis unter 75;582;277;305
09276;      Regen (Lkr);75 bis unter 76;619;306;313
09276;      Regen (Lkr);76 bis unter 77;620;270;350
09276;      Regen (Lkr);77 bis unter 78;702;317;385
09276;      Regen (Lkr);78 bis unter 79;789;319;470
09276;      Regen (Lkr);79 bis unter 80;826;342;484
09276;      Regen (Lkr);80 bis unter 81;728;332;396
09276;      Regen (Lkr);81 bis unter 82;645;230;415
09276;      Regen (Lkr);82 bis unter 83;525;202;323
09276;      Regen (Lkr);83 bis unter 84;525;193;332
09276;      Regen (Lkr);84 bis unter 85;424;141;283
09276;      Regen (Lkr);85 bis unter 90;1417;472;945
09276;      Regen (Lkr);90 bis unter 95;516;127;389
09276;      Regen (Lkr);95 oder älter;110;22;88
09276;      Regen (Lkr);Insgesamt;77656;38745;38911
09277;      Rottal-Inn (Lkr);unter 1;1078;571;507
09277;      Rottal-Inn (Lkr);1 bis unter 2;1111;573;538
09277;      Rottal-Inn (Lkr);2 bis unter 3;1075;586;489
09277;      Rottal-Inn (Lkr);3 bis unter 4;1077;565;512
09277;      Rottal-Inn (Lkr);4 bis unter 5;1030;500;530
09277;      Rottal-Inn (Lkr);5 bis unter 6;1043;524;519
09277;      Rottal-Inn (Lkr);6 bis unter 7;1045;556;489
09277;      Rottal-Inn (Lkr);7 bis unter 8;977;510;467
09277;      Rottal-Inn (Lkr);8 bis unter 9;1063;537;526
09277;      Rottal-Inn (Lkr);9 bis unter 10;1038;558;480
09277;      Rottal-Inn (Lkr);10 bis unter 11;1086;545;541
09277;      Rottal-Inn (Lkr);11 bis unter 12;1071;535;536
09277;      Rottal-Inn (Lkr);12 bis unter 13;1055;526;529
09277;      Rottal-Inn (Lkr);13 bis unter 14;1098;564;534
09277;      Rottal-Inn (Lkr);14 bis unter 15;1151;593;558
09277;      Rottal-Inn (Lkr);15 bis unter 16;1149;571;578
09277;      Rottal-Inn (Lkr);16 bis unter 17;1223;616;607
09277;      Rottal-Inn (Lkr);17 bis unter 18;1186;606;580
09277;      Rottal-Inn (Lkr);18 bis unter 19;1316;687;629
09277;      Rottal-Inn (Lkr);19 bis unter 20;1391;732;659
09277;      Rottal-Inn (Lkr);20 bis unter 21;1364;744;620
09277;      Rottal-Inn (Lkr);21 bis unter 22;1499;805;694
09277;      Rottal-Inn (Lkr);22 bis unter 23;1514;797;717
09277;      Rottal-Inn (Lkr);23 bis unter 24;1404;769;635
09277;      Rottal-Inn (Lkr);24 bis unter 25;1398;758;640
09277;      Rottal-Inn (Lkr);25 bis unter 26;1466;777;689
09277;      Rottal-Inn (Lkr);26 bis unter 27;1471;773;698
09277;      Rottal-Inn (Lkr);27 bis unter 28;1419;772;647
09277;      Rottal-Inn (Lkr);28 bis unter 29;1482;810;672
09277;      Rottal-Inn (Lkr);29 bis unter 30;1408;730;678
09277;      Rottal-Inn (Lkr);30 bis unter 31;1420;760;660
09277;      Rottal-Inn (Lkr);31 bis unter 32;1372;718;654
09277;      Rottal-Inn (Lkr);32 bis unter 33;1401;702;699
09277;      Rottal-Inn (Lkr);33 bis unter 34;1396;760;636
09277;      Rottal-Inn (Lkr);34 bis unter 35;1377;733;644
09277;      Rottal-Inn (Lkr);35 bis unter 36;1430;718;712
09277;      Rottal-Inn (Lkr);36 bis unter 37;1427;722;705
09277;      Rottal-Inn (Lkr);37 bis unter 38;1549;743;806
09277;      Rottal-Inn (Lkr);38 bis unter 39;1476;776;700
09277;      Rottal-Inn (Lkr);39 bis unter 40;1373;685;688
09277;      Rottal-Inn (Lkr);40 bis unter 41;1391;745;646
09277;      Rottal-Inn (Lkr);41 bis unter 42;1351;701;650
09277;      Rottal-Inn (Lkr);42 bis unter 43;1424;753;671
09277;      Rottal-Inn (Lkr);43 bis unter 44;1366;686;680
09277;      Rottal-Inn (Lkr);44 bis unter 45;1468;765;703
09277;      Rottal-Inn (Lkr);45 bis unter 46;1400;739;661
09277;      Rottal-Inn (Lkr);46 bis unter 47;1591;841;750
09277;      Rottal-Inn (Lkr);47 bis unter 48;1663;897;766
09277;      Rottal-Inn (Lkr);48 bis unter 49;1860;910;950
09277;      Rottal-Inn (Lkr);49 bis unter 50;1913;947;966
09277;      Rottal-Inn (Lkr);50 bis unter 51;1964;1022;942
09277;      Rottal-Inn (Lkr);51 bis unter 52;1982;1028;954
09277;      Rottal-Inn (Lkr);52 bis unter 53;2045;1047;998
09277;      Rottal-Inn (Lkr);53 bis unter 54;2011;1001;1010
09277;      Rottal-Inn (Lkr);54 bis unter 55;2028;1053;975
09277;      Rottal-Inn (Lkr);55 bis unter 56;2165;1081;1084
09277;      Rottal-Inn (Lkr);56 bis unter 57;1989;995;994
09277;      Rottal-Inn (Lkr);57 bis unter 58;2047;1022;1025
09277;      Rottal-Inn (Lkr);58 bis unter 59;1985;963;1022
09277;      Rottal-Inn (Lkr);59 bis unter 60;1915;984;931
09277;      Rottal-Inn (Lkr);60 bis unter 61;1834;893;941
09277;      Rottal-Inn (Lkr);61 bis unter 62;1799;892;907
09277;      Rottal-Inn (Lkr);62 bis unter 63;1669;833;836
09277;      Rottal-Inn (Lkr);63 bis unter 64;1605;798;807
09277;      Rottal-Inn (Lkr);64 bis unter 65;1550;764;786
09277;      Rottal-Inn (Lkr);65 bis unter 66;1437;706;731
09277;      Rottal-Inn (Lkr);66 bis unter 67;1397;680;717
09277;      Rottal-Inn (Lkr);67 bis unter 68;1449;706;743
09277;      Rottal-Inn (Lkr);68 bis unter 69;1361;697;664
09277;      Rottal-Inn (Lkr);69 bis unter 70;1342;648;694
09277;      Rottal-Inn (Lkr);70 bis unter 71;1255;595;660
09277;      Rottal-Inn (Lkr);71 bis unter 72;1188;578;610
09277;      Rottal-Inn (Lkr);72 bis unter 73;1095;507;588
09277;      Rottal-Inn (Lkr);73 bis unter 74;831;398;433
09277;      Rottal-Inn (Lkr);74 bis unter 75;987;469;518
09277;      Rottal-Inn (Lkr);75 bis unter 76;968;443;525
09277;      Rottal-Inn (Lkr);76 bis unter 77;1048;496;552
09277;      Rottal-Inn (Lkr);77 bis unter 78;1215;562;653
09277;      Rottal-Inn (Lkr);78 bis unter 79;1259;562;697
09277;      Rottal-Inn (Lkr);79 bis unter 80;1218;540;678
09277;      Rottal-Inn (Lkr);80 bis unter 81;1104;478;626
09277;      Rottal-Inn (Lkr);81 bis unter 82;885;369;516
09277;      Rottal-Inn (Lkr);82 bis unter 83;846;349;497
09277;      Rottal-Inn (Lkr);83 bis unter 84;777;325;452
09277;      Rottal-Inn (Lkr);84 bis unter 85;687;262;425
09277;      Rottal-Inn (Lkr);85 bis unter 90;2279;801;1478
09277;      Rottal-Inn (Lkr);90 bis unter 95;899;264;635
09277;      Rottal-Inn (Lkr);95 oder älter;208;44;164
09277;      Rottal-Inn (Lkr);Insgesamt;120659;60346;60313
09278;      Straubing-Bogen (Lkr);unter 1;932;482;450
09278;      Straubing-Bogen (Lkr);1 bis unter 2;960;512;448
09278;      Straubing-Bogen (Lkr);2 bis unter 3;929;495;434
09278;      Straubing-Bogen (Lkr);3 bis unter 4;956;458;498
09278;      Straubing-Bogen (Lkr);4 bis unter 5;928;501;427
09278;      Straubing-Bogen (Lkr);5 bis unter 6;941;470;471
09278;      Straubing-Bogen (Lkr);6 bis unter 7;887;462;425
09278;      Straubing-Bogen (Lkr);7 bis unter 8;892;471;421
09278;      Straubing-Bogen (Lkr);8 bis unter 9;899;439;460
09278;      Straubing-Bogen (Lkr);9 bis unter 10;912;476;436
09278;      Straubing-Bogen (Lkr);10 bis unter 11;942;459;483
09278;      Straubing-Bogen (Lkr);11 bis unter 12;933;435;498
09278;      Straubing-Bogen (Lkr);12 bis unter 13;946;502;444
09278;      Straubing-Bogen (Lkr);13 bis unter 14;1007;506;501
09278;      Straubing-Bogen (Lkr);14 bis unter 15;971;473;498
09278;      Straubing-Bogen (Lkr);15 bis unter 16;1024;552;472
09278;      Straubing-Bogen (Lkr);16 bis unter 17;1042;576;466
09278;      Straubing-Bogen (Lkr);17 bis unter 18;1062;558;504
09278;      Straubing-Bogen (Lkr);18 bis unter 19;1175;623;552
09278;      Straubing-Bogen (Lkr);19 bis unter 20;1116;609;507
09278;      Straubing-Bogen (Lkr);20 bis unter 21;1159;628;531
09278;      Straubing-Bogen (Lkr);21 bis unter 22;1196;641;555
09278;      Straubing-Bogen (Lkr);22 bis unter 23;1038;554;484
09278;      Straubing-Bogen (Lkr);23 bis unter 24;1085;592;493
09278;      Straubing-Bogen (Lkr);24 bis unter 25;1029;540;489
09278;      Straubing-Bogen (Lkr);25 bis unter 26;1134;593;541
09278;      Straubing-Bogen (Lkr);26 bis unter 27;1145;627;518
09278;      Straubing-Bogen (Lkr);27 bis unter 28;1168;638;530
09278;      Straubing-Bogen (Lkr);28 bis unter 29;1230;616;614
09278;      Straubing-Bogen (Lkr);29 bis unter 30;1083;587;496
09278;      Straubing-Bogen (Lkr);30 bis unter 31;1234;662;572
09278;      Straubing-Bogen (Lkr);31 bis unter 32;1213;678;535
09278;      Straubing-Bogen (Lkr);32 bis unter 33;1250;634;616
09278;      Straubing-Bogen (Lkr);33 bis unter 34;1155;582;573
09278;      Straubing-Bogen (Lkr);34 bis unter 35;1214;633;581
09278;      Straubing-Bogen (Lkr);35 bis unter 36;1181;610;571
09278;      Straubing-Bogen (Lkr);36 bis unter 37;1258;650;608
09278;      Straubing-Bogen (Lkr);37 bis unter 38;1231;625;606
09278;      Straubing-Bogen (Lkr);38 bis unter 39;1262;637;625
09278;      Straubing-Bogen (Lkr);39 bis unter 40;1186;588;598
09278;      Straubing-Bogen (Lkr);40 bis unter 41;1228;639;589
09278;      Straubing-Bogen (Lkr);41 bis unter 42;1238;616;622
09278;      Straubing-Bogen (Lkr);42 bis unter 43;1290;669;621
09278;      Straubing-Bogen (Lkr);43 bis unter 44;1218;618;600
09278;      Straubing-Bogen (Lkr);44 bis unter 45;1308;650;658
09278;      Straubing-Bogen (Lkr);45 bis unter 46;1256;638;618
09278;      Straubing-Bogen (Lkr);46 bis unter 47;1362;676;686
09278;      Straubing-Bogen (Lkr);47 bis unter 48;1596;788;808
09278;      Straubing-Bogen (Lkr);48 bis unter 49;1625;841;784
09278;      Straubing-Bogen (Lkr);49 bis unter 50;1641;836;805
09278;      Straubing-Bogen (Lkr);50 bis unter 51;1714;891;823
09278;      Straubing-Bogen (Lkr);51 bis unter 52;1828;921;907
09278;      Straubing-Bogen (Lkr);52 bis unter 53;1733;904;829
09278;      Straubing-Bogen (Lkr);53 bis unter 54;1742;893;849
09278;      Straubing-Bogen (Lkr);54 bis unter 55;1779;936;843
09278;      Straubing-Bogen (Lkr);55 bis unter 56;1751;890;861
09278;      Straubing-Bogen (Lkr);56 bis unter 57;1797;902;895
09278;      Straubing-Bogen (Lkr);57 bis unter 58;1686;870;816
09278;      Straubing-Bogen (Lkr);58 bis unter 59;1681;860;821
09278;      Straubing-Bogen (Lkr);59 bis unter 60;1594;781;813
09278;      Straubing-Bogen (Lkr);60 bis unter 61;1471;758;713
09278;      Straubing-Bogen (Lkr);61 bis unter 62;1519;756;763
09278;      Straubing-Bogen (Lkr);62 bis unter 63;1429;736;693
09278;      Straubing-Bogen (Lkr);63 bis unter 64;1309;671;638
09278;      Straubing-Bogen (Lkr);64 bis unter 65;1267;628;639
09278;      Straubing-Bogen (Lkr);65 bis unter 66;1224;625;599
09278;      Straubing-Bogen (Lkr);66 bis unter 67;1245;634;611
09278;      Straubing-Bogen (Lkr);67 bis unter 68;1177;586;591
09278;      Straubing-Bogen (Lkr);68 bis unter 69;1151;568;583
09278;      Straubing-Bogen (Lkr);69 bis unter 70;1058;508;550
09278;      Straubing-Bogen (Lkr);70 bis unter 71;1012;488;524
09278;      Straubing-Bogen (Lkr);71 bis unter 72;972;482;490
09278;      Straubing-Bogen (Lkr);72 bis unter 73;804;382;422
09278;      Straubing-Bogen (Lkr);73 bis unter 74;609;285;324
09278;      Straubing-Bogen (Lkr);74 bis unter 75;709;344;365
09278;      Straubing-Bogen (Lkr);75 bis unter 76;759;377;382
09278;      Straubing-Bogen (Lkr);76 bis unter 77;709;331;378
09278;      Straubing-Bogen (Lkr);77 bis unter 78;889;410;479
09278;      Straubing-Bogen (Lkr);78 bis unter 79;963;456;507
09278;      Straubing-Bogen (Lkr);79 bis unter 80;950;439;511
09278;      Straubing-Bogen (Lkr);80 bis unter 81;797;360;437
09278;      Straubing-Bogen (Lkr);81 bis unter 82;694;265;429
09278;      Straubing-Bogen (Lkr);82 bis unter 83;607;248;359
09278;      Straubing-Bogen (Lkr);83 bis unter 84;522;222;300
09278;      Straubing-Bogen (Lkr);84 bis unter 85;492;162;330
09278;      Straubing-Bogen (Lkr);85 bis unter 90;1588;534;1054
09278;      Straubing-Bogen (Lkr);90 bis unter 95;607;157;450
09278;      Straubing-Bogen (Lkr);95 oder älter;144;22;122
09278;      Straubing-Bogen (Lkr);Insgesamt;100649;50627;50022
09279;      Dingolfing-Landau (Lkr);unter 1;920;448;472
09279;      Dingolfing-Landau (Lkr);1 bis unter 2;921;492;429
09279;      Dingolfing-Landau (Lkr);2 bis unter 3;927;472;455
09279;      Dingolfing-Landau (Lkr);3 bis unter 4;836;412;424
09279;      Dingolfing-Landau (Lkr);4 bis unter 5;889;479;410
09279;      Dingolfing-Landau (Lkr);5 bis unter 6;834;440;394
09279;      Dingolfing-Landau (Lkr);6 bis unter 7;822;445;377
09279;      Dingolfing-Landau (Lkr);7 bis unter 8;807;420;387
09279;      Dingolfing-Landau (Lkr);8 bis unter 9;830;425;405
09279;      Dingolfing-Landau (Lkr);9 bis unter 10;794;386;408
09279;      Dingolfing-Landau (Lkr);10 bis unter 11;879;455;424
09279;      Dingolfing-Landau (Lkr);11 bis unter 12;862;448;414
09279;      Dingolfing-Landau (Lkr);12 bis unter 13;869;448;421
09279;      Dingolfing-Landau (Lkr);13 bis unter 14;883;438;445
09279;      Dingolfing-Landau (Lkr);14 bis unter 15;887;467;420
09279;      Dingolfing-Landau (Lkr);15 bis unter 16;952;477;475
09279;      Dingolfing-Landau (Lkr);16 bis unter 17;947;480;467
09279;      Dingolfing-Landau (Lkr);17 bis unter 18;966;488;478
09279;      Dingolfing-Landau (Lkr);18 bis unter 19;1069;561;508
09279;      Dingolfing-Landau (Lkr);19 bis unter 20;1032;586;446
09279;      Dingolfing-Landau (Lkr);20 bis unter 21;1059;599;460
09279;      Dingolfing-Landau (Lkr);21 bis unter 22;1023;543;480
09279;      Dingolfing-Landau (Lkr);22 bis unter 23;1148;622;526
09279;      Dingolfing-Landau (Lkr);23 bis unter 24;1132;669;463
09279;      Dingolfing-Landau (Lkr);24 bis unter 25;1126;602;524
09279;      Dingolfing-Landau (Lkr);25 bis unter 26;1268;685;583
09279;      Dingolfing-Landau (Lkr);26 bis unter 27;1239;692;547
09279;      Dingolfing-Landau (Lkr);27 bis unter 28;1337;724;613
09279;      Dingolfing-Landau (Lkr);28 bis unter 29;1343;743;600
09279;      Dingolfing-Landau (Lkr);29 bis unter 30;1344;758;586
09279;      Dingolfing-Landau (Lkr);30 bis unter 31;1241;715;526
09279;      Dingolfing-Landau (Lkr);31 bis unter 32;1278;700;578
09279;      Dingolfing-Landau (Lkr);32 bis unter 33;1313;740;573
09279;      Dingolfing-Landau (Lkr);33 bis unter 34;1222;664;558
09279;      Dingolfing-Landau (Lkr);34 bis unter 35;1210;625;585
09279;      Dingolfing-Landau (Lkr);35 bis unter 36;1266;687;579
09279;      Dingolfing-Landau (Lkr);36 bis unter 37;1216;639;577
09279;      Dingolfing-Landau (Lkr);37 bis unter 38;1212;636;576
09279;      Dingolfing-Landau (Lkr);38 bis unter 39;1261;691;570
09279;      Dingolfing-Landau (Lkr);39 bis unter 40;1235;632;603
09279;      Dingolfing-Landau (Lkr);40 bis unter 41;1131;617;514
09279;      Dingolfing-Landau (Lkr);41 bis unter 42;1191;623;568
09279;      Dingolfing-Landau (Lkr);42 bis unter 43;1200;656;544
09279;      Dingolfing-Landau (Lkr);43 bis unter 44;1188;671;517
09279;      Dingolfing-Landau (Lkr);44 bis unter 45;1196;618;578
09279;      Dingolfing-Landau (Lkr);45 bis unter 46;1199;619;580
09279;      Dingolfing-Landau (Lkr);46 bis unter 47;1315;692;623
09279;      Dingolfing-Landau (Lkr);47 bis unter 48;1396;724;672
09279;      Dingolfing-Landau (Lkr);48 bis unter 49;1430;755;675
09279;      Dingolfing-Landau (Lkr);49 bis unter 50;1565;809;756
09279;      Dingolfing-Landau (Lkr);50 bis unter 51;1577;816;761
09279;      Dingolfing-Landau (Lkr);51 bis unter 52;1622;837;785
09279;      Dingolfing-Landau (Lkr);52 bis unter 53;1522;805;717
09279;      Dingolfing-Landau (Lkr);53 bis unter 54;1586;824;762
09279;      Dingolfing-Landau (Lkr);54 bis unter 55;1659;879;780
09279;      Dingolfing-Landau (Lkr);55 bis unter 56;1704;859;845
09279;      Dingolfing-Landau (Lkr);56 bis unter 57;1665;842;823
09279;      Dingolfing-Landau (Lkr);57 bis unter 58;1638;852;786
09279;      Dingolfing-Landau (Lkr);58 bis unter 59;1598;810;788
09279;      Dingolfing-Landau (Lkr);59 bis unter 60;1570;820;750
09279;      Dingolfing-Landau (Lkr);60 bis unter 61;1445;690;755
09279;      Dingolfing-Landau (Lkr);61 bis unter 62;1407;734;673
09279;      Dingolfing-Landau (Lkr);62 bis unter 63;1333;673;660
09279;      Dingolfing-Landau (Lkr);63 bis unter 64;1263;642;621
09279;      Dingolfing-Landau (Lkr);64 bis unter 65;1117;591;526
09279;      Dingolfing-Landau (Lkr);65 bis unter 66;1152;589;563
09279;      Dingolfing-Landau (Lkr);66 bis unter 67;1017;499;518
09279;      Dingolfing-Landau (Lkr);67 bis unter 68;1136;581;555
09279;      Dingolfing-Landau (Lkr);68 bis unter 69;1005;489;516
09279;      Dingolfing-Landau (Lkr);69 bis unter 70;995;493;502
09279;      Dingolfing-Landau (Lkr);70 bis unter 71;916;442;474
09279;      Dingolfing-Landau (Lkr);71 bis unter 72;895;443;452
09279;      Dingolfing-Landau (Lkr);72 bis unter 73;736;351;385
09279;      Dingolfing-Landau (Lkr);73 bis unter 74;554;278;276
09279;      Dingolfing-Landau (Lkr);74 bis unter 75;684;328;356
09279;      Dingolfing-Landau (Lkr);75 bis unter 76;699;328;371
09279;      Dingolfing-Landau (Lkr);76 bis unter 77;648;286;362
09279;      Dingolfing-Landau (Lkr);77 bis unter 78;851;408;443
09279;      Dingolfing-Landau (Lkr);78 bis unter 79;874;406;468
09279;      Dingolfing-Landau (Lkr);79 bis unter 80;829;376;453
09279;      Dingolfing-Landau (Lkr);80 bis unter 81;804;364;440
09279;      Dingolfing-Landau (Lkr);81 bis unter 82;682;283;399
09279;      Dingolfing-Landau (Lkr);82 bis unter 83;631;271;360
09279;      Dingolfing-Landau (Lkr);83 bis unter 84;560;215;345
09279;      Dingolfing-Landau (Lkr);84 bis unter 85;493;220;273
09279;      Dingolfing-Landau (Lkr);85 bis unter 90;1498;534;964
09279;      Dingolfing-Landau (Lkr);90 bis unter 95;536;158;378
09279;      Dingolfing-Landau (Lkr);95 oder älter;106;17;89
09279;      Dingolfing-Landau (Lkr);Insgesamt;96217;49450;46767
LK092;    Landkreise Niederbayern;unter 1;9424;4874;4550
LK092;    Landkreise Niederbayern;1 bis unter 2;9910;5055;4855
LK092;    Landkreise Niederbayern;2 bis unter 3;9856;5066;4790
LK092;    Landkreise Niederbayern;3 bis unter 4;9761;4987;4774
LK092;    Landkreise Niederbayern;4 bis unter 5;9513;4900;4613
LK092;    Landkreise Niederbayern;5 bis unter 6;9413;4819;4594
LK092;    Landkreise Niederbayern;6 bis unter 7;9468;4963;4505
LK092;    Landkreise Niederbayern;7 bis unter 8;9103;4716;4387
LK092;    Landkreise Niederbayern;8 bis unter 9;9343;4787;4556
LK092;    Landkreise Niederbayern;9 bis unter 10;9083;4667;4416
LK092;    Landkreise Niederbayern;10 bis unter 11;9627;4958;4669
LK092;    Landkreise Niederbayern;11 bis unter 12;9445;4816;4629
LK092;    Landkreise Niederbayern;12 bis unter 13;9440;4879;4561
LK092;    Landkreise Niederbayern;13 bis unter 14;9902;5036;4866
LK092;    Landkreise Niederbayern;14 bis unter 15;10103;5147;4956
LK092;    Landkreise Niederbayern;15 bis unter 16;10374;5319;5055
LK092;    Landkreise Niederbayern;16 bis unter 17;10634;5562;5072
LK092;    Landkreise Niederbayern;17 bis unter 18;10859;5628;5231
LK092;    Landkreise Niederbayern;18 bis unter 19;11759;6119;5640
LK092;    Landkreise Niederbayern;19 bis unter 20;12009;6455;5554
LK092;    Landkreise Niederbayern;20 bis unter 21;12078;6550;5528
LK092;    Landkreise Niederbayern;21 bis unter 22;12371;6644;5727
LK092;    Landkreise Niederbayern;22 bis unter 23;12400;6687;5713
LK092;    Landkreise Niederbayern;23 bis unter 24;12113;6587;5526
LK092;    Landkreise Niederbayern;24 bis unter 25;11923;6482;5441
LK092;    Landkreise Niederbayern;25 bis unter 26;12646;6755;5891
LK092;    Landkreise Niederbayern;26 bis unter 27;12630;6737;5893
LK092;    Landkreise Niederbayern;27 bis unter 28;12862;6983;5879
LK092;    Landkreise Niederbayern;28 bis unter 29;13403;7266;6137
LK092;    Landkreise Niederbayern;29 bis unter 30;12682;6763;5919
LK092;    Landkreise Niederbayern;30 bis unter 31;12843;6855;5988
LK092;    Landkreise Niederbayern;31 bis unter 32;12805;6831;5974
LK092;    Landkreise Niederbayern;32 bis unter 33;12913;6671;6242
LK092;    Landkreise Niederbayern;33 bis unter 34;12342;6485;5857
LK092;    Landkreise Niederbayern;34 bis unter 35;12642;6660;5982
LK092;    Landkreise Niederbayern;35 bis unter 36;12872;6632;6240
LK092;    Landkreise Niederbayern;36 bis unter 37;13221;6807;6414
LK092;    Landkreise Niederbayern;37 bis unter 38;13315;6837;6478
LK092;    Landkreise Niederbayern;38 bis unter 39;13312;6878;6434
LK092;    Landkreise Niederbayern;39 bis unter 40;12793;6601;6192
LK092;    Landkreise Niederbayern;40 bis unter 41;12704;6536;6168
LK092;    Landkreise Niederbayern;41 bis unter 42;12705;6455;6250
LK092;    Landkreise Niederbayern;42 bis unter 43;13025;6758;6267
LK092;    Landkreise Niederbayern;43 bis unter 44;12566;6383;6183
LK092;    Landkreise Niederbayern;44 bis unter 45;13210;6748;6462
LK092;    Landkreise Niederbayern;45 bis unter 46;13201;6741;6460
LK092;    Landkreise Niederbayern;46 bis unter 47;14468;7385;7083
LK092;    Landkreise Niederbayern;47 bis unter 48;15649;8056;7593
LK092;    Landkreise Niederbayern;48 bis unter 49;16070;8173;7897
LK092;    Landkreise Niederbayern;49 bis unter 50;17232;8841;8391
LK092;    Landkreise Niederbayern;50 bis unter 51;17569;8991;8578
LK092;    Landkreise Niederbayern;51 bis unter 52;17957;9144;8813
LK092;    Landkreise Niederbayern;52 bis unter 53;18212;9362;8850
LK092;    Landkreise Niederbayern;53 bis unter 54;18223;9336;8887
LK092;    Landkreise Niederbayern;54 bis unter 55;18552;9481;9071
LK092;    Landkreise Niederbayern;55 bis unter 56;18670;9308;9362
LK092;    Landkreise Niederbayern;56 bis unter 57;18313;9133;9180
LK092;    Landkreise Niederbayern;57 bis unter 58;18140;9181;8959
LK092;    Landkreise Niederbayern;58 bis unter 59;17585;8851;8734
LK092;    Landkreise Niederbayern;59 bis unter 60;17349;8865;8484
LK092;    Landkreise Niederbayern;60 bis unter 61;16073;7994;8079
LK092;    Landkreise Niederbayern;61 bis unter 62;15663;7866;7797
LK092;    Landkreise Niederbayern;62 bis unter 63;14976;7626;7350
LK092;    Landkreise Niederbayern;63 bis unter 64;14027;6996;7031
LK092;    Landkreise Niederbayern;64 bis unter 65;13815;6865;6950
LK092;    Landkreise Niederbayern;65 bis unter 66;13036;6393;6643
LK092;    Landkreise Niederbayern;66 bis unter 67;13091;6336;6755
LK092;    Landkreise Niederbayern;67 bis unter 68;12597;6242;6355
LK092;    Landkreise Niederbayern;68 bis unter 69;12442;6159;6283
LK092;    Landkreise Niederbayern;69 bis unter 70;11820;5822;5998
LK092;    Landkreise Niederbayern;70 bis unter 71;10907;5365;5542
LK092;    Landkreise Niederbayern;71 bis unter 72;10632;5225;5407
LK092;    Landkreise Niederbayern;72 bis unter 73;9135;4438;4697
LK092;    Landkreise Niederbayern;73 bis unter 74;6711;3183;3528
LK092;    Landkreise Niederbayern;74 bis unter 75;8360;4008;4352
LK092;    Landkreise Niederbayern;75 bis unter 76;8317;3956;4361
LK092;    Landkreise Niederbayern;76 bis unter 77;8116;3828;4288
LK092;    Landkreise Niederbayern;77 bis unter 78;9867;4615;5252
LK092;    Landkreise Niederbayern;78 bis unter 79;10320;4625;5695
LK092;    Landkreise Niederbayern;79 bis unter 80;10065;4425;5640
LK092;    Landkreise Niederbayern;80 bis unter 81;8887;3895;4992
LK092;    Landkreise Niederbayern;81 bis unter 82;7688;3171;4517
LK092;    Landkreise Niederbayern;82 bis unter 83;6940;2831;4109
LK092;    Landkreise Niederbayern;83 bis unter 84;6263;2485;3778
LK092;    Landkreise Niederbayern;84 bis unter 85;5408;2060;3348
LK092;    Landkreise Niederbayern;85 bis unter 90;17694;6185;11509
LK092;    Landkreise Niederbayern;90 bis unter 95;6886;1855;5031
LK092;    Landkreise Niederbayern;95 oder älter;1533;304;1229
LK092;    Landkreise Niederbayern;Insgesamt;1065861;535945;529916
092;  Niederbayern;unter 1;11035;5689;5346
092;  Niederbayern;1 bis unter 2;11365;5785;5580
092;  Niederbayern;2 bis unter 3;11371;5823;5548
092;  Niederbayern;3 bis unter 4;11180;5714;5466
092;  Niederbayern;4 bis unter 5;10924;5640;5284
092;  Niederbayern;5 bis unter 6;10710;5469;5241
092;  Niederbayern;6 bis unter 7;10815;5654;5161
092;  Niederbayern;7 bis unter 8;10371;5327;5044
092;  Niederbayern;8 bis unter 9;10701;5487;5214
092;  Niederbayern;9 bis unter 10;10479;5365;5114
092;  Niederbayern;10 bis unter 11;10968;5647;5321
092;  Niederbayern;11 bis unter 12;10789;5548;5241
092;  Niederbayern;12 bis unter 13;10753;5549;5204
092;  Niederbayern;13 bis unter 14;11226;5708;5518
092;  Niederbayern;14 bis unter 15;11440;5836;5604
092;  Niederbayern;15 bis unter 16;11722;5998;5724
092;  Niederbayern;16 bis unter 17;12062;6279;5783
092;  Niederbayern;17 bis unter 18;12236;6363;5873
092;  Niederbayern;18 bis unter 19;13375;6941;6434
092;  Niederbayern;19 bis unter 20;13974;7465;6509
092;  Niederbayern;20 bis unter 21;14368;7678;6690
092;  Niederbayern;21 bis unter 22;14993;7936;7057
092;  Niederbayern;22 bis unter 23;15003;7964;7039
092;  Niederbayern;23 bis unter 24;14725;7916;6809
092;  Niederbayern;24 bis unter 25;14589;7868;6721
092;  Niederbayern;25 bis unter 26;15416;8190;7226
092;  Niederbayern;26 bis unter 27;15546;8276;7270
092;  Niederbayern;27 bis unter 28;15750;8559;7191
092;  Niederbayern;28 bis unter 29;16330;8825;7505
092;  Niederbayern;29 bis unter 30;15567;8376;7191
092;  Niederbayern;30 bis unter 31;15587;8291;7296
092;  Niederbayern;31 bis unter 32;15437;8236;7201
092;  Niederbayern;32 bis unter 33;15450;8056;7394
092;  Niederbayern;33 bis unter 34;14710;7743;6967
092;  Niederbayern;34 bis unter 35;14930;7882;7048
092;  Niederbayern;35 bis unter 36;15150;7842;7308
092;  Niederbayern;36 bis unter 37;15498;8015;7483
092;  Niederbayern;37 bis unter 38;15572;8006;7566
092;  Niederbayern;38 bis unter 39;15548;7995;7553
092;  Niederbayern;39 bis unter 40;14834;7624;7210
092;  Niederbayern;40 bis unter 41;14806;7620;7186
092;  Niederbayern;41 bis unter 42;14851;7592;7259
092;  Niederbayern;42 bis unter 43;15014;7770;7244
092;  Niederbayern;43 bis unter 44;14614;7396;7218
092;  Niederbayern;44 bis unter 45;15295;7808;7487
092;  Niederbayern;45 bis unter 46;15181;7744;7437
092;  Niederbayern;46 bis unter 47;16529;8496;8033
092;  Niederbayern;47 bis unter 48;17815;9171;8644
092;  Niederbayern;48 bis unter 49;18440;9356;9084
092;  Niederbayern;49 bis unter 50;19790;10128;9662
092;  Niederbayern;50 bis unter 51;20209;10385;9824
092;  Niederbayern;51 bis unter 52;20600;10510;10090
092;  Niederbayern;52 bis unter 53;20714;10621;10093
092;  Niederbayern;53 bis unter 54;20658;10600;10058
092;  Niederbayern;54 bis unter 55;21151;10811;10340
092;  Niederbayern;55 bis unter 56;21360;10694;10666
092;  Niederbayern;56 bis unter 57;20765;10333;10432
092;  Niederbayern;57 bis unter 58;20671;10412;10259
092;  Niederbayern;58 bis unter 59;19960;10013;9947
092;  Niederbayern;59 bis unter 60;19656;9961;9695
092;  Niederbayern;60 bis unter 61;18336;9073;9263
092;  Niederbayern;61 bis unter 62;17852;8896;8956
092;  Niederbayern;62 bis unter 63;17066;8621;8445
092;  Niederbayern;63 bis unter 64;15965;7897;8068
092;  Niederbayern;64 bis unter 65;15826;7782;8044
092;  Niederbayern;65 bis unter 66;14871;7230;7641
092;  Niederbayern;66 bis unter 67;14992;7194;7798
092;  Niederbayern;67 bis unter 68;14500;7119;7381
092;  Niederbayern;68 bis unter 69;14424;7050;7374
092;  Niederbayern;69 bis unter 70;13650;6669;6981
092;  Niederbayern;70 bis unter 71;12669;6171;6498
092;  Niederbayern;71 bis unter 72;12330;5982;6348
092;  Niederbayern;72 bis unter 73;10660;5118;5542
092;  Niederbayern;73 bis unter 74;7918;3696;4222
092;  Niederbayern;74 bis unter 75;9907;4711;5196
092;  Niederbayern;75 bis unter 76;9837;4626;5211
092;  Niederbayern;76 bis unter 77;9567;4438;5129
092;  Niederbayern;77 bis unter 78;11617;5398;6219
092;  Niederbayern;78 bis unter 79;12109;5392;6717
092;  Niederbayern;79 bis unter 80;11783;5172;6611
092;  Niederbayern;80 bis unter 81;10361;4513;5848
092;  Niederbayern;81 bis unter 82;9020;3675;5345
092;  Niederbayern;82 bis unter 83;8111;3334;4777
092;  Niederbayern;83 bis unter 84;7310;2899;4411
092;  Niederbayern;84 bis unter 85;6273;2374;3899
092;  Niederbayern;85 bis unter 90;20767;7194;13573
092;  Niederbayern;90 bis unter 95;8351;2236;6115
092;  Niederbayern;95 oder älter;1878;363;1515
092;  Niederbayern;Insgesamt;1238528;620809;617719
09361;      Amberg (Krfr.St);unter 1;385;191;194
09361;      Amberg (Krfr.St);1 bis unter 2;379;192;187
09361;      Amberg (Krfr.St);2 bis unter 3;344;171;173
09361;      Amberg (Krfr.St);3 bis unter 4;332;162;170
09361;      Amberg (Krfr.St);4 bis unter 5;330;162;168
09361;      Amberg (Krfr.St);5 bis unter 6;307;144;163
09361;      Amberg (Krfr.St);6 bis unter 7;331;152;179
09361;      Amberg (Krfr.St);7 bis unter 8;342;191;151
09361;      Amberg (Krfr.St);8 bis unter 9;325;178;147
09361;      Amberg (Krfr.St);9 bis unter 10;338;184;154
09361;      Amberg (Krfr.St);10 bis unter 11;353;195;158
09361;      Amberg (Krfr.St);11 bis unter 12;339;190;149
09361;      Amberg (Krfr.St);12 bis unter 13;341;178;163
09361;      Amberg (Krfr.St);13 bis unter 14;376;200;176
09361;      Amberg (Krfr.St);14 bis unter 15;332;167;165
09361;      Amberg (Krfr.St);15 bis unter 16;355;176;179
09361;      Amberg (Krfr.St);16 bis unter 17;375;189;186
09361;      Amberg (Krfr.St);17 bis unter 18;409;202;207
09361;      Amberg (Krfr.St);18 bis unter 19;421;219;202
09361;      Amberg (Krfr.St);19 bis unter 20;427;237;190
09361;      Amberg (Krfr.St);20 bis unter 21;464;246;218
09361;      Amberg (Krfr.St);21 bis unter 22;445;250;195
09361;      Amberg (Krfr.St);22 bis unter 23;479;271;208
09361;      Amberg (Krfr.St);23 bis unter 24;465;242;223
09361;      Amberg (Krfr.St);24 bis unter 25;506;263;243
09361;      Amberg (Krfr.St);25 bis unter 26;523;292;231
09361;      Amberg (Krfr.St);26 bis unter 27;507;285;222
09361;      Amberg (Krfr.St);27 bis unter 28;557;306;251
09361;      Amberg (Krfr.St);28 bis unter 29;640;351;289
09361;      Amberg (Krfr.St);29 bis unter 30;577;326;251
09361;      Amberg (Krfr.St);30 bis unter 31;575;315;260
09361;      Amberg (Krfr.St);31 bis unter 32;547;291;256
09361;      Amberg (Krfr.St);32 bis unter 33;569;331;238
09361;      Amberg (Krfr.St);33 bis unter 34;522;287;235
09361;      Amberg (Krfr.St);34 bis unter 35;497;265;232
09361;      Amberg (Krfr.St);35 bis unter 36;500;266;234
09361;      Amberg (Krfr.St);36 bis unter 37;562;319;243
09361;      Amberg (Krfr.St);37 bis unter 38;450;255;195
09361;      Amberg (Krfr.St);38 bis unter 39;501;264;237
09361;      Amberg (Krfr.St);39 bis unter 40;466;239;227
09361;      Amberg (Krfr.St);40 bis unter 41;465;242;223
09361;      Amberg (Krfr.St);41 bis unter 42;498;266;232
09361;      Amberg (Krfr.St);42 bis unter 43;451;230;221
09361;      Amberg (Krfr.St);43 bis unter 44;445;235;210
09361;      Amberg (Krfr.St);44 bis unter 45;465;240;225
09361;      Amberg (Krfr.St);45 bis unter 46;419;190;229
09361;      Amberg (Krfr.St);46 bis unter 47;464;223;241
09361;      Amberg (Krfr.St);47 bis unter 48;553;267;286
09361;      Amberg (Krfr.St);48 bis unter 49;608;316;292
09361;      Amberg (Krfr.St);49 bis unter 50;623;337;286
09361;      Amberg (Krfr.St);50 bis unter 51;609;307;302
09361;      Amberg (Krfr.St);51 bis unter 52;642;288;354
09361;      Amberg (Krfr.St);52 bis unter 53;686;333;353
09361;      Amberg (Krfr.St);53 bis unter 54;711;350;361
09361;      Amberg (Krfr.St);54 bis unter 55;707;356;351
09361;      Amberg (Krfr.St);55 bis unter 56;727;361;366
09361;      Amberg (Krfr.St);56 bis unter 57;695;356;339
09361;      Amberg (Krfr.St);57 bis unter 58;614;293;321
09361;      Amberg (Krfr.St);58 bis unter 59;691;342;349
09361;      Amberg (Krfr.St);59 bis unter 60;638;319;319
09361;      Amberg (Krfr.St);60 bis unter 61;611;294;317
09361;      Amberg (Krfr.St);61 bis unter 62;607;297;310
09361;      Amberg (Krfr.St);62 bis unter 63;594;296;298
09361;      Amberg (Krfr.St);63 bis unter 64;548;253;295
09361;      Amberg (Krfr.St);64 bis unter 65;569;268;301
09361;      Amberg (Krfr.St);65 bis unter 66;529;246;283
09361;      Amberg (Krfr.St);66 bis unter 67;539;247;292
09361;      Amberg (Krfr.St);67 bis unter 68;591;269;322
09361;      Amberg (Krfr.St);68 bis unter 69;488;229;259
09361;      Amberg (Krfr.St);69 bis unter 70;481;226;255
09361;      Amberg (Krfr.St);70 bis unter 71;477;226;251
09361;      Amberg (Krfr.St);71 bis unter 72;427;189;238
09361;      Amberg (Krfr.St);72 bis unter 73;388;180;208
09361;      Amberg (Krfr.St);73 bis unter 74;298;151;147
09361;      Amberg (Krfr.St);74 bis unter 75;347;158;189
09361;      Amberg (Krfr.St);75 bis unter 76;367;155;212
09361;      Amberg (Krfr.St);76 bis unter 77;331;131;200
09361;      Amberg (Krfr.St);77 bis unter 78;470;217;253
09361;      Amberg (Krfr.St);78 bis unter 79;457;175;282
09361;      Amberg (Krfr.St);79 bis unter 80;502;182;320
09361;      Amberg (Krfr.St);80 bis unter 81;397;153;244
09361;      Amberg (Krfr.St);81 bis unter 82;367;153;214
09361;      Amberg (Krfr.St);82 bis unter 83;363;146;217
09361;      Amberg (Krfr.St);83 bis unter 84;342;116;226
09361;      Amberg (Krfr.St);84 bis unter 85;281;117;164
09361;      Amberg (Krfr.St);85 bis unter 90;885;292;593
09361;      Amberg (Krfr.St);90 bis unter 95;401;90;311
09361;      Amberg (Krfr.St);95 oder älter;109;22;87
09361;      Amberg (Krfr.St);Insgesamt;41970;20673;21297
09362;      Regensburg (Krfr.St);unter 1;1546;808;738
09362;      Regensburg (Krfr.St);1 bis unter 2;1460;781;679
09362;      Regensburg (Krfr.St);2 bis unter 3;1366;691;675
09362;      Regensburg (Krfr.St);3 bis unter 4;1343;680;663
09362;      Regensburg (Krfr.St);4 bis unter 5;1334;679;655
09362;      Regensburg (Krfr.St);5 bis unter 6;1208;593;615
09362;      Regensburg (Krfr.St);6 bis unter 7;1197;615;582
09362;      Regensburg (Krfr.St);7 bis unter 8;1138;576;562
09362;      Regensburg (Krfr.St);8 bis unter 9;1226;639;587
09362;      Regensburg (Krfr.St);9 bis unter 10;1182;564;618
09362;      Regensburg (Krfr.St);10 bis unter 11;1117;586;531
09362;      Regensburg (Krfr.St);11 bis unter 12;1127;565;562
09362;      Regensburg (Krfr.St);12 bis unter 13;1193;605;588
09362;      Regensburg (Krfr.St);13 bis unter 14;1116;610;506
09362;      Regensburg (Krfr.St);14 bis unter 15;1107;575;532
09362;      Regensburg (Krfr.St);15 bis unter 16;1020;516;504
09362;      Regensburg (Krfr.St);16 bis unter 17;1073;539;534
09362;      Regensburg (Krfr.St);17 bis unter 18;1179;632;547
09362;      Regensburg (Krfr.St);18 bis unter 19;1331;655;676
09362;      Regensburg (Krfr.St);19 bis unter 20;1693;868;825
09362;      Regensburg (Krfr.St);20 bis unter 21;2109;1019;1090
09362;      Regensburg (Krfr.St);21 bis unter 22;2351;1095;1256
09362;      Regensburg (Krfr.St);22 bis unter 23;2652;1190;1462
09362;      Regensburg (Krfr.St);23 bis unter 24;2664;1230;1434
09362;      Regensburg (Krfr.St);24 bis unter 25;2757;1308;1449
09362;      Regensburg (Krfr.St);25 bis unter 26;3033;1444;1589
09362;      Regensburg (Krfr.St);26 bis unter 27;3227;1644;1583
09362;      Regensburg (Krfr.St);27 bis unter 28;3398;1657;1741
09362;      Regensburg (Krfr.St);28 bis unter 29;3636;1919;1717
09362;      Regensburg (Krfr.St);29 bis unter 30;3486;1805;1681
09362;      Regensburg (Krfr.St);30 bis unter 31;3391;1699;1692
09362;      Regensburg (Krfr.St);31 bis unter 32;3030;1558;1472
09362;      Regensburg (Krfr.St);32 bis unter 33;2821;1550;1271
09362;      Regensburg (Krfr.St);33 bis unter 34;2531;1298;1233
09362;      Regensburg (Krfr.St);34 bis unter 35;2589;1370;1219
09362;      Regensburg (Krfr.St);35 bis unter 36;2492;1360;1132
09362;      Regensburg (Krfr.St);36 bis unter 37;2374;1249;1125
09362;      Regensburg (Krfr.St);37 bis unter 38;2324;1203;1121
09362;      Regensburg (Krfr.St);38 bis unter 39;2084;1067;1017
09362;      Regensburg (Krfr.St);39 bis unter 40;1969;992;977
09362;      Regensburg (Krfr.St);40 bis unter 41;1935;944;991
09362;      Regensburg (Krfr.St);41 bis unter 42;1902;951;951
09362;      Regensburg (Krfr.St);42 bis unter 43;1791;899;892
09362;      Regensburg (Krfr.St);43 bis unter 44;1756;911;845
09362;      Regensburg (Krfr.St);44 bis unter 45;1761;861;900
09362;      Regensburg (Krfr.St);45 bis unter 46;1687;814;873
09362;      Regensburg (Krfr.St);46 bis unter 47;1848;954;894
09362;      Regensburg (Krfr.St);47 bis unter 48;1964;999;965
09362;      Regensburg (Krfr.St);48 bis unter 49;2033;984;1049
09362;      Regensburg (Krfr.St);49 bis unter 50;2068;1053;1015
09362;      Regensburg (Krfr.St);50 bis unter 51;2048;1049;999
09362;      Regensburg (Krfr.St);51 bis unter 52;2113;1072;1041
09362;      Regensburg (Krfr.St);52 bis unter 53;2175;1056;1119
09362;      Regensburg (Krfr.St);53 bis unter 54;2041;1038;1003
09362;      Regensburg (Krfr.St);54 bis unter 55;2093;1049;1044
09362;      Regensburg (Krfr.St);55 bis unter 56;2063;1010;1053
09362;      Regensburg (Krfr.St);56 bis unter 57;2036;973;1063
09362;      Regensburg (Krfr.St);57 bis unter 58;1861;893;968
09362;      Regensburg (Krfr.St);58 bis unter 59;1851;879;972
09362;      Regensburg (Krfr.St);59 bis unter 60;1768;871;897
09362;      Regensburg (Krfr.St);60 bis unter 61;1720;862;858
09362;      Regensburg (Krfr.St);61 bis unter 62;1658;787;871
09362;      Regensburg (Krfr.St);62 bis unter 63;1537;731;806
09362;      Regensburg (Krfr.St);63 bis unter 64;1497;699;798
09362;      Regensburg (Krfr.St);64 bis unter 65;1408;615;793
09362;      Regensburg (Krfr.St);65 bis unter 66;1420;635;785
09362;      Regensburg (Krfr.St);66 bis unter 67;1324;612;712
09362;      Regensburg (Krfr.St);67 bis unter 68;1305;608;697
09362;      Regensburg (Krfr.St);68 bis unter 69;1338;640;698
09362;      Regensburg (Krfr.St);69 bis unter 70;1205;558;647
09362;      Regensburg (Krfr.St);70 bis unter 71;1266;560;706
09362;      Regensburg (Krfr.St);71 bis unter 72;1155;512;643
09362;      Regensburg (Krfr.St);72 bis unter 73;1108;479;629
09362;      Regensburg (Krfr.St);73 bis unter 74;853;357;496
09362;      Regensburg (Krfr.St);74 bis unter 75;1154;513;641
09362;      Regensburg (Krfr.St);75 bis unter 76;1069;480;589
09362;      Regensburg (Krfr.St);76 bis unter 77;1079;474;605
09362;      Regensburg (Krfr.St);77 bis unter 78;1263;526;737
09362;      Regensburg (Krfr.St);78 bis unter 79;1318;554;764
09362;      Regensburg (Krfr.St);79 bis unter 80;1234;497;737
09362;      Regensburg (Krfr.St);80 bis unter 81;1108;421;687
09362;      Regensburg (Krfr.St);81 bis unter 82;957;383;574
09362;      Regensburg (Krfr.St);82 bis unter 83;855;340;515
09362;      Regensburg (Krfr.St);83 bis unter 84;770;301;469
09362;      Regensburg (Krfr.St);84 bis unter 85;693;245;448
09362;      Regensburg (Krfr.St);85 bis unter 90;2201;765;1436
09362;      Regensburg (Krfr.St);90 bis unter 95;1139;323;816
09362;      Regensburg (Krfr.St);95 oder älter;308;54;254
09362;      Regensburg (Krfr.St);Insgesamt;152610;74225;78385
09363;      Weiden i.d.OPf. (Krfr.St);unter 1;393;197;196
09363;      Weiden i.d.OPf. (Krfr.St);1 bis unter 2;384;203;181
09363;      Weiden i.d.OPf. (Krfr.St);2 bis unter 3;360;183;177
09363;      Weiden i.d.OPf. (Krfr.St);3 bis unter 4;338;163;175
09363;      Weiden i.d.OPf. (Krfr.St);4 bis unter 5;331;157;174
09363;      Weiden i.d.OPf. (Krfr.St);5 bis unter 6;338;172;166
09363;      Weiden i.d.OPf. (Krfr.St);6 bis unter 7;338;194;144
09363;      Weiden i.d.OPf. (Krfr.St);7 bis unter 8;285;130;155
09363;      Weiden i.d.OPf. (Krfr.St);8 bis unter 9;352;181;171
09363;      Weiden i.d.OPf. (Krfr.St);9 bis unter 10;314;166;148
09363;      Weiden i.d.OPf. (Krfr.St);10 bis unter 11;341;166;175
09363;      Weiden i.d.OPf. (Krfr.St);11 bis unter 12;329;167;162
09363;      Weiden i.d.OPf. (Krfr.St);12 bis unter 13;339;171;168
09363;      Weiden i.d.OPf. (Krfr.St);13 bis unter 14;352;179;173
09363;      Weiden i.d.OPf. (Krfr.St);14 bis unter 15;344;170;174
09363;      Weiden i.d.OPf. (Krfr.St);15 bis unter 16;391;194;197
09363;      Weiden i.d.OPf. (Krfr.St);16 bis unter 17;367;181;186
09363;      Weiden i.d.OPf. (Krfr.St);17 bis unter 18;411;212;199
09363;      Weiden i.d.OPf. (Krfr.St);18 bis unter 19;445;235;210
09363;      Weiden i.d.OPf. (Krfr.St);19 bis unter 20;464;267;197
09363;      Weiden i.d.OPf. (Krfr.St);20 bis unter 21;535;288;247
09363;      Weiden i.d.OPf. (Krfr.St);21 bis unter 22;517;270;247
09363;      Weiden i.d.OPf. (Krfr.St);22 bis unter 23;545;286;259
09363;      Weiden i.d.OPf. (Krfr.St);23 bis unter 24;522;265;257
09363;      Weiden i.d.OPf. (Krfr.St);24 bis unter 25;525;285;240
09363;      Weiden i.d.OPf. (Krfr.St);25 bis unter 26;560;301;259
09363;      Weiden i.d.OPf. (Krfr.St);26 bis unter 27;577;289;288
09363;      Weiden i.d.OPf. (Krfr.St);27 bis unter 28;587;315;272
09363;      Weiden i.d.OPf. (Krfr.St);28 bis unter 29;585;317;268
09363;      Weiden i.d.OPf. (Krfr.St);29 bis unter 30;595;307;288
09363;      Weiden i.d.OPf. (Krfr.St);30 bis unter 31;545;287;258
09363;      Weiden i.d.OPf. (Krfr.St);31 bis unter 32;556;290;266
09363;      Weiden i.d.OPf. (Krfr.St);32 bis unter 33;550;319;231
09363;      Weiden i.d.OPf. (Krfr.St);33 bis unter 34;474;248;226
09363;      Weiden i.d.OPf. (Krfr.St);34 bis unter 35;489;225;264
09363;      Weiden i.d.OPf. (Krfr.St);35 bis unter 36;488;264;224
09363;      Weiden i.d.OPf. (Krfr.St);36 bis unter 37;511;247;264
09363;      Weiden i.d.OPf. (Krfr.St);37 bis unter 38;519;248;271
09363;      Weiden i.d.OPf. (Krfr.St);38 bis unter 39;516;263;253
09363;      Weiden i.d.OPf. (Krfr.St);39 bis unter 40;469;236;233
09363;      Weiden i.d.OPf. (Krfr.St);40 bis unter 41;469;232;237
09363;      Weiden i.d.OPf. (Krfr.St);41 bis unter 42;468;228;240
09363;      Weiden i.d.OPf. (Krfr.St);42 bis unter 43;442;233;209
09363;      Weiden i.d.OPf. (Krfr.St);43 bis unter 44;459;215;244
09363;      Weiden i.d.OPf. (Krfr.St);44 bis unter 45;489;228;261
09363;      Weiden i.d.OPf. (Krfr.St);45 bis unter 46;478;222;256
09363;      Weiden i.d.OPf. (Krfr.St);46 bis unter 47;517;235;282
09363;      Weiden i.d.OPf. (Krfr.St);47 bis unter 48;554;276;278
09363;      Weiden i.d.OPf. (Krfr.St);48 bis unter 49;594;292;302
09363;      Weiden i.d.OPf. (Krfr.St);49 bis unter 50;630;308;322
09363;      Weiden i.d.OPf. (Krfr.St);50 bis unter 51;670;356;314
09363;      Weiden i.d.OPf. (Krfr.St);51 bis unter 52;716;356;360
09363;      Weiden i.d.OPf. (Krfr.St);52 bis unter 53;699;363;336
09363;      Weiden i.d.OPf. (Krfr.St);53 bis unter 54;691;339;352
09363;      Weiden i.d.OPf. (Krfr.St);54 bis unter 55;735;363;372
09363;      Weiden i.d.OPf. (Krfr.St);55 bis unter 56;710;334;376
09363;      Weiden i.d.OPf. (Krfr.St);56 bis unter 57;668;323;345
09363;      Weiden i.d.OPf. (Krfr.St);57 bis unter 58;690;338;352
09363;      Weiden i.d.OPf. (Krfr.St);58 bis unter 59;640;316;324
09363;      Weiden i.d.OPf. (Krfr.St);59 bis unter 60;648;311;337
09363;      Weiden i.d.OPf. (Krfr.St);60 bis unter 61;595;323;272
09363;      Weiden i.d.OPf. (Krfr.St);61 bis unter 62;617;284;333
09363;      Weiden i.d.OPf. (Krfr.St);62 bis unter 63;562;280;282
09363;      Weiden i.d.OPf. (Krfr.St);63 bis unter 64;491;216;275
09363;      Weiden i.d.OPf. (Krfr.St);64 bis unter 65;543;243;300
09363;      Weiden i.d.OPf. (Krfr.St);65 bis unter 66;507;247;260
09363;      Weiden i.d.OPf. (Krfr.St);66 bis unter 67;519;229;290
09363;      Weiden i.d.OPf. (Krfr.St);67 bis unter 68;525;252;273
09363;      Weiden i.d.OPf. (Krfr.St);68 bis unter 69;491;208;283
09363;      Weiden i.d.OPf. (Krfr.St);69 bis unter 70;499;224;275
09363;      Weiden i.d.OPf. (Krfr.St);70 bis unter 71;423;191;232
09363;      Weiden i.d.OPf. (Krfr.St);71 bis unter 72;456;219;237
09363;      Weiden i.d.OPf. (Krfr.St);72 bis unter 73;447;184;263
09363;      Weiden i.d.OPf. (Krfr.St);73 bis unter 74;312;132;180
09363;      Weiden i.d.OPf. (Krfr.St);74 bis unter 75;426;197;229
09363;      Weiden i.d.OPf. (Krfr.St);75 bis unter 76;377;150;227
09363;      Weiden i.d.OPf. (Krfr.St);76 bis unter 77;371;187;184
09363;      Weiden i.d.OPf. (Krfr.St);77 bis unter 78;449;187;262
09363;      Weiden i.d.OPf. (Krfr.St);78 bis unter 79;495;194;301
09363;      Weiden i.d.OPf. (Krfr.St);79 bis unter 80;490;218;272
09363;      Weiden i.d.OPf. (Krfr.St);80 bis unter 81;413;171;242
09363;      Weiden i.d.OPf. (Krfr.St);81 bis unter 82;405;165;240
09363;      Weiden i.d.OPf. (Krfr.St);82 bis unter 83;335;133;202
09363;      Weiden i.d.OPf. (Krfr.St);83 bis unter 84;297;95;202
09363;      Weiden i.d.OPf. (Krfr.St);84 bis unter 85;261;111;150
09363;      Weiden i.d.OPf. (Krfr.St);85 bis unter 90;905;277;628
09363;      Weiden i.d.OPf. (Krfr.St);90 bis unter 95;375;111;264
09363;      Weiden i.d.OPf. (Krfr.St);95 oder älter;86;8;78
09363;      Weiden i.d.OPf. (Krfr.St);Insgesamt;42520;20542;21978
KS093;    Kreisfreie Städte Oberpfalz;unter 1;2324;1196;1128
KS093;    Kreisfreie Städte Oberpfalz;1 bis unter 2;2223;1176;1047
KS093;    Kreisfreie Städte Oberpfalz;2 bis unter 3;2070;1045;1025
KS093;    Kreisfreie Städte Oberpfalz;3 bis unter 4;2013;1005;1008
KS093;    Kreisfreie Städte Oberpfalz;4 bis unter 5;1995;998;997
KS093;    Kreisfreie Städte Oberpfalz;5 bis unter 6;1853;909;944
KS093;    Kreisfreie Städte Oberpfalz;6 bis unter 7;1866;961;905
KS093;    Kreisfreie Städte Oberpfalz;7 bis unter 8;1765;897;868
KS093;    Kreisfreie Städte Oberpfalz;8 bis unter 9;1903;998;905
KS093;    Kreisfreie Städte Oberpfalz;9 bis unter 10;1834;914;920
KS093;    Kreisfreie Städte Oberpfalz;10 bis unter 11;1811;947;864
KS093;    Kreisfreie Städte Oberpfalz;11 bis unter 12;1795;922;873
KS093;    Kreisfreie Städte Oberpfalz;12 bis unter 13;1873;954;919
KS093;    Kreisfreie Städte Oberpfalz;13 bis unter 14;1844;989;855
KS093;    Kreisfreie Städte Oberpfalz;14 bis unter 15;1783;912;871
KS093;    Kreisfreie Städte Oberpfalz;15 bis unter 16;1766;886;880
KS093;    Kreisfreie Städte Oberpfalz;16 bis unter 17;1815;909;906
KS093;    Kreisfreie Städte Oberpfalz;17 bis unter 18;1999;1046;953
KS093;    Kreisfreie Städte Oberpfalz;18 bis unter 19;2197;1109;1088
KS093;    Kreisfreie Städte Oberpfalz;19 bis unter 20;2584;1372;1212
KS093;    Kreisfreie Städte Oberpfalz;20 bis unter 21;3108;1553;1555
KS093;    Kreisfreie Städte Oberpfalz;21 bis unter 22;3313;1615;1698
KS093;    Kreisfreie Städte Oberpfalz;22 bis unter 23;3676;1747;1929
KS093;    Kreisfreie Städte Oberpfalz;23 bis unter 24;3651;1737;1914
KS093;    Kreisfreie Städte Oberpfalz;24 bis unter 25;3788;1856;1932
KS093;    Kreisfreie Städte Oberpfalz;25 bis unter 26;4116;2037;2079
KS093;    Kreisfreie Städte Oberpfalz;26 bis unter 27;4311;2218;2093
KS093;    Kreisfreie Städte Oberpfalz;27 bis unter 28;4542;2278;2264
KS093;    Kreisfreie Städte Oberpfalz;28 bis unter 29;4861;2587;2274
KS093;    Kreisfreie Städte Oberpfalz;29 bis unter 30;4658;2438;2220
KS093;    Kreisfreie Städte Oberpfalz;30 bis unter 31;4511;2301;2210
KS093;    Kreisfreie Städte Oberpfalz;31 bis unter 32;4133;2139;1994
KS093;    Kreisfreie Städte Oberpfalz;32 bis unter 33;3940;2200;1740
KS093;    Kreisfreie Städte Oberpfalz;33 bis unter 34;3527;1833;1694
KS093;    Kreisfreie Städte Oberpfalz;34 bis unter 35;3575;1860;1715
KS093;    Kreisfreie Städte Oberpfalz;35 bis unter 36;3480;1890;1590
KS093;    Kreisfreie Städte Oberpfalz;36 bis unter 37;3447;1815;1632
KS093;    Kreisfreie Städte Oberpfalz;37 bis unter 38;3293;1706;1587
KS093;    Kreisfreie Städte Oberpfalz;38 bis unter 39;3101;1594;1507
KS093;    Kreisfreie Städte Oberpfalz;39 bis unter 40;2904;1467;1437
KS093;    Kreisfreie Städte Oberpfalz;40 bis unter 41;2869;1418;1451
KS093;    Kreisfreie Städte Oberpfalz;41 bis unter 42;2868;1445;1423
KS093;    Kreisfreie Städte Oberpfalz;42 bis unter 43;2684;1362;1322
KS093;    Kreisfreie Städte Oberpfalz;43 bis unter 44;2660;1361;1299
KS093;    Kreisfreie Städte Oberpfalz;44 bis unter 45;2715;1329;1386
KS093;    Kreisfreie Städte Oberpfalz;45 bis unter 46;2584;1226;1358
KS093;    Kreisfreie Städte Oberpfalz;46 bis unter 47;2829;1412;1417
KS093;    Kreisfreie Städte Oberpfalz;47 bis unter 48;3071;1542;1529
KS093;    Kreisfreie Städte Oberpfalz;48 bis unter 49;3235;1592;1643
KS093;    Kreisfreie Städte Oberpfalz;49 bis unter 50;3321;1698;1623
KS093;    Kreisfreie Städte Oberpfalz;50 bis unter 51;3327;1712;1615
KS093;    Kreisfreie Städte Oberpfalz;51 bis unter 52;3471;1716;1755
KS093;    Kreisfreie Städte Oberpfalz;52 bis unter 53;3560;1752;1808
KS093;    Kreisfreie Städte Oberpfalz;53 bis unter 54;3443;1727;1716
KS093;    Kreisfreie Städte Oberpfalz;54 bis unter 55;3535;1768;1767
KS093;    Kreisfreie Städte Oberpfalz;55 bis unter 56;3500;1705;1795
KS093;    Kreisfreie Städte Oberpfalz;56 bis unter 57;3399;1652;1747
KS093;    Kreisfreie Städte Oberpfalz;57 bis unter 58;3165;1524;1641
KS093;    Kreisfreie Städte Oberpfalz;58 bis unter 59;3182;1537;1645
KS093;    Kreisfreie Städte Oberpfalz;59 bis unter 60;3054;1501;1553
KS093;    Kreisfreie Städte Oberpfalz;60 bis unter 61;2926;1479;1447
KS093;    Kreisfreie Städte Oberpfalz;61 bis unter 62;2882;1368;1514
KS093;    Kreisfreie Städte Oberpfalz;62 bis unter 63;2693;1307;1386
KS093;    Kreisfreie Städte Oberpfalz;63 bis unter 64;2536;1168;1368
KS093;    Kreisfreie Städte Oberpfalz;64 bis unter 65;2520;1126;1394
KS093;    Kreisfreie Städte Oberpfalz;65 bis unter 66;2456;1128;1328
KS093;    Kreisfreie Städte Oberpfalz;66 bis unter 67;2382;1088;1294
KS093;    Kreisfreie Städte Oberpfalz;67 bis unter 68;2421;1129;1292
KS093;    Kreisfreie Städte Oberpfalz;68 bis unter 69;2317;1077;1240
KS093;    Kreisfreie Städte Oberpfalz;69 bis unter 70;2185;1008;1177
KS093;    Kreisfreie Städte Oberpfalz;70 bis unter 71;2166;977;1189
KS093;    Kreisfreie Städte Oberpfalz;71 bis unter 72;2038;920;1118
KS093;    Kreisfreie Städte Oberpfalz;72 bis unter 73;1943;843;1100
KS093;    Kreisfreie Städte Oberpfalz;73 bis unter 74;1463;640;823
KS093;    Kreisfreie Städte Oberpfalz;74 bis unter 75;1927;868;1059
KS093;    Kreisfreie Städte Oberpfalz;75 bis unter 76;1813;785;1028
KS093;    Kreisfreie Städte Oberpfalz;76 bis unter 77;1781;792;989
KS093;    Kreisfreie Städte Oberpfalz;77 bis unter 78;2182;930;1252
KS093;    Kreisfreie Städte Oberpfalz;78 bis unter 79;2270;923;1347
KS093;    Kreisfreie Städte Oberpfalz;79 bis unter 80;2226;897;1329
KS093;    Kreisfreie Städte Oberpfalz;80 bis unter 81;1918;745;1173
KS093;    Kreisfreie Städte Oberpfalz;81 bis unter 82;1729;701;1028
KS093;    Kreisfreie Städte Oberpfalz;82 bis unter 83;1553;619;934
KS093;    Kreisfreie Städte Oberpfalz;83 bis unter 84;1409;512;897
KS093;    Kreisfreie Städte Oberpfalz;84 bis unter 85;1235;473;762
KS093;    Kreisfreie Städte Oberpfalz;85 bis unter 90;3991;1334;2657
KS093;    Kreisfreie Städte Oberpfalz;90 bis unter 95;1915;524;1391
KS093;    Kreisfreie Städte Oberpfalz;95 oder älter;503;84;419
KS093;    Kreisfreie Städte Oberpfalz;Insgesamt;237100;115440;121660
09371;      Amberg-Sulzbach (Lkr);unter 1;1060;558;502
09371;      Amberg-Sulzbach (Lkr);1 bis unter 2;881;422;459
09371;      Amberg-Sulzbach (Lkr);2 bis unter 3;836;437;399
09371;      Amberg-Sulzbach (Lkr);3 bis unter 4;898;438;460
09371;      Amberg-Sulzbach (Lkr);4 bis unter 5;810;423;387
09371;      Amberg-Sulzbach (Lkr);5 bis unter 6;837;419;418
09371;      Amberg-Sulzbach (Lkr);6 bis unter 7;852;437;415
09371;      Amberg-Sulzbach (Lkr);7 bis unter 8;822;388;434
09371;      Amberg-Sulzbach (Lkr);8 bis unter 9;854;449;405
09371;      Amberg-Sulzbach (Lkr);9 bis unter 10;870;430;440
09371;      Amberg-Sulzbach (Lkr);10 bis unter 11;925;482;443
09371;      Amberg-Sulzbach (Lkr);11 bis unter 12;857;463;394
09371;      Amberg-Sulzbach (Lkr);12 bis unter 13;866;465;401
09371;      Amberg-Sulzbach (Lkr);13 bis unter 14;927;487;440
09371;      Amberg-Sulzbach (Lkr);14 bis unter 15;960;503;457
09371;      Amberg-Sulzbach (Lkr);15 bis unter 16;955;468;487
09371;      Amberg-Sulzbach (Lkr);16 bis unter 17;1032;557;475
09371;      Amberg-Sulzbach (Lkr);17 bis unter 18;1119;566;553
09371;      Amberg-Sulzbach (Lkr);18 bis unter 19;1106;562;544
09371;      Amberg-Sulzbach (Lkr);19 bis unter 20;1172;634;538
09371;      Amberg-Sulzbach (Lkr);20 bis unter 21;1132;600;532
09371;      Amberg-Sulzbach (Lkr);21 bis unter 22;1184;665;519
09371;      Amberg-Sulzbach (Lkr);22 bis unter 23;1170;624;546
09371;      Amberg-Sulzbach (Lkr);23 bis unter 24;1171;608;563
09371;      Amberg-Sulzbach (Lkr);24 bis unter 25;1116;608;508
09371;      Amberg-Sulzbach (Lkr);25 bis unter 26;1129;604;525
09371;      Amberg-Sulzbach (Lkr);26 bis unter 27;1152;626;526
09371;      Amberg-Sulzbach (Lkr);27 bis unter 28;1156;617;539
09371;      Amberg-Sulzbach (Lkr);28 bis unter 29;1218;651;567
09371;      Amberg-Sulzbach (Lkr);29 bis unter 30;1203;622;581
09371;      Amberg-Sulzbach (Lkr);30 bis unter 31;1232;650;582
09371;      Amberg-Sulzbach (Lkr);31 bis unter 32;1165;623;542
09371;      Amberg-Sulzbach (Lkr);32 bis unter 33;1259;651;608
09371;      Amberg-Sulzbach (Lkr);33 bis unter 34;1144;604;540
09371;      Amberg-Sulzbach (Lkr);34 bis unter 35;1126;593;533
09371;      Amberg-Sulzbach (Lkr);35 bis unter 36;1146;584;562
09371;      Amberg-Sulzbach (Lkr);36 bis unter 37;1182;588;594
09371;      Amberg-Sulzbach (Lkr);37 bis unter 38;1140;557;583
09371;      Amberg-Sulzbach (Lkr);38 bis unter 39;1222;634;588
09371;      Amberg-Sulzbach (Lkr);39 bis unter 40;1188;624;564
09371;      Amberg-Sulzbach (Lkr);40 bis unter 41;1137;567;570
09371;      Amberg-Sulzbach (Lkr);41 bis unter 42;1175;609;566
09371;      Amberg-Sulzbach (Lkr);42 bis unter 43;1146;552;594
09371;      Amberg-Sulzbach (Lkr);43 bis unter 44;1131;583;548
09371;      Amberg-Sulzbach (Lkr);44 bis unter 45;1146;588;558
09371;      Amberg-Sulzbach (Lkr);45 bis unter 46;1239;615;624
09371;      Amberg-Sulzbach (Lkr);46 bis unter 47;1339;657;682
09371;      Amberg-Sulzbach (Lkr);47 bis unter 48;1518;772;746
09371;      Amberg-Sulzbach (Lkr);48 bis unter 49;1531;797;734
09371;      Amberg-Sulzbach (Lkr);49 bis unter 50;1623;789;834
09371;      Amberg-Sulzbach (Lkr);50 bis unter 51;1716;872;844
09371;      Amberg-Sulzbach (Lkr);51 bis unter 52;1820;945;875
09371;      Amberg-Sulzbach (Lkr);52 bis unter 53;1874;967;907
09371;      Amberg-Sulzbach (Lkr);53 bis unter 54;1898;968;930
09371;      Amberg-Sulzbach (Lkr);54 bis unter 55;1962;1001;961
09371;      Amberg-Sulzbach (Lkr);55 bis unter 56;1913;944;969
09371;      Amberg-Sulzbach (Lkr);56 bis unter 57;1920;962;958
09371;      Amberg-Sulzbach (Lkr);57 bis unter 58;1898;996;902
09371;      Amberg-Sulzbach (Lkr);58 bis unter 59;1842;963;879
09371;      Amberg-Sulzbach (Lkr);59 bis unter 60;1757;899;858
09371;      Amberg-Sulzbach (Lkr);60 bis unter 61;1736;889;847
09371;      Amberg-Sulzbach (Lkr);61 bis unter 62;1666;843;823
09371;      Amberg-Sulzbach (Lkr);62 bis unter 63;1521;786;735
09371;      Amberg-Sulzbach (Lkr);63 bis unter 64;1422;681;741
09371;      Amberg-Sulzbach (Lkr);64 bis unter 65;1425;748;677
09371;      Amberg-Sulzbach (Lkr);65 bis unter 66;1327;654;673
09371;      Amberg-Sulzbach (Lkr);66 bis unter 67;1310;684;626
09371;      Amberg-Sulzbach (Lkr);67 bis unter 68;1272;619;653
09371;      Amberg-Sulzbach (Lkr);68 bis unter 69;1205;614;591
09371;      Amberg-Sulzbach (Lkr);69 bis unter 70;1091;522;569
09371;      Amberg-Sulzbach (Lkr);70 bis unter 71;1012;511;501
09371;      Amberg-Sulzbach (Lkr);71 bis unter 72;884;443;441
09371;      Amberg-Sulzbach (Lkr);72 bis unter 73;816;398;418
09371;      Amberg-Sulzbach (Lkr);73 bis unter 74;624;312;312
09371;      Amberg-Sulzbach (Lkr);74 bis unter 75;770;337;433
09371;      Amberg-Sulzbach (Lkr);75 bis unter 76;782;365;417
09371;      Amberg-Sulzbach (Lkr);76 bis unter 77;770;358;412
09371;      Amberg-Sulzbach (Lkr);77 bis unter 78;928;428;500
09371;      Amberg-Sulzbach (Lkr);78 bis unter 79;1075;480;595
09371;      Amberg-Sulzbach (Lkr);79 bis unter 80;1087;464;623
09371;      Amberg-Sulzbach (Lkr);80 bis unter 81;981;409;572
09371;      Amberg-Sulzbach (Lkr);81 bis unter 82;824;347;477
09371;      Amberg-Sulzbach (Lkr);82 bis unter 83;776;322;454
09371;      Amberg-Sulzbach (Lkr);83 bis unter 84;658;277;381
09371;      Amberg-Sulzbach (Lkr);84 bis unter 85;591;253;338
09371;      Amberg-Sulzbach (Lkr);85 bis unter 90;1984;717;1267
09371;      Amberg-Sulzbach (Lkr);90 bis unter 95;750;204;546
09371;      Amberg-Sulzbach (Lkr);95 oder älter;163;33;130
09371;      Amberg-Sulzbach (Lkr);Insgesamt;103109;51665;51444
09372;      Cham (Lkr);unter 1;1112;550;562
09372;      Cham (Lkr);1 bis unter 2;1155;591;564
09372;      Cham (Lkr);2 bis unter 3;1171;613;558
09372;      Cham (Lkr);3 bis unter 4;1109;597;512
09372;      Cham (Lkr);4 bis unter 5;1172;620;552
09372;      Cham (Lkr);5 bis unter 6;1084;574;510
09372;      Cham (Lkr);6 bis unter 7;1066;511;555
09372;      Cham (Lkr);7 bis unter 8;1033;505;528
09372;      Cham (Lkr);8 bis unter 9;1097;556;541
09372;      Cham (Lkr);9 bis unter 10;1038;531;507
09372;      Cham (Lkr);10 bis unter 11;1128;589;539
09372;      Cham (Lkr);11 bis unter 12;1074;562;512
09372;      Cham (Lkr);12 bis unter 13;1072;533;539
09372;      Cham (Lkr);13 bis unter 14;1166;591;575
09372;      Cham (Lkr);14 bis unter 15;1184;636;548
09372;      Cham (Lkr);15 bis unter 16;1174;603;571
09372;      Cham (Lkr);16 bis unter 17;1119;533;586
09372;      Cham (Lkr);17 bis unter 18;1306;639;667
09372;      Cham (Lkr);18 bis unter 19;1330;695;635
09372;      Cham (Lkr);19 bis unter 20;1384;763;621
09372;      Cham (Lkr);20 bis unter 21;1361;763;598
09372;      Cham (Lkr);21 bis unter 22;1527;813;714
09372;      Cham (Lkr);22 bis unter 23;1464;728;736
09372;      Cham (Lkr);23 bis unter 24;1440;772;668
09372;      Cham (Lkr);24 bis unter 25;1486;807;679
09372;      Cham (Lkr);25 bis unter 26;1487;809;678
09372;      Cham (Lkr);26 bis unter 27;1486;780;706
09372;      Cham (Lkr);27 bis unter 28;1515;810;705
09372;      Cham (Lkr);28 bis unter 29;1585;877;708
09372;      Cham (Lkr);29 bis unter 30;1491;759;732
09372;      Cham (Lkr);30 bis unter 31;1658;889;769
09372;      Cham (Lkr);31 bis unter 32;1471;763;708
09372;      Cham (Lkr);32 bis unter 33;1532;782;750
09372;      Cham (Lkr);33 bis unter 34;1525;796;729
09372;      Cham (Lkr);34 bis unter 35;1479;763;716
09372;      Cham (Lkr);35 bis unter 36;1449;735;714
09372;      Cham (Lkr);36 bis unter 37;1577;811;766
09372;      Cham (Lkr);37 bis unter 38;1609;850;759
09372;      Cham (Lkr);38 bis unter 39;1536;805;731
09372;      Cham (Lkr);39 bis unter 40;1472;745;727
09372;      Cham (Lkr);40 bis unter 41;1501;792;709
09372;      Cham (Lkr);41 bis unter 42;1449;741;708
09372;      Cham (Lkr);42 bis unter 43;1489;727;762
09372;      Cham (Lkr);43 bis unter 44;1455;729;726
09372;      Cham (Lkr);44 bis unter 45;1553;808;745
09372;      Cham (Lkr);45 bis unter 46;1562;819;743
09372;      Cham (Lkr);46 bis unter 47;1738;864;874
09372;      Cham (Lkr);47 bis unter 48;1936;982;954
09372;      Cham (Lkr);48 bis unter 49;1818;911;907
09372;      Cham (Lkr);49 bis unter 50;2040;1029;1011
09372;      Cham (Lkr);50 bis unter 51;2105;1107;998
09372;      Cham (Lkr);51 bis unter 52;2061;1078;983
09372;      Cham (Lkr);52 bis unter 53;2236;1151;1085
09372;      Cham (Lkr);53 bis unter 54;2093;1075;1018
09372;      Cham (Lkr);54 bis unter 55;2349;1191;1158
09372;      Cham (Lkr);55 bis unter 56;2254;1122;1132
09372;      Cham (Lkr);56 bis unter 57;2191;1115;1076
09372;      Cham (Lkr);57 bis unter 58;2251;1138;1113
09372;      Cham (Lkr);58 bis unter 59;2156;1138;1018
09372;      Cham (Lkr);59 bis unter 60;2138;1065;1073
09372;      Cham (Lkr);60 bis unter 61;1963;960;1003
09372;      Cham (Lkr);61 bis unter 62;1939;1011;928
09372;      Cham (Lkr);62 bis unter 63;1854;955;899
09372;      Cham (Lkr);63 bis unter 64;1740;905;835
09372;      Cham (Lkr);64 bis unter 65;1763;890;873
09372;      Cham (Lkr);65 bis unter 66;1726;883;843
09372;      Cham (Lkr);66 bis unter 67;1699;841;858
09372;      Cham (Lkr);67 bis unter 68;1554;799;755
09372;      Cham (Lkr);68 bis unter 69;1653;861;792
09372;      Cham (Lkr);69 bis unter 70;1455;712;743
09372;      Cham (Lkr);70 bis unter 71;1359;694;665
09372;      Cham (Lkr);71 bis unter 72;1262;616;646
09372;      Cham (Lkr);72 bis unter 73;1132;548;584
09372;      Cham (Lkr);73 bis unter 74;784;386;398
09372;      Cham (Lkr);74 bis unter 75;957;466;491
09372;      Cham (Lkr);75 bis unter 76;939;455;484
09372;      Cham (Lkr);76 bis unter 77;943;437;506
09372;      Cham (Lkr);77 bis unter 78;1187;531;656
09372;      Cham (Lkr);78 bis unter 79;1296;590;706
09372;      Cham (Lkr);79 bis unter 80;1267;573;694
09372;      Cham (Lkr);80 bis unter 81;1181;526;655
09372;      Cham (Lkr);81 bis unter 82;982;433;549
09372;      Cham (Lkr);82 bis unter 83;858;364;494
09372;      Cham (Lkr);83 bis unter 84;768;302;466
09372;      Cham (Lkr);84 bis unter 85;730;262;468
09372;      Cham (Lkr);85 bis unter 90;2295;736;1559
09372;      Cham (Lkr);90 bis unter 95;890;235;655
09372;      Cham (Lkr);95 oder älter;207;46;161
09372;      Cham (Lkr);Insgesamt;127882;64248;63634
09373;      Neumarkt i.d.OPf. (Lkr);unter 1;1321;658;663
09373;      Neumarkt i.d.OPf. (Lkr);1 bis unter 2;1275;682;593
09373;      Neumarkt i.d.OPf. (Lkr);2 bis unter 3;1258;631;627
09373;      Neumarkt i.d.OPf. (Lkr);3 bis unter 4;1311;713;598
09373;      Neumarkt i.d.OPf. (Lkr);4 bis unter 5;1281;643;638
09373;      Neumarkt i.d.OPf. (Lkr);5 bis unter 6;1267;654;613
09373;      Neumarkt i.d.OPf. (Lkr);6 bis unter 7;1187;600;587
09373;      Neumarkt i.d.OPf. (Lkr);7 bis unter 8;1207;620;587
09373;      Neumarkt i.d.OPf. (Lkr);8 bis unter 9;1209;615;594
09373;      Neumarkt i.d.OPf. (Lkr);9 bis unter 10;1200;613;587
09373;      Neumarkt i.d.OPf. (Lkr);10 bis unter 11;1185;625;560
09373;      Neumarkt i.d.OPf. (Lkr);11 bis unter 12;1208;622;586
09373;      Neumarkt i.d.OPf. (Lkr);12 bis unter 13;1249;629;620
09373;      Neumarkt i.d.OPf. (Lkr);13 bis unter 14;1218;636;582
09373;      Neumarkt i.d.OPf. (Lkr);14 bis unter 15;1207;592;615
09373;      Neumarkt i.d.OPf. (Lkr);15 bis unter 16;1289;640;649
09373;      Neumarkt i.d.OPf. (Lkr);16 bis unter 17;1331;675;656
09373;      Neumarkt i.d.OPf. (Lkr);17 bis unter 18;1427;763;664
09373;      Neumarkt i.d.OPf. (Lkr);18 bis unter 19;1529;801;728
09373;      Neumarkt i.d.OPf. (Lkr);19 bis unter 20;1531;829;702
09373;      Neumarkt i.d.OPf. (Lkr);20 bis unter 21;1590;859;731
09373;      Neumarkt i.d.OPf. (Lkr);21 bis unter 22;1600;881;719
09373;      Neumarkt i.d.OPf. (Lkr);22 bis unter 23;1602;848;754
09373;      Neumarkt i.d.OPf. (Lkr);23 bis unter 24;1545;846;699
09373;      Neumarkt i.d.OPf. (Lkr);24 bis unter 25;1573;861;712
09373;      Neumarkt i.d.OPf. (Lkr);25 bis unter 26;1664;916;748
09373;      Neumarkt i.d.OPf. (Lkr);26 bis unter 27;1669;850;819
09373;      Neumarkt i.d.OPf. (Lkr);27 bis unter 28;1637;878;759
09373;      Neumarkt i.d.OPf. (Lkr);28 bis unter 29;1738;956;782
09373;      Neumarkt i.d.OPf. (Lkr);29 bis unter 30;1580;844;736
09373;      Neumarkt i.d.OPf. (Lkr);30 bis unter 31;1709;920;789
09373;      Neumarkt i.d.OPf. (Lkr);31 bis unter 32;1564;840;724
09373;      Neumarkt i.d.OPf. (Lkr);32 bis unter 33;1651;851;800
09373;      Neumarkt i.d.OPf. (Lkr);33 bis unter 34;1577;846;731
09373;      Neumarkt i.d.OPf. (Lkr);34 bis unter 35;1574;827;747
09373;      Neumarkt i.d.OPf. (Lkr);35 bis unter 36;1684;889;795
09373;      Neumarkt i.d.OPf. (Lkr);36 bis unter 37;1621;816;805
09373;      Neumarkt i.d.OPf. (Lkr);37 bis unter 38;1724;901;823
09373;      Neumarkt i.d.OPf. (Lkr);38 bis unter 39;1788;901;887
09373;      Neumarkt i.d.OPf. (Lkr);39 bis unter 40;1598;807;791
09373;      Neumarkt i.d.OPf. (Lkr);40 bis unter 41;1597;831;766
09373;      Neumarkt i.d.OPf. (Lkr);41 bis unter 42;1621;853;768
09373;      Neumarkt i.d.OPf. (Lkr);42 bis unter 43;1557;785;772
09373;      Neumarkt i.d.OPf. (Lkr);43 bis unter 44;1620;828;792
09373;      Neumarkt i.d.OPf. (Lkr);44 bis unter 45;1603;812;791
09373;      Neumarkt i.d.OPf. (Lkr);45 bis unter 46;1648;879;769
09373;      Neumarkt i.d.OPf. (Lkr);46 bis unter 47;1837;923;914
09373;      Neumarkt i.d.OPf. (Lkr);47 bis unter 48;1940;989;951
09373;      Neumarkt i.d.OPf. (Lkr);48 bis unter 49;2009;1006;1003
09373;      Neumarkt i.d.OPf. (Lkr);49 bis unter 50;2212;1157;1055
09373;      Neumarkt i.d.OPf. (Lkr);50 bis unter 51;2224;1176;1048
09373;      Neumarkt i.d.OPf. (Lkr);51 bis unter 52;2407;1212;1195
09373;      Neumarkt i.d.OPf. (Lkr);52 bis unter 53;2382;1194;1188
09373;      Neumarkt i.d.OPf. (Lkr);53 bis unter 54;2370;1249;1121
09373;      Neumarkt i.d.OPf. (Lkr);54 bis unter 55;2390;1185;1205
09373;      Neumarkt i.d.OPf. (Lkr);55 bis unter 56;2407;1242;1165
09373;      Neumarkt i.d.OPf. (Lkr);56 bis unter 57;2305;1171;1134
09373;      Neumarkt i.d.OPf. (Lkr);57 bis unter 58;2249;1179;1070
09373;      Neumarkt i.d.OPf. (Lkr);58 bis unter 59;2198;1130;1068
09373;      Neumarkt i.d.OPf. (Lkr);59 bis unter 60;2117;1090;1027
09373;      Neumarkt i.d.OPf. (Lkr);60 bis unter 61;1931;989;942
09373;      Neumarkt i.d.OPf. (Lkr);61 bis unter 62;1956;975;981
09373;      Neumarkt i.d.OPf. (Lkr);62 bis unter 63;1789;875;914
09373;      Neumarkt i.d.OPf. (Lkr);63 bis unter 64;1722;876;846
09373;      Neumarkt i.d.OPf. (Lkr);64 bis unter 65;1681;856;825
09373;      Neumarkt i.d.OPf. (Lkr);65 bis unter 66;1548;770;778
09373;      Neumarkt i.d.OPf. (Lkr);66 bis unter 67;1561;789;772
09373;      Neumarkt i.d.OPf. (Lkr);67 bis unter 68;1511;746;765
09373;      Neumarkt i.d.OPf. (Lkr);68 bis unter 69;1417;715;702
09373;      Neumarkt i.d.OPf. (Lkr);69 bis unter 70;1366;688;678
09373;      Neumarkt i.d.OPf. (Lkr);70 bis unter 71;1263;680;583
09373;      Neumarkt i.d.OPf. (Lkr);71 bis unter 72;1140;564;576
09373;      Neumarkt i.d.OPf. (Lkr);72 bis unter 73;1006;474;532
09373;      Neumarkt i.d.OPf. (Lkr);73 bis unter 74;705;338;367
09373;      Neumarkt i.d.OPf. (Lkr);74 bis unter 75;906;421;485
09373;      Neumarkt i.d.OPf. (Lkr);75 bis unter 76;967;437;530
09373;      Neumarkt i.d.OPf. (Lkr);76 bis unter 77;921;447;474
09373;      Neumarkt i.d.OPf. (Lkr);77 bis unter 78;1147;541;606
09373;      Neumarkt i.d.OPf. (Lkr);78 bis unter 79;1289;567;722
09373;      Neumarkt i.d.OPf. (Lkr);79 bis unter 80;1272;563;709
09373;      Neumarkt i.d.OPf. (Lkr);80 bis unter 81;1060;429;631
09373;      Neumarkt i.d.OPf. (Lkr);81 bis unter 82;911;377;534
09373;      Neumarkt i.d.OPf. (Lkr);82 bis unter 83;836;342;494
09373;      Neumarkt i.d.OPf. (Lkr);83 bis unter 84;739;290;449
09373;      Neumarkt i.d.OPf. (Lkr);84 bis unter 85;641;238;403
09373;      Neumarkt i.d.OPf. (Lkr);85 bis unter 90;2136;741;1395
09373;      Neumarkt i.d.OPf. (Lkr);90 bis unter 95;866;250;616
09373;      Neumarkt i.d.OPf. (Lkr);95 oder älter;203;52;151
09373;      Neumarkt i.d.OPf. (Lkr);Insgesamt;133561;67499;66062
09374;      Neustadt a.d.Waldnaab (Lkr);unter 1;1030;505;525
09374;      Neustadt a.d.Waldnaab (Lkr);1 bis unter 2;784;390;394
09374;      Neustadt a.d.Waldnaab (Lkr);2 bis unter 3;826;424;402
09374;      Neustadt a.d.Waldnaab (Lkr);3 bis unter 4;802;430;372
09374;      Neustadt a.d.Waldnaab (Lkr);4 bis unter 5;742;399;343
09374;      Neustadt a.d.Waldnaab (Lkr);5 bis unter 6;728;356;372
09374;      Neustadt a.d.Waldnaab (Lkr);6 bis unter 7;837;440;397
09374;      Neustadt a.d.Waldnaab (Lkr);7 bis unter 8;763;393;370
09374;      Neustadt a.d.Waldnaab (Lkr);8 bis unter 9;782;402;380
09374;      Neustadt a.d.Waldnaab (Lkr);9 bis unter 10;789;424;365
09374;      Neustadt a.d.Waldnaab (Lkr);10 bis unter 11;784;377;407
09374;      Neustadt a.d.Waldnaab (Lkr);11 bis unter 12;847;443;404
09374;      Neustadt a.d.Waldnaab (Lkr);12 bis unter 13;834;443;391
09374;      Neustadt a.d.Waldnaab (Lkr);13 bis unter 14;817;405;412
09374;      Neustadt a.d.Waldnaab (Lkr);14 bis unter 15;864;429;435
09374;      Neustadt a.d.Waldnaab (Lkr);15 bis unter 16;914;457;457
09374;      Neustadt a.d.Waldnaab (Lkr);16 bis unter 17;950;502;448
09374;      Neustadt a.d.Waldnaab (Lkr);17 bis unter 18;1001;492;509
09374;      Neustadt a.d.Waldnaab (Lkr);18 bis unter 19;1035;543;492
09374;      Neustadt a.d.Waldnaab (Lkr);19 bis unter 20;1081;589;492
09374;      Neustadt a.d.Waldnaab (Lkr);20 bis unter 21;1149;597;552
09374;      Neustadt a.d.Waldnaab (Lkr);21 bis unter 22;1041;527;514
09374;      Neustadt a.d.Waldnaab (Lkr);22 bis unter 23;1033;533;500
09374;      Neustadt a.d.Waldnaab (Lkr);23 bis unter 24;994;549;445
09374;      Neustadt a.d.Waldnaab (Lkr);24 bis unter 25;1040;553;487
09374;      Neustadt a.d.Waldnaab (Lkr);25 bis unter 26;1054;569;485
09374;      Neustadt a.d.Waldnaab (Lkr);26 bis unter 27;1084;577;507
09374;      Neustadt a.d.Waldnaab (Lkr);27 bis unter 28;1099;559;540
09374;      Neustadt a.d.Waldnaab (Lkr);28 bis unter 29;1115;602;513
09374;      Neustadt a.d.Waldnaab (Lkr);29 bis unter 30;1038;515;523
09374;      Neustadt a.d.Waldnaab (Lkr);30 bis unter 31;1088;575;513
09374;      Neustadt a.d.Waldnaab (Lkr);31 bis unter 32;1132;583;549
09374;      Neustadt a.d.Waldnaab (Lkr);32 bis unter 33;1143;566;577
09374;      Neustadt a.d.Waldnaab (Lkr);33 bis unter 34;1077;557;520
09374;      Neustadt a.d.Waldnaab (Lkr);34 bis unter 35;1081;555;526
09374;      Neustadt a.d.Waldnaab (Lkr);35 bis unter 36;1092;553;539
09374;      Neustadt a.d.Waldnaab (Lkr);36 bis unter 37;1156;601;555
09374;      Neustadt a.d.Waldnaab (Lkr);37 bis unter 38;1137;588;549
09374;      Neustadt a.d.Waldnaab (Lkr);38 bis unter 39;1113;522;591
09374;      Neustadt a.d.Waldnaab (Lkr);39 bis unter 40;1057;571;486
09374;      Neustadt a.d.Waldnaab (Lkr);40 bis unter 41;1057;525;532
09374;      Neustadt a.d.Waldnaab (Lkr);41 bis unter 42;1076;534;542
09374;      Neustadt a.d.Waldnaab (Lkr);42 bis unter 43;1004;502;502
09374;      Neustadt a.d.Waldnaab (Lkr);43 bis unter 44;1109;569;540
09374;      Neustadt a.d.Waldnaab (Lkr);44 bis unter 45;1066;518;548
09374;      Neustadt a.d.Waldnaab (Lkr);45 bis unter 46;1116;577;539
09374;      Neustadt a.d.Waldnaab (Lkr);46 bis unter 47;1220;623;597
09374;      Neustadt a.d.Waldnaab (Lkr);47 bis unter 48;1330;648;682
09374;      Neustadt a.d.Waldnaab (Lkr);48 bis unter 49;1398;670;728
09374;      Neustadt a.d.Waldnaab (Lkr);49 bis unter 50;1595;752;843
09374;      Neustadt a.d.Waldnaab (Lkr);50 bis unter 51;1605;791;814
09374;      Neustadt a.d.Waldnaab (Lkr);51 bis unter 52;1707;856;851
09374;      Neustadt a.d.Waldnaab (Lkr);52 bis unter 53;1697;889;808
09374;      Neustadt a.d.Waldnaab (Lkr);53 bis unter 54;1666;838;828
09374;      Neustadt a.d.Waldnaab (Lkr);54 bis unter 55;1774;920;854
09374;      Neustadt a.d.Waldnaab (Lkr);55 bis unter 56;1710;832;878
09374;      Neustadt a.d.Waldnaab (Lkr);56 bis unter 57;1730;913;817
09374;      Neustadt a.d.Waldnaab (Lkr);57 bis unter 58;1700;876;824
09374;      Neustadt a.d.Waldnaab (Lkr);58 bis unter 59;1612;829;783
09374;      Neustadt a.d.Waldnaab (Lkr);59 bis unter 60;1574;801;773
09374;      Neustadt a.d.Waldnaab (Lkr);60 bis unter 61;1479;748;731
09374;      Neustadt a.d.Waldnaab (Lkr);61 bis unter 62;1492;764;728
09374;      Neustadt a.d.Waldnaab (Lkr);62 bis unter 63;1355;683;672
09374;      Neustadt a.d.Waldnaab (Lkr);63 bis unter 64;1299;679;620
09374;      Neustadt a.d.Waldnaab (Lkr);64 bis unter 65;1287;660;627
09374;      Neustadt a.d.Waldnaab (Lkr);65 bis unter 66;1245;641;604
09374;      Neustadt a.d.Waldnaab (Lkr);66 bis unter 67;1230;607;623
09374;      Neustadt a.d.Waldnaab (Lkr);67 bis unter 68;1202;599;603
09374;      Neustadt a.d.Waldnaab (Lkr);68 bis unter 69;1177;577;600
09374;      Neustadt a.d.Waldnaab (Lkr);69 bis unter 70;1074;556;518
09374;      Neustadt a.d.Waldnaab (Lkr);70 bis unter 71;917;473;444
09374;      Neustadt a.d.Waldnaab (Lkr);71 bis unter 72;880;427;453
09374;      Neustadt a.d.Waldnaab (Lkr);72 bis unter 73;725;342;383
09374;      Neustadt a.d.Waldnaab (Lkr);73 bis unter 74;578;277;301
09374;      Neustadt a.d.Waldnaab (Lkr);74 bis unter 75;765;348;417
09374;      Neustadt a.d.Waldnaab (Lkr);75 bis unter 76;699;311;388
09374;      Neustadt a.d.Waldnaab (Lkr);76 bis unter 77;671;314;357
09374;      Neustadt a.d.Waldnaab (Lkr);77 bis unter 78;865;390;475
09374;      Neustadt a.d.Waldnaab (Lkr);78 bis unter 79;947;413;534
09374;      Neustadt a.d.Waldnaab (Lkr);79 bis unter 80;1022;439;583
09374;      Neustadt a.d.Waldnaab (Lkr);80 bis unter 81;834;351;483
09374;      Neustadt a.d.Waldnaab (Lkr);81 bis unter 82;669;289;380
09374;      Neustadt a.d.Waldnaab (Lkr);82 bis unter 83;714;279;435
09374;      Neustadt a.d.Waldnaab (Lkr);83 bis unter 84;590;234;356
09374;      Neustadt a.d.Waldnaab (Lkr);84 bis unter 85;525;206;319
09374;      Neustadt a.d.Waldnaab (Lkr);85 bis unter 90;1686;590;1096
09374;      Neustadt a.d.Waldnaab (Lkr);90 bis unter 95;644;168;476
09374;      Neustadt a.d.Waldnaab (Lkr);95 oder älter;102;20;82
09374;      Neustadt a.d.Waldnaab (Lkr);Insgesamt;94352;46943;47409
09375;      Regensburg (Lkr);unter 1;1793;886;907
09375;      Regensburg (Lkr);1 bis unter 2;1884;955;929
09375;      Regensburg (Lkr);2 bis unter 3;1946;1009;937
09375;      Regensburg (Lkr);3 bis unter 4;1913;927;986
09375;      Regensburg (Lkr);4 bis unter 5;1888;1002;886
09375;      Regensburg (Lkr);5 bis unter 6;1903;987;916
09375;      Regensburg (Lkr);6 bis unter 7;1776;916;860
09375;      Regensburg (Lkr);7 bis unter 8;1773;954;819
09375;      Regensburg (Lkr);8 bis unter 9;1771;916;855
09375;      Regensburg (Lkr);9 bis unter 10;1763;904;859
09375;      Regensburg (Lkr);10 bis unter 11;1804;935;869
09375;      Regensburg (Lkr);11 bis unter 12;1861;924;937
09375;      Regensburg (Lkr);12 bis unter 13;1745;921;824
09375;      Regensburg (Lkr);13 bis unter 14;1813;952;861
09375;      Regensburg (Lkr);14 bis unter 15;1875;950;925
09375;      Regensburg (Lkr);15 bis unter 16;1885;953;932
09375;      Regensburg (Lkr);16 bis unter 17;1952;1025;927
09375;      Regensburg (Lkr);17 bis unter 18;1952;1027;925
09375;      Regensburg (Lkr);18 bis unter 19;2048;1052;996
09375;      Regensburg (Lkr);19 bis unter 20;2126;1122;1004
09375;      Regensburg (Lkr);20 bis unter 21;2193;1134;1059
09375;      Regensburg (Lkr);21 bis unter 22;2236;1209;1027
09375;      Regensburg (Lkr);22 bis unter 23;2102;1164;938
09375;      Regensburg (Lkr);23 bis unter 24;2101;1160;941
09375;      Regensburg (Lkr);24 bis unter 25;2110;1129;981
09375;      Regensburg (Lkr);25 bis unter 26;2094;1138;956
09375;      Regensburg (Lkr);26 bis unter 27;2137;1149;988
09375;      Regensburg (Lkr);27 bis unter 28;2128;1145;983
09375;      Regensburg (Lkr);28 bis unter 29;2293;1219;1074
09375;      Regensburg (Lkr);29 bis unter 30;2160;1143;1017
09375;      Regensburg (Lkr);30 bis unter 31;2222;1172;1050
09375;      Regensburg (Lkr);31 bis unter 32;2247;1118;1129
09375;      Regensburg (Lkr);32 bis unter 33;2343;1201;1142
09375;      Regensburg (Lkr);33 bis unter 34;2338;1231;1107
09375;      Regensburg (Lkr);34 bis unter 35;2300;1154;1146
09375;      Regensburg (Lkr);35 bis unter 36;2354;1229;1125
09375;      Regensburg (Lkr);36 bis unter 37;2489;1215;1274
09375;      Regensburg (Lkr);37 bis unter 38;2555;1298;1257
09375;      Regensburg (Lkr);38 bis unter 39;2592;1300;1292
09375;      Regensburg (Lkr);39 bis unter 40;2582;1291;1291
09375;      Regensburg (Lkr);40 bis unter 41;2453;1252;1201
09375;      Regensburg (Lkr);41 bis unter 42;2429;1225;1204
09375;      Regensburg (Lkr);42 bis unter 43;2401;1201;1200
09375;      Regensburg (Lkr);43 bis unter 44;2401;1206;1195
09375;      Regensburg (Lkr);44 bis unter 45;2405;1176;1229
09375;      Regensburg (Lkr);45 bis unter 46;2544;1266;1278
09375;      Regensburg (Lkr);46 bis unter 47;2726;1383;1343
09375;      Regensburg (Lkr);47 bis unter 48;2809;1439;1370
09375;      Regensburg (Lkr);48 bis unter 49;3036;1586;1450
09375;      Regensburg (Lkr);49 bis unter 50;3269;1691;1578
09375;      Regensburg (Lkr);50 bis unter 51;3320;1685;1635
09375;      Regensburg (Lkr);51 bis unter 52;3314;1689;1625
09375;      Regensburg (Lkr);52 bis unter 53;3480;1731;1749
09375;      Regensburg (Lkr);53 bis unter 54;3458;1720;1738
09375;      Regensburg (Lkr);54 bis unter 55;3455;1746;1709
09375;      Regensburg (Lkr);55 bis unter 56;3460;1778;1682
09375;      Regensburg (Lkr);56 bis unter 57;3295;1662;1633
09375;      Regensburg (Lkr);57 bis unter 58;3277;1629;1648
09375;      Regensburg (Lkr);58 bis unter 59;3190;1616;1574
09375;      Regensburg (Lkr);59 bis unter 60;3103;1533;1570
09375;      Regensburg (Lkr);60 bis unter 61;2895;1475;1420
09375;      Regensburg (Lkr);61 bis unter 62;2754;1391;1363
09375;      Regensburg (Lkr);62 bis unter 63;2693;1304;1389
09375;      Regensburg (Lkr);63 bis unter 64;2567;1275;1292
09375;      Regensburg (Lkr);64 bis unter 65;2431;1237;1194
09375;      Regensburg (Lkr);65 bis unter 66;2348;1124;1224
09375;      Regensburg (Lkr);66 bis unter 67;2374;1145;1229
09375;      Regensburg (Lkr);67 bis unter 68;2205;1098;1107
09375;      Regensburg (Lkr);68 bis unter 69;2207;1075;1132
09375;      Regensburg (Lkr);69 bis unter 70;2097;1026;1071
09375;      Regensburg (Lkr);70 bis unter 71;1948;976;972
09375;      Regensburg (Lkr);71 bis unter 72;1854;914;940
09375;      Regensburg (Lkr);72 bis unter 73;1536;743;793
09375;      Regensburg (Lkr);73 bis unter 74;1160;554;606
09375;      Regensburg (Lkr);74 bis unter 75;1575;786;789
09375;      Regensburg (Lkr);75 bis unter 76;1439;728;711
09375;      Regensburg (Lkr);76 bis unter 77;1341;643;698
09375;      Regensburg (Lkr);77 bis unter 78;1704;785;919
09375;      Regensburg (Lkr);78 bis unter 79;1833;829;1004
09375;      Regensburg (Lkr);79 bis unter 80;1641;747;894
09375;      Regensburg (Lkr);80 bis unter 81;1451;649;802
09375;      Regensburg (Lkr);81 bis unter 82;1315;583;732
09375;      Regensburg (Lkr);82 bis unter 83;1113;483;630
09375;      Regensburg (Lkr);83 bis unter 84;1023;431;592
09375;      Regensburg (Lkr);84 bis unter 85;881;347;534
09375;      Regensburg (Lkr);85 bis unter 90;2900;1016;1884
09375;      Regensburg (Lkr);90 bis unter 95;1168;328;840
09375;      Regensburg (Lkr);95 oder älter;247;59;188
09375;      Regensburg (Lkr);Insgesamt;193572;97081;96491
09376;      Schwandorf (Lkr);unter 1;1315;667;648
09376;      Schwandorf (Lkr);1 bis unter 2;1357;696;661
09376;      Schwandorf (Lkr);2 bis unter 3;1374;706;668
09376;      Schwandorf (Lkr);3 bis unter 4;1294;704;590
09376;      Schwandorf (Lkr);4 bis unter 5;1252;642;610
09376;      Schwandorf (Lkr);5 bis unter 6;1240;623;617
09376;      Schwandorf (Lkr);6 bis unter 7;1260;626;634
09376;      Schwandorf (Lkr);7 bis unter 8;1236;674;562
09376;      Schwandorf (Lkr);8 bis unter 9;1231;623;608
09376;      Schwandorf (Lkr);9 bis unter 10;1213;620;593
09376;      Schwandorf (Lkr);10 bis unter 11;1224;606;618
09376;      Schwandorf (Lkr);11 bis unter 12;1289;658;631
09376;      Schwandorf (Lkr);12 bis unter 13;1302;643;659
09376;      Schwandorf (Lkr);13 bis unter 14;1258;637;621
09376;      Schwandorf (Lkr);14 bis unter 15;1381;721;660
09376;      Schwandorf (Lkr);15 bis unter 16;1432;736;696
09376;      Schwandorf (Lkr);16 bis unter 17;1371;711;660
09376;      Schwandorf (Lkr);17 bis unter 18;1512;789;723
09376;      Schwandorf (Lkr);18 bis unter 19;1523;796;727
09376;      Schwandorf (Lkr);19 bis unter 20;1672;909;763
09376;      Schwandorf (Lkr);20 bis unter 21;1659;855;804
09376;      Schwandorf (Lkr);21 bis unter 22;1697;895;802
09376;      Schwandorf (Lkr);22 bis unter 23;1683;893;790
09376;      Schwandorf (Lkr);23 bis unter 24;1679;923;756
09376;      Schwandorf (Lkr);24 bis unter 25;1720;913;807
09376;      Schwandorf (Lkr);25 bis unter 26;1742;945;797
09376;      Schwandorf (Lkr);26 bis unter 27;1791;953;838
09376;      Schwandorf (Lkr);27 bis unter 28;1763;961;802
09376;      Schwandorf (Lkr);28 bis unter 29;1917;1006;911
09376;      Schwandorf (Lkr);29 bis unter 30;1736;937;799
09376;      Schwandorf (Lkr);30 bis unter 31;1870;1008;862
09376;      Schwandorf (Lkr);31 bis unter 32;1855;1052;803
09376;      Schwandorf (Lkr);32 bis unter 33;1743;895;848
09376;      Schwandorf (Lkr);33 bis unter 34;1743;885;858
09376;      Schwandorf (Lkr);34 bis unter 35;1744;918;826
09376;      Schwandorf (Lkr);35 bis unter 36;1788;934;854
09376;      Schwandorf (Lkr);36 bis unter 37;1829;935;894
09376;      Schwandorf (Lkr);37 bis unter 38;1797;918;879
09376;      Schwandorf (Lkr);38 bis unter 39;1813;882;931
09376;      Schwandorf (Lkr);39 bis unter 40;1845;920;925
09376;      Schwandorf (Lkr);40 bis unter 41;1779;956;823
09376;      Schwandorf (Lkr);41 bis unter 42;1869;957;912
09376;      Schwandorf (Lkr);42 bis unter 43;1731;915;816
09376;      Schwandorf (Lkr);43 bis unter 44;1726;947;779
09376;      Schwandorf (Lkr);44 bis unter 45;1876;921;955
09376;      Schwandorf (Lkr);45 bis unter 46;1812;947;865
09376;      Schwandorf (Lkr);46 bis unter 47;1989;1026;963
09376;      Schwandorf (Lkr);47 bis unter 48;2142;1061;1081
09376;      Schwandorf (Lkr);48 bis unter 49;2244;1141;1103
09376;      Schwandorf (Lkr);49 bis unter 50;2365;1221;1144
09376;      Schwandorf (Lkr);50 bis unter 51;2482;1256;1226
09376;      Schwandorf (Lkr);51 bis unter 52;2369;1243;1126
09376;      Schwandorf (Lkr);52 bis unter 53;2476;1265;1211
09376;      Schwandorf (Lkr);53 bis unter 54;2567;1359;1208
09376;      Schwandorf (Lkr);54 bis unter 55;2694;1412;1282
09376;      Schwandorf (Lkr);55 bis unter 56;2607;1299;1308
09376;      Schwandorf (Lkr);56 bis unter 57;2596;1296;1300
09376;      Schwandorf (Lkr);57 bis unter 58;2552;1349;1203
09376;      Schwandorf (Lkr);58 bis unter 59;2408;1220;1188
09376;      Schwandorf (Lkr);59 bis unter 60;2307;1177;1130
09376;      Schwandorf (Lkr);60 bis unter 61;2204;1136;1068
09376;      Schwandorf (Lkr);61 bis unter 62;2137;1134;1003
09376;      Schwandorf (Lkr);62 bis unter 63;2053;1011;1042
09376;      Schwandorf (Lkr);63 bis unter 64;1940;973;967
09376;      Schwandorf (Lkr);64 bis unter 65;1894;945;949
09376;      Schwandorf (Lkr);65 bis unter 66;1887;949;938
09376;      Schwandorf (Lkr);66 bis unter 67;1842;938;904
09376;      Schwandorf (Lkr);67 bis unter 68;1776;868;908
09376;      Schwandorf (Lkr);68 bis unter 69;1690;854;836
09376;      Schwandorf (Lkr);69 bis unter 70;1602;804;798
09376;      Schwandorf (Lkr);70 bis unter 71;1486;718;768
09376;      Schwandorf (Lkr);71 bis unter 72;1300;630;670
09376;      Schwandorf (Lkr);72 bis unter 73;1157;536;621
09376;      Schwandorf (Lkr);73 bis unter 74;908;426;482
09376;      Schwandorf (Lkr);74 bis unter 75;1126;537;589
09376;      Schwandorf (Lkr);75 bis unter 76;1120;522;598
09376;      Schwandorf (Lkr);76 bis unter 77;1066;487;579
09376;      Schwandorf (Lkr);77 bis unter 78;1353;619;734
09376;      Schwandorf (Lkr);78 bis unter 79;1420;637;783
09376;      Schwandorf (Lkr);79 bis unter 80;1483;613;870
09376;      Schwandorf (Lkr);80 bis unter 81;1238;498;740
09376;      Schwandorf (Lkr);81 bis unter 82;1120;455;665
09376;      Schwandorf (Lkr);82 bis unter 83;1028;400;628
09376;      Schwandorf (Lkr);83 bis unter 84;876;340;536
09376;      Schwandorf (Lkr);84 bis unter 85;841;319;522
09376;      Schwandorf (Lkr);85 bis unter 90;2615;899;1716
09376;      Schwandorf (Lkr);90 bis unter 95;1071;285;786
09376;      Schwandorf (Lkr);95 oder älter;215;48;167
09376;      Schwandorf (Lkr);Insgesamt;147189;73964;73225
09377;      Tirschenreuth (Lkr);unter 1;596;302;294
09377;      Tirschenreuth (Lkr);1 bis unter 2;586;297;289
09377;      Tirschenreuth (Lkr);2 bis unter 3;651;337;314
09377;      Tirschenreuth (Lkr);3 bis unter 4;591;297;294
09377;      Tirschenreuth (Lkr);4 bis unter 5;608;317;291
09377;      Tirschenreuth (Lkr);5 bis unter 6;620;310;310
09377;      Tirschenreuth (Lkr);6 bis unter 7;596;298;298
09377;      Tirschenreuth (Lkr);7 bis unter 8;542;271;271
09377;      Tirschenreuth (Lkr);8 bis unter 9;622;311;311
09377;      Tirschenreuth (Lkr);9 bis unter 10;565;286;279
09377;      Tirschenreuth (Lkr);10 bis unter 11;635;323;312
09377;      Tirschenreuth (Lkr);11 bis unter 12;552;285;267
09377;      Tirschenreuth (Lkr);12 bis unter 13;567;292;275
09377;      Tirschenreuth (Lkr);13 bis unter 14;616;329;287
09377;      Tirschenreuth (Lkr);14 bis unter 15;631;316;315
09377;      Tirschenreuth (Lkr);15 bis unter 16;654;337;317
09377;      Tirschenreuth (Lkr);16 bis unter 17;675;342;333
09377;      Tirschenreuth (Lkr);17 bis unter 18;744;392;352
09377;      Tirschenreuth (Lkr);18 bis unter 19;700;352;348
09377;      Tirschenreuth (Lkr);19 bis unter 20;756;407;349
09377;      Tirschenreuth (Lkr);20 bis unter 21;770;400;370
09377;      Tirschenreuth (Lkr);21 bis unter 22;837;452;385
09377;      Tirschenreuth (Lkr);22 bis unter 23;809;447;362
09377;      Tirschenreuth (Lkr);23 bis unter 24;757;401;356
09377;      Tirschenreuth (Lkr);24 bis unter 25;798;439;359
09377;      Tirschenreuth (Lkr);25 bis unter 26;853;440;413
09377;      Tirschenreuth (Lkr);26 bis unter 27;811;442;369
09377;      Tirschenreuth (Lkr);27 bis unter 28;809;456;353
09377;      Tirschenreuth (Lkr);28 bis unter 29;882;465;417
09377;      Tirschenreuth (Lkr);29 bis unter 30;842;445;397
09377;      Tirschenreuth (Lkr);30 bis unter 31;802;415;387
09377;      Tirschenreuth (Lkr);31 bis unter 32;797;439;358
09377;      Tirschenreuth (Lkr);32 bis unter 33;796;428;368
09377;      Tirschenreuth (Lkr);33 bis unter 34;829;448;381
09377;      Tirschenreuth (Lkr);34 bis unter 35;783;408;375
09377;      Tirschenreuth (Lkr);35 bis unter 36;815;415;400
09377;      Tirschenreuth (Lkr);36 bis unter 37;785;389;396
09377;      Tirschenreuth (Lkr);37 bis unter 38;798;404;394
09377;      Tirschenreuth (Lkr);38 bis unter 39;818;424;394
09377;      Tirschenreuth (Lkr);39 bis unter 40;766;363;403
09377;      Tirschenreuth (Lkr);40 bis unter 41;787;409;378
09377;      Tirschenreuth (Lkr);41 bis unter 42;809;387;422
09377;      Tirschenreuth (Lkr);42 bis unter 43;786;422;364
09377;      Tirschenreuth (Lkr);43 bis unter 44;827;412;415
09377;      Tirschenreuth (Lkr);44 bis unter 45;829;419;410
09377;      Tirschenreuth (Lkr);45 bis unter 46;864;439;425
09377;      Tirschenreuth (Lkr);46 bis unter 47;942;495;447
09377;      Tirschenreuth (Lkr);47 bis unter 48;1033;531;502
09377;      Tirschenreuth (Lkr);48 bis unter 49;1074;533;541
09377;      Tirschenreuth (Lkr);49 bis unter 50;1176;615;561
09377;      Tirschenreuth (Lkr);50 bis unter 51;1237;614;623
09377;      Tirschenreuth (Lkr);51 bis unter 52;1249;619;630
09377;      Tirschenreuth (Lkr);52 bis unter 53;1269;675;594
09377;      Tirschenreuth (Lkr);53 bis unter 54;1274;661;613
09377;      Tirschenreuth (Lkr);54 bis unter 55;1328;641;687
09377;      Tirschenreuth (Lkr);55 bis unter 56;1331;655;676
09377;      Tirschenreuth (Lkr);56 bis unter 57;1330;685;645
09377;      Tirschenreuth (Lkr);57 bis unter 58;1308;688;620
09377;      Tirschenreuth (Lkr);58 bis unter 59;1244;637;607
09377;      Tirschenreuth (Lkr);59 bis unter 60;1190;622;568
09377;      Tirschenreuth (Lkr);60 bis unter 61;1212;606;606
09377;      Tirschenreuth (Lkr);61 bis unter 62;1111;550;561
09377;      Tirschenreuth (Lkr);62 bis unter 63;1116;542;574
09377;      Tirschenreuth (Lkr);63 bis unter 64;1018;507;511
09377;      Tirschenreuth (Lkr);64 bis unter 65;1046;529;517
09377;      Tirschenreuth (Lkr);65 bis unter 66;954;473;481
09377;      Tirschenreuth (Lkr);66 bis unter 67;959;510;449
09377;      Tirschenreuth (Lkr);67 bis unter 68;920;446;474
09377;      Tirschenreuth (Lkr);68 bis unter 69;940;485;455
09377;      Tirschenreuth (Lkr);69 bis unter 70;858;448;410
09377;      Tirschenreuth (Lkr);70 bis unter 71;762;383;379
09377;      Tirschenreuth (Lkr);71 bis unter 72;730;358;372
09377;      Tirschenreuth (Lkr);72 bis unter 73;618;276;342
09377;      Tirschenreuth (Lkr);73 bis unter 74;466;208;258
09377;      Tirschenreuth (Lkr);74 bis unter 75;572;270;302
09377;      Tirschenreuth (Lkr);75 bis unter 76;638;284;354
09377;      Tirschenreuth (Lkr);76 bis unter 77;601;273;328
09377;      Tirschenreuth (Lkr);77 bis unter 78;769;341;428
09377;      Tirschenreuth (Lkr);78 bis unter 79;826;383;443
09377;      Tirschenreuth (Lkr);79 bis unter 80;802;352;450
09377;      Tirschenreuth (Lkr);80 bis unter 81;691;274;417
09377;      Tirschenreuth (Lkr);81 bis unter 82;601;253;348
09377;      Tirschenreuth (Lkr);82 bis unter 83;549;217;332
09377;      Tirschenreuth (Lkr);83 bis unter 84;534;195;339
09377;      Tirschenreuth (Lkr);84 bis unter 85;479;202;277
09377;      Tirschenreuth (Lkr);85 bis unter 90;1475;496;979
09377;      Tirschenreuth (Lkr);90 bis unter 95;567;152;415
09377;      Tirschenreuth (Lkr);95 oder älter;139;28;111
09377;      Tirschenreuth (Lkr);Insgesamt;72504;36121;36383
LK093;    Landkreise Oberpfalz;unter 1;8227;4126;4101
LK093;    Landkreise Oberpfalz;1 bis unter 2;7922;4033;3889
LK093;    Landkreise Oberpfalz;2 bis unter 3;8062;4157;3905
LK093;    Landkreise Oberpfalz;3 bis unter 4;7918;4106;3812
LK093;    Landkreise Oberpfalz;4 bis unter 5;7753;4046;3707
LK093;    Landkreise Oberpfalz;5 bis unter 6;7679;3923;3756
LK093;    Landkreise Oberpfalz;6 bis unter 7;7574;3828;3746
LK093;    Landkreise Oberpfalz;7 bis unter 8;7376;3805;3571
LK093;    Landkreise Oberpfalz;8 bis unter 9;7566;3872;3694
LK093;    Landkreise Oberpfalz;9 bis unter 10;7438;3808;3630
LK093;    Landkreise Oberpfalz;10 bis unter 11;7685;3937;3748
LK093;    Landkreise Oberpfalz;11 bis unter 12;7688;3957;3731
LK093;    Landkreise Oberpfalz;12 bis unter 13;7635;3926;3709
LK093;    Landkreise Oberpfalz;13 bis unter 14;7815;4037;3778
LK093;    Landkreise Oberpfalz;14 bis unter 15;8102;4147;3955
LK093;    Landkreise Oberpfalz;15 bis unter 16;8303;4194;4109
LK093;    Landkreise Oberpfalz;16 bis unter 17;8430;4345;4085
LK093;    Landkreise Oberpfalz;17 bis unter 18;9061;4668;4393
LK093;    Landkreise Oberpfalz;18 bis unter 19;9271;4801;4470
LK093;    Landkreise Oberpfalz;19 bis unter 20;9722;5253;4469
LK093;    Landkreise Oberpfalz;20 bis unter 21;9854;5208;4646
LK093;    Landkreise Oberpfalz;21 bis unter 22;10122;5442;4680
LK093;    Landkreise Oberpfalz;22 bis unter 23;9863;5237;4626
LK093;    Landkreise Oberpfalz;23 bis unter 24;9687;5259;4428
LK093;    Landkreise Oberpfalz;24 bis unter 25;9843;5310;4533
LK093;    Landkreise Oberpfalz;25 bis unter 26;10023;5421;4602
LK093;    Landkreise Oberpfalz;26 bis unter 27;10130;5377;4753
LK093;    Landkreise Oberpfalz;27 bis unter 28;10107;5426;4681
LK093;    Landkreise Oberpfalz;28 bis unter 29;10748;5776;4972
LK093;    Landkreise Oberpfalz;29 bis unter 30;10050;5265;4785
LK093;    Landkreise Oberpfalz;30 bis unter 31;10581;5629;4952
LK093;    Landkreise Oberpfalz;31 bis unter 32;10231;5418;4813
LK093;    Landkreise Oberpfalz;32 bis unter 33;10467;5374;5093
LK093;    Landkreise Oberpfalz;33 bis unter 34;10233;5367;4866
LK093;    Landkreise Oberpfalz;34 bis unter 35;10087;5218;4869
LK093;    Landkreise Oberpfalz;35 bis unter 36;10328;5339;4989
LK093;    Landkreise Oberpfalz;36 bis unter 37;10639;5355;5284
LK093;    Landkreise Oberpfalz;37 bis unter 38;10760;5516;5244
LK093;    Landkreise Oberpfalz;38 bis unter 39;10882;5468;5414
LK093;    Landkreise Oberpfalz;39 bis unter 40;10508;5321;5187
LK093;    Landkreise Oberpfalz;40 bis unter 41;10311;5332;4979
LK093;    Landkreise Oberpfalz;41 bis unter 42;10428;5306;5122
LK093;    Landkreise Oberpfalz;42 bis unter 43;10114;5104;5010
LK093;    Landkreise Oberpfalz;43 bis unter 44;10269;5274;4995
LK093;    Landkreise Oberpfalz;44 bis unter 45;10478;5242;5236
LK093;    Landkreise Oberpfalz;45 bis unter 46;10785;5542;5243
LK093;    Landkreise Oberpfalz;46 bis unter 47;11791;5971;5820
LK093;    Landkreise Oberpfalz;47 bis unter 48;12708;6422;6286
LK093;    Landkreise Oberpfalz;48 bis unter 49;13110;6644;6466
LK093;    Landkreise Oberpfalz;49 bis unter 50;14280;7254;7026
LK093;    Landkreise Oberpfalz;50 bis unter 51;14689;7501;7188
LK093;    Landkreise Oberpfalz;51 bis unter 52;14927;7642;7285
LK093;    Landkreise Oberpfalz;52 bis unter 53;15414;7872;7542
LK093;    Landkreise Oberpfalz;53 bis unter 54;15326;7870;7456
LK093;    Landkreise Oberpfalz;54 bis unter 55;15952;8096;7856
LK093;    Landkreise Oberpfalz;55 bis unter 56;15682;7872;7810
LK093;    Landkreise Oberpfalz;56 bis unter 57;15367;7804;7563
LK093;    Landkreise Oberpfalz;57 bis unter 58;15235;7855;7380
LK093;    Landkreise Oberpfalz;58 bis unter 59;14650;7533;7117
LK093;    Landkreise Oberpfalz;59 bis unter 60;14186;7187;6999
LK093;    Landkreise Oberpfalz;60 bis unter 61;13420;6803;6617
LK093;    Landkreise Oberpfalz;61 bis unter 62;13055;6668;6387
LK093;    Landkreise Oberpfalz;62 bis unter 63;12381;6156;6225
LK093;    Landkreise Oberpfalz;63 bis unter 64;11708;5896;5812
LK093;    Landkreise Oberpfalz;64 bis unter 65;11527;5865;5662
LK093;    Landkreise Oberpfalz;65 bis unter 66;11035;5494;5541
LK093;    Landkreise Oberpfalz;66 bis unter 67;10975;5514;5461
LK093;    Landkreise Oberpfalz;67 bis unter 68;10440;5175;5265
LK093;    Landkreise Oberpfalz;68 bis unter 69;10289;5181;5108
LK093;    Landkreise Oberpfalz;69 bis unter 70;9543;4756;4787
LK093;    Landkreise Oberpfalz;70 bis unter 71;8747;4435;4312
LK093;    Landkreise Oberpfalz;71 bis unter 72;8050;3952;4098
LK093;    Landkreise Oberpfalz;72 bis unter 73;6990;3317;3673
LK093;    Landkreise Oberpfalz;73 bis unter 74;5225;2501;2724
LK093;    Landkreise Oberpfalz;74 bis unter 75;6671;3165;3506
LK093;    Landkreise Oberpfalz;75 bis unter 76;6584;3102;3482
LK093;    Landkreise Oberpfalz;76 bis unter 77;6313;2959;3354
LK093;    Landkreise Oberpfalz;77 bis unter 78;7953;3635;4318
LK093;    Landkreise Oberpfalz;78 bis unter 79;8686;3899;4787
LK093;    Landkreise Oberpfalz;79 bis unter 80;8574;3751;4823
LK093;    Landkreise Oberpfalz;80 bis unter 81;7436;3136;4300
LK093;    Landkreise Oberpfalz;81 bis unter 82;6422;2737;3685
LK093;    Landkreise Oberpfalz;82 bis unter 83;5874;2407;3467
LK093;    Landkreise Oberpfalz;83 bis unter 84;5188;2069;3119
LK093;    Landkreise Oberpfalz;84 bis unter 85;4688;1827;2861
LK093;    Landkreise Oberpfalz;85 bis unter 90;15091;5195;9896
LK093;    Landkreise Oberpfalz;90 bis unter 95;5956;1622;4334
LK093;    Landkreise Oberpfalz;95 oder älter;1276;286;990
LK093;    Landkreise Oberpfalz;Insgesamt;872169;437521;434648
093;  Oberpfalz;unter 1;10551;5322;5229
093;  Oberpfalz;1 bis unter 2;10145;5209;4936
093;  Oberpfalz;2 bis unter 3;10132;5202;4930
093;  Oberpfalz;3 bis unter 4;9931;5111;4820
093;  Oberpfalz;4 bis unter 5;9748;5044;4704
093;  Oberpfalz;5 bis unter 6;9532;4832;4700
093;  Oberpfalz;6 bis unter 7;9440;4789;4651
093;  Oberpfalz;7 bis unter 8;9141;4702;4439
093;  Oberpfalz;8 bis unter 9;9469;4870;4599
093;  Oberpfalz;9 bis unter 10;9272;4722;4550
093;  Oberpfalz;10 bis unter 11;9496;4884;4612
093;  Oberpfalz;11 bis unter 12;9483;4879;4604
093;  Oberpfalz;12 bis unter 13;9508;4880;4628
093;  Oberpfalz;13 bis unter 14;9659;5026;4633
093;  Oberpfalz;14 bis unter 15;9885;5059;4826
093;  Oberpfalz;15 bis unter 16;10069;5080;4989
093;  Oberpfalz;16 bis unter 17;10245;5254;4991
093;  Oberpfalz;17 bis unter 18;11060;5714;5346
093;  Oberpfalz;18 bis unter 19;11468;5910;5558
093;  Oberpfalz;19 bis unter 20;12306;6625;5681
093;  Oberpfalz;20 bis unter 21;12962;6761;6201
093;  Oberpfalz;21 bis unter 22;13435;7057;6378
093;  Oberpfalz;22 bis unter 23;13539;6984;6555
093;  Oberpfalz;23 bis unter 24;13338;6996;6342
093;  Oberpfalz;24 bis unter 25;13631;7166;6465
093;  Oberpfalz;25 bis unter 26;14139;7458;6681
093;  Oberpfalz;26 bis unter 27;14441;7595;6846
093;  Oberpfalz;27 bis unter 28;14649;7704;6945
093;  Oberpfalz;28 bis unter 29;15609;8363;7246
093;  Oberpfalz;29 bis unter 30;14708;7703;7005
093;  Oberpfalz;30 bis unter 31;15092;7930;7162
093;  Oberpfalz;31 bis unter 32;14364;7557;6807
093;  Oberpfalz;32 bis unter 33;14407;7574;6833
093;  Oberpfalz;33 bis unter 34;13760;7200;6560
093;  Oberpfalz;34 bis unter 35;13662;7078;6584
093;  Oberpfalz;35 bis unter 36;13808;7229;6579
093;  Oberpfalz;36 bis unter 37;14086;7170;6916
093;  Oberpfalz;37 bis unter 38;14053;7222;6831
093;  Oberpfalz;38 bis unter 39;13983;7062;6921
093;  Oberpfalz;39 bis unter 40;13412;6788;6624
093;  Oberpfalz;40 bis unter 41;13180;6750;6430
093;  Oberpfalz;41 bis unter 42;13296;6751;6545
093;  Oberpfalz;42 bis unter 43;12798;6466;6332
093;  Oberpfalz;43 bis unter 44;12929;6635;6294
093;  Oberpfalz;44 bis unter 45;13193;6571;6622
093;  Oberpfalz;45 bis unter 46;13369;6768;6601
093;  Oberpfalz;46 bis unter 47;14620;7383;7237
093;  Oberpfalz;47 bis unter 48;15779;7964;7815
093;  Oberpfalz;48 bis unter 49;16345;8236;8109
093;  Oberpfalz;49 bis unter 50;17601;8952;8649
093;  Oberpfalz;50 bis unter 51;18016;9213;8803
093;  Oberpfalz;51 bis unter 52;18398;9358;9040
093;  Oberpfalz;52 bis unter 53;18974;9624;9350
093;  Oberpfalz;53 bis unter 54;18769;9597;9172
093;  Oberpfalz;54 bis unter 55;19487;9864;9623
093;  Oberpfalz;55 bis unter 56;19182;9577;9605
093;  Oberpfalz;56 bis unter 57;18766;9456;9310
093;  Oberpfalz;57 bis unter 58;18400;9379;9021
093;  Oberpfalz;58 bis unter 59;17832;9070;8762
093;  Oberpfalz;59 bis unter 60;17240;8688;8552
093;  Oberpfalz;60 bis unter 61;16346;8282;8064
093;  Oberpfalz;61 bis unter 62;15937;8036;7901
093;  Oberpfalz;62 bis unter 63;15074;7463;7611
093;  Oberpfalz;63 bis unter 64;14244;7064;7180
093;  Oberpfalz;64 bis unter 65;14047;6991;7056
093;  Oberpfalz;65 bis unter 66;13491;6622;6869
093;  Oberpfalz;66 bis unter 67;13357;6602;6755
093;  Oberpfalz;67 bis unter 68;12861;6304;6557
093;  Oberpfalz;68 bis unter 69;12606;6258;6348
093;  Oberpfalz;69 bis unter 70;11728;5764;5964
093;  Oberpfalz;70 bis unter 71;10913;5412;5501
093;  Oberpfalz;71 bis unter 72;10088;4872;5216
093;  Oberpfalz;72 bis unter 73;8933;4160;4773
093;  Oberpfalz;73 bis unter 74;6688;3141;3547
093;  Oberpfalz;74 bis unter 75;8598;4033;4565
093;  Oberpfalz;75 bis unter 76;8397;3887;4510
093;  Oberpfalz;76 bis unter 77;8094;3751;4343
093;  Oberpfalz;77 bis unter 78;10135;4565;5570
093;  Oberpfalz;78 bis unter 79;10956;4822;6134
093;  Oberpfalz;79 bis unter 80;10800;4648;6152
093;  Oberpfalz;80 bis unter 81;9354;3881;5473
093;  Oberpfalz;81 bis unter 82;8151;3438;4713
093;  Oberpfalz;82 bis unter 83;7427;3026;4401
093;  Oberpfalz;83 bis unter 84;6597;2581;4016
093;  Oberpfalz;84 bis unter 85;5923;2300;3623
093;  Oberpfalz;85 bis unter 90;19082;6529;12553
093;  Oberpfalz;90 bis unter 95;7871;2146;5725
093;  Oberpfalz;95 oder älter;1779;370;1409
093;  Oberpfalz;Insgesamt;1109269;552961;556308
09461;      Bamberg (Krfr.St);unter 1;845;448;397
09461;      Bamberg (Krfr.St);1 bis unter 2;815;417;398
09461;      Bamberg (Krfr.St);2 bis unter 3;720;383;337
09461;      Bamberg (Krfr.St);3 bis unter 4;680;345;335
09461;      Bamberg (Krfr.St);4 bis unter 5;624;317;307
09461;      Bamberg (Krfr.St);5 bis unter 6;656;331;325
09461;      Bamberg (Krfr.St);6 bis unter 7;660;353;307
09461;      Bamberg (Krfr.St);7 bis unter 8;551;297;254
09461;      Bamberg (Krfr.St);8 bis unter 9;580;284;296
09461;      Bamberg (Krfr.St);9 bis unter 10;568;293;275
09461;      Bamberg (Krfr.St);10 bis unter 11;574;287;287
09461;      Bamberg (Krfr.St);11 bis unter 12;596;295;301
09461;      Bamberg (Krfr.St);12 bis unter 13;560;279;281
09461;      Bamberg (Krfr.St);13 bis unter 14;533;268;265
09461;      Bamberg (Krfr.St);14 bis unter 15;573;296;277
09461;      Bamberg (Krfr.St);15 bis unter 16;570;295;275
09461;      Bamberg (Krfr.St);16 bis unter 17;566;289;277
09461;      Bamberg (Krfr.St);17 bis unter 18;582;314;268
09461;      Bamberg (Krfr.St);18 bis unter 19;678;332;346
09461;      Bamberg (Krfr.St);19 bis unter 20;854;440;414
09461;      Bamberg (Krfr.St);20 bis unter 21;1058;501;557
09461;      Bamberg (Krfr.St);21 bis unter 22;1202;538;664
09461;      Bamberg (Krfr.St);22 bis unter 23;1234;570;664
09461;      Bamberg (Krfr.St);23 bis unter 24;1281;578;703
09461;      Bamberg (Krfr.St);24 bis unter 25;1447;663;784
09461;      Bamberg (Krfr.St);25 bis unter 26;1478;723;755
09461;      Bamberg (Krfr.St);26 bis unter 27;1504;727;777
09461;      Bamberg (Krfr.St);27 bis unter 28;1559;782;777
09461;      Bamberg (Krfr.St);28 bis unter 29;1578;804;774
09461;      Bamberg (Krfr.St);29 bis unter 30;1650;809;841
09461;      Bamberg (Krfr.St);30 bis unter 31;1533;810;723
09461;      Bamberg (Krfr.St);31 bis unter 32;1518;811;707
09461;      Bamberg (Krfr.St);32 bis unter 33;1398;751;647
09461;      Bamberg (Krfr.St);33 bis unter 34;1230;670;560
09461;      Bamberg (Krfr.St);34 bis unter 35;1140;610;530
09461;      Bamberg (Krfr.St);35 bis unter 36;1081;587;494
09461;      Bamberg (Krfr.St);36 bis unter 37;1112;600;512
09461;      Bamberg (Krfr.St);37 bis unter 38;998;511;487
09461;      Bamberg (Krfr.St);38 bis unter 39;922;442;480
09461;      Bamberg (Krfr.St);39 bis unter 40;918;447;471
09461;      Bamberg (Krfr.St);40 bis unter 41;859;443;416
09461;      Bamberg (Krfr.St);41 bis unter 42;854;444;410
09461;      Bamberg (Krfr.St);42 bis unter 43;866;432;434
09461;      Bamberg (Krfr.St);43 bis unter 44;822;412;410
09461;      Bamberg (Krfr.St);44 bis unter 45;758;392;366
09461;      Bamberg (Krfr.St);45 bis unter 46;790;365;425
09461;      Bamberg (Krfr.St);46 bis unter 47;871;404;467
09461;      Bamberg (Krfr.St);47 bis unter 48;1010;509;501
09461;      Bamberg (Krfr.St);48 bis unter 49;992;495;497
09461;      Bamberg (Krfr.St);49 bis unter 50;1061;554;507
09461;      Bamberg (Krfr.St);50 bis unter 51;1113;546;567
09461;      Bamberg (Krfr.St);51 bis unter 52;1099;560;539
09461;      Bamberg (Krfr.St);52 bis unter 53;1032;507;525
09461;      Bamberg (Krfr.St);53 bis unter 54;1104;545;559
09461;      Bamberg (Krfr.St);54 bis unter 55;1151;529;622
09461;      Bamberg (Krfr.St);55 bis unter 56;1138;585;553
09461;      Bamberg (Krfr.St);56 bis unter 57;1091;523;568
09461;      Bamberg (Krfr.St);57 bis unter 58;1098;557;541
09461;      Bamberg (Krfr.St);58 bis unter 59;1034;492;542
09461;      Bamberg (Krfr.St);59 bis unter 60;987;494;493
09461;      Bamberg (Krfr.St);60 bis unter 61;967;433;534
09461;      Bamberg (Krfr.St);61 bis unter 62;897;426;471
09461;      Bamberg (Krfr.St);62 bis unter 63;906;431;475
09461;      Bamberg (Krfr.St);63 bis unter 64;824;407;417
09461;      Bamberg (Krfr.St);64 bis unter 65;795;378;417
09461;      Bamberg (Krfr.St);65 bis unter 66;748;338;410
09461;      Bamberg (Krfr.St);66 bis unter 67;709;330;379
09461;      Bamberg (Krfr.St);67 bis unter 68;715;342;373
09461;      Bamberg (Krfr.St);68 bis unter 69;728;329;399
09461;      Bamberg (Krfr.St);69 bis unter 70;699;308;391
09461;      Bamberg (Krfr.St);70 bis unter 71;701;332;369
09461;      Bamberg (Krfr.St);71 bis unter 72;682;295;387
09461;      Bamberg (Krfr.St);72 bis unter 73;594;263;331
09461;      Bamberg (Krfr.St);73 bis unter 74;458;210;248
09461;      Bamberg (Krfr.St);74 bis unter 75;609;266;343
09461;      Bamberg (Krfr.St);75 bis unter 76;635;288;347
09461;      Bamberg (Krfr.St);76 bis unter 77;601;262;339
09461;      Bamberg (Krfr.St);77 bis unter 78;716;285;431
09461;      Bamberg (Krfr.St);78 bis unter 79;738;315;423
09461;      Bamberg (Krfr.St);79 bis unter 80;717;287;430
09461;      Bamberg (Krfr.St);80 bis unter 81;589;238;351
09461;      Bamberg (Krfr.St);81 bis unter 82;565;220;345
09461;      Bamberg (Krfr.St);82 bis unter 83;520;198;322
09461;      Bamberg (Krfr.St);83 bis unter 84;458;181;277
09461;      Bamberg (Krfr.St);84 bis unter 85;442;156;286
09461;      Bamberg (Krfr.St);85 bis unter 90;1408;469;939
09461;      Bamberg (Krfr.St);90 bis unter 95;656;171;485
09461;      Bamberg (Krfr.St);95 oder älter;159;21;138
09461;      Bamberg (Krfr.St);Insgesamt;77592;37464;40128
09462;      Bayreuth (Krfr.St);unter 1;587;296;291
09462;      Bayreuth (Krfr.St);1 bis unter 2;620;304;316
09462;      Bayreuth (Krfr.St);2 bis unter 3;570;311;259
09462;      Bayreuth (Krfr.St);3 bis unter 4;541;285;256
09462;      Bayreuth (Krfr.St);4 bis unter 5;530;282;248
09462;      Bayreuth (Krfr.St);5 bis unter 6;473;238;235
09462;      Bayreuth (Krfr.St);6 bis unter 7;497;252;245
09462;      Bayreuth (Krfr.St);7 bis unter 8;474;219;255
09462;      Bayreuth (Krfr.St);8 bis unter 9;515;256;259
09462;      Bayreuth (Krfr.St);9 bis unter 10;480;253;227
09462;      Bayreuth (Krfr.St);10 bis unter 11;538;274;264
09462;      Bayreuth (Krfr.St);11 bis unter 12;534;284;250
09462;      Bayreuth (Krfr.St);12 bis unter 13;516;256;260
09462;      Bayreuth (Krfr.St);13 bis unter 14;568;292;276
09462;      Bayreuth (Krfr.St);14 bis unter 15;513;274;239
09462;      Bayreuth (Krfr.St);15 bis unter 16;534;274;260
09462;      Bayreuth (Krfr.St);16 bis unter 17;548;279;269
09462;      Bayreuth (Krfr.St);17 bis unter 18;532;276;256
09462;      Bayreuth (Krfr.St);18 bis unter 19;857;459;398
09462;      Bayreuth (Krfr.St);19 bis unter 20;1210;636;574
09462;      Bayreuth (Krfr.St);20 bis unter 21;1619;848;771
09462;      Bayreuth (Krfr.St);21 bis unter 22;1651;823;828
09462;      Bayreuth (Krfr.St);22 bis unter 23;1737;864;873
09462;      Bayreuth (Krfr.St);23 bis unter 24;1695;887;808
09462;      Bayreuth (Krfr.St);24 bis unter 25;1612;833;779
09462;      Bayreuth (Krfr.St);25 bis unter 26;1537;816;721
09462;      Bayreuth (Krfr.St);26 bis unter 27;1453;793;660
09462;      Bayreuth (Krfr.St);27 bis unter 28;1354;732;622
09462;      Bayreuth (Krfr.St);28 bis unter 29;1311;712;599
09462;      Bayreuth (Krfr.St);29 bis unter 30;1108;572;536
09462;      Bayreuth (Krfr.St);30 bis unter 31;1188;649;539
09462;      Bayreuth (Krfr.St);31 bis unter 32;1004;529;475
09462;      Bayreuth (Krfr.St);32 bis unter 33;996;525;471
09462;      Bayreuth (Krfr.St);33 bis unter 34;908;459;449
09462;      Bayreuth (Krfr.St);34 bis unter 35;852;467;385
09462;      Bayreuth (Krfr.St);35 bis unter 36;858;441;417
09462;      Bayreuth (Krfr.St);36 bis unter 37;876;466;410
09462;      Bayreuth (Krfr.St);37 bis unter 38;833;447;386
09462;      Bayreuth (Krfr.St);38 bis unter 39;828;414;414
09462;      Bayreuth (Krfr.St);39 bis unter 40;819;456;363
09462;      Bayreuth (Krfr.St);40 bis unter 41;756;397;359
09462;      Bayreuth (Krfr.St);41 bis unter 42;801;381;420
09462;      Bayreuth (Krfr.St);42 bis unter 43;752;379;373
09462;      Bayreuth (Krfr.St);43 bis unter 44;810;415;395
09462;      Bayreuth (Krfr.St);44 bis unter 45;751;368;383
09462;      Bayreuth (Krfr.St);45 bis unter 46;799;402;397
09462;      Bayreuth (Krfr.St);46 bis unter 47;819;408;411
09462;      Bayreuth (Krfr.St);47 bis unter 48;845;406;439
09462;      Bayreuth (Krfr.St);48 bis unter 49;888;433;455
09462;      Bayreuth (Krfr.St);49 bis unter 50;968;493;475
09462;      Bayreuth (Krfr.St);50 bis unter 51;1048;506;542
09462;      Bayreuth (Krfr.St);51 bis unter 52;1009;519;490
09462;      Bayreuth (Krfr.St);52 bis unter 53;1035;516;519
09462;      Bayreuth (Krfr.St);53 bis unter 54;1041;521;520
09462;      Bayreuth (Krfr.St);54 bis unter 55;1011;489;522
09462;      Bayreuth (Krfr.St);55 bis unter 56;1110;533;577
09462;      Bayreuth (Krfr.St);56 bis unter 57;987;475;512
09462;      Bayreuth (Krfr.St);57 bis unter 58;981;486;495
09462;      Bayreuth (Krfr.St);58 bis unter 59;974;469;505
09462;      Bayreuth (Krfr.St);59 bis unter 60;986;456;530
09462;      Bayreuth (Krfr.St);60 bis unter 61;951;466;485
09462;      Bayreuth (Krfr.St);61 bis unter 62;886;408;478
09462;      Bayreuth (Krfr.St);62 bis unter 63;864;399;465
09462;      Bayreuth (Krfr.St);63 bis unter 64;850;373;477
09462;      Bayreuth (Krfr.St);64 bis unter 65;862;389;473
09462;      Bayreuth (Krfr.St);65 bis unter 66;825;379;446
09462;      Bayreuth (Krfr.St);66 bis unter 67;846;378;468
09462;      Bayreuth (Krfr.St);67 bis unter 68;758;329;429
09462;      Bayreuth (Krfr.St);68 bis unter 69;858;403;455
09462;      Bayreuth (Krfr.St);69 bis unter 70;762;347;415
09462;      Bayreuth (Krfr.St);70 bis unter 71;825;363;462
09462;      Bayreuth (Krfr.St);71 bis unter 72;776;350;426
09462;      Bayreuth (Krfr.St);72 bis unter 73;657;309;348
09462;      Bayreuth (Krfr.St);73 bis unter 74;483;223;260
09462;      Bayreuth (Krfr.St);74 bis unter 75;683;314;369
09462;      Bayreuth (Krfr.St);75 bis unter 76;652;288;364
09462;      Bayreuth (Krfr.St);76 bis unter 77;615;279;336
09462;      Bayreuth (Krfr.St);77 bis unter 78;785;343;442
09462;      Bayreuth (Krfr.St);78 bis unter 79;834;357;477
09462;      Bayreuth (Krfr.St);79 bis unter 80;735;286;449
09462;      Bayreuth (Krfr.St);80 bis unter 81;708;292;416
09462;      Bayreuth (Krfr.St);81 bis unter 82;580;243;337
09462;      Bayreuth (Krfr.St);82 bis unter 83;525;216;309
09462;      Bayreuth (Krfr.St);83 bis unter 84;482;173;309
09462;      Bayreuth (Krfr.St);84 bis unter 85;410;132;278
09462;      Bayreuth (Krfr.St);85 bis unter 90;1298;445;853
09462;      Bayreuth (Krfr.St);90 bis unter 95;679;177;502
09462;      Bayreuth (Krfr.St);95 oder älter;221;23;198
09462;      Bayreuth (Krfr.St);Insgesamt;74657;36469;38188
09463;      Coburg (Krfr.St);unter 1;380;210;170
09463;      Coburg (Krfr.St);1 bis unter 2;348;168;180
09463;      Coburg (Krfr.St);2 bis unter 3;326;162;164
09463;      Coburg (Krfr.St);3 bis unter 4;324;166;158
09463;      Coburg (Krfr.St);4 bis unter 5;336;167;169
09463;      Coburg (Krfr.St);5 bis unter 6;275;133;142
09463;      Coburg (Krfr.St);6 bis unter 7;311;150;161
09463;      Coburg (Krfr.St);7 bis unter 8;318;170;148
09463;      Coburg (Krfr.St);8 bis unter 9;271;144;127
09463;      Coburg (Krfr.St);9 bis unter 10;334;151;183
09463;      Coburg (Krfr.St);10 bis unter 11;324;170;154
09463;      Coburg (Krfr.St);11 bis unter 12;345;167;178
09463;      Coburg (Krfr.St);12 bis unter 13;322;160;162
09463;      Coburg (Krfr.St);13 bis unter 14;314;166;148
09463;      Coburg (Krfr.St);14 bis unter 15;297;165;132
09463;      Coburg (Krfr.St);15 bis unter 16;326;164;162
09463;      Coburg (Krfr.St);16 bis unter 17;323;179;144
09463;      Coburg (Krfr.St);17 bis unter 18;346;182;164
09463;      Coburg (Krfr.St);18 bis unter 19;429;215;214
09463;      Coburg (Krfr.St);19 bis unter 20;435;229;206
09463;      Coburg (Krfr.St);20 bis unter 21;529;284;245
09463;      Coburg (Krfr.St);21 bis unter 22;534;311;223
09463;      Coburg (Krfr.St);22 bis unter 23;537;273;264
09463;      Coburg (Krfr.St);23 bis unter 24;538;303;235
09463;      Coburg (Krfr.St);24 bis unter 25;529;266;263
09463;      Coburg (Krfr.St);25 bis unter 26;536;281;255
09463;      Coburg (Krfr.St);26 bis unter 27;587;327;260
09463;      Coburg (Krfr.St);27 bis unter 28;625;326;299
09463;      Coburg (Krfr.St);28 bis unter 29;639;349;290
09463;      Coburg (Krfr.St);29 bis unter 30;598;324;274
09463;      Coburg (Krfr.St);30 bis unter 31;617;339;278
09463;      Coburg (Krfr.St);31 bis unter 32;593;322;271
09463;      Coburg (Krfr.St);32 bis unter 33;559;315;244
09463;      Coburg (Krfr.St);33 bis unter 34;567;313;254
09463;      Coburg (Krfr.St);34 bis unter 35;526;290;236
09463;      Coburg (Krfr.St);35 bis unter 36;511;257;254
09463;      Coburg (Krfr.St);36 bis unter 37;533;300;233
09463;      Coburg (Krfr.St);37 bis unter 38;464;272;192
09463;      Coburg (Krfr.St);38 bis unter 39;453;228;225
09463;      Coburg (Krfr.St);39 bis unter 40;439;210;229
09463;      Coburg (Krfr.St);40 bis unter 41;450;208;242
09463;      Coburg (Krfr.St);41 bis unter 42;419;190;229
09463;      Coburg (Krfr.St);42 bis unter 43;378;184;194
09463;      Coburg (Krfr.St);43 bis unter 44;410;226;184
09463;      Coburg (Krfr.St);44 bis unter 45;417;192;225
09463;      Coburg (Krfr.St);45 bis unter 46;455;229;226
09463;      Coburg (Krfr.St);46 bis unter 47;422;190;232
09463;      Coburg (Krfr.St);47 bis unter 48;504;240;264
09463;      Coburg (Krfr.St);48 bis unter 49;610;288;322
09463;      Coburg (Krfr.St);49 bis unter 50;596;278;318
09463;      Coburg (Krfr.St);50 bis unter 51;650;348;302
09463;      Coburg (Krfr.St);51 bis unter 52;633;310;323
09463;      Coburg (Krfr.St);52 bis unter 53;636;327;309
09463;      Coburg (Krfr.St);53 bis unter 54;608;296;312
09463;      Coburg (Krfr.St);54 bis unter 55;717;356;361
09463;      Coburg (Krfr.St);55 bis unter 56;681;337;344
09463;      Coburg (Krfr.St);56 bis unter 57;640;331;309
09463;      Coburg (Krfr.St);57 bis unter 58;647;305;342
09463;      Coburg (Krfr.St);58 bis unter 59;663;332;331
09463;      Coburg (Krfr.St);59 bis unter 60;627;285;342
09463;      Coburg (Krfr.St);60 bis unter 61;585;269;316
09463;      Coburg (Krfr.St);61 bis unter 62;628;314;314
09463;      Coburg (Krfr.St);62 bis unter 63;551;242;309
09463;      Coburg (Krfr.St);63 bis unter 64;542;251;291
09463;      Coburg (Krfr.St);64 bis unter 65;499;237;262
09463;      Coburg (Krfr.St);65 bis unter 66;476;226;250
09463;      Coburg (Krfr.St);66 bis unter 67;489;222;267
09463;      Coburg (Krfr.St);67 bis unter 68;492;224;268
09463;      Coburg (Krfr.St);68 bis unter 69;466;214;252
09463;      Coburg (Krfr.St);69 bis unter 70;474;217;257
09463;      Coburg (Krfr.St);70 bis unter 71;467;216;251
09463;      Coburg (Krfr.St);71 bis unter 72;430;183;247
09463;      Coburg (Krfr.St);72 bis unter 73;354;174;180
09463;      Coburg (Krfr.St);73 bis unter 74;298;129;169
09463;      Coburg (Krfr.St);74 bis unter 75;431;205;226
09463;      Coburg (Krfr.St);75 bis unter 76;410;195;215
09463;      Coburg (Krfr.St);76 bis unter 77;348;161;187
09463;      Coburg (Krfr.St);77 bis unter 78;428;179;249
09463;      Coburg (Krfr.St);78 bis unter 79;478;214;264
09463;      Coburg (Krfr.St);79 bis unter 80;462;192;270
09463;      Coburg (Krfr.St);80 bis unter 81;422;179;243
09463;      Coburg (Krfr.St);81 bis unter 82;381;163;218
09463;      Coburg (Krfr.St);82 bis unter 83;303;121;182
09463;      Coburg (Krfr.St);83 bis unter 84;328;125;203
09463;      Coburg (Krfr.St);84 bis unter 85;280;100;180
09463;      Coburg (Krfr.St);85 bis unter 90;889;313;576
09463;      Coburg (Krfr.St);90 bis unter 95;450;116;334
09463;      Coburg (Krfr.St);95 oder älter;127;21;106
09463;      Coburg (Krfr.St);Insgesamt;41249;20162;21087
09464;      Hof (Krfr.St);unter 1;417;226;191
09464;      Hof (Krfr.St);1 bis unter 2;477;227;250
09464;      Hof (Krfr.St);2 bis unter 3;438;235;203
09464;      Hof (Krfr.St);3 bis unter 4;455;225;230
09464;      Hof (Krfr.St);4 bis unter 5;418;208;210
09464;      Hof (Krfr.St);5 bis unter 6;408;215;193
09464;      Hof (Krfr.St);6 bis unter 7;397;201;196
09464;      Hof (Krfr.St);7 bis unter 8;390;192;198
09464;      Hof (Krfr.St);8 bis unter 9;393;197;196
09464;      Hof (Krfr.St);9 bis unter 10;347;194;153
09464;      Hof (Krfr.St);10 bis unter 11;368;180;188
09464;      Hof (Krfr.St);11 bis unter 12;372;183;189
09464;      Hof (Krfr.St);12 bis unter 13;344;169;175
09464;      Hof (Krfr.St);13 bis unter 14;378;190;188
09464;      Hof (Krfr.St);14 bis unter 15;365;165;200
09464;      Hof (Krfr.St);15 bis unter 16;355;193;162
09464;      Hof (Krfr.St);16 bis unter 17;439;231;208
09464;      Hof (Krfr.St);17 bis unter 18;435;232;203
09464;      Hof (Krfr.St);18 bis unter 19;525;272;253
09464;      Hof (Krfr.St);19 bis unter 20;453;247;206
09464;      Hof (Krfr.St);20 bis unter 21;559;297;262
09464;      Hof (Krfr.St);21 bis unter 22;544;277;267
09464;      Hof (Krfr.St);22 bis unter 23;560;307;253
09464;      Hof (Krfr.St);23 bis unter 24;572;308;264
09464;      Hof (Krfr.St);24 bis unter 25;566;311;255
09464;      Hof (Krfr.St);25 bis unter 26;581;297;284
09464;      Hof (Krfr.St);26 bis unter 27;601;322;279
09464;      Hof (Krfr.St);27 bis unter 28;570;290;280
09464;      Hof (Krfr.St);28 bis unter 29;606;305;301
09464;      Hof (Krfr.St);29 bis unter 30;650;330;320
09464;      Hof (Krfr.St);30 bis unter 31;604;332;272
09464;      Hof (Krfr.St);31 bis unter 32;567;303;264
09464;      Hof (Krfr.St);32 bis unter 33;588;286;302
09464;      Hof (Krfr.St);33 bis unter 34;517;270;247
09464;      Hof (Krfr.St);34 bis unter 35;524;271;253
09464;      Hof (Krfr.St);35 bis unter 36;519;273;246
09464;      Hof (Krfr.St);36 bis unter 37;513;270;243
09464;      Hof (Krfr.St);37 bis unter 38;502;251;251
09464;      Hof (Krfr.St);38 bis unter 39;541;263;278
09464;      Hof (Krfr.St);39 bis unter 40;526;262;264
09464;      Hof (Krfr.St);40 bis unter 41;500;239;261
09464;      Hof (Krfr.St);41 bis unter 42;466;229;237
09464;      Hof (Krfr.St);42 bis unter 43;480;247;233
09464;      Hof (Krfr.St);43 bis unter 44;469;224;245
09464;      Hof (Krfr.St);44 bis unter 45;502;260;242
09464;      Hof (Krfr.St);45 bis unter 46;493;235;258
09464;      Hof (Krfr.St);46 bis unter 47;541;262;279
09464;      Hof (Krfr.St);47 bis unter 48;606;304;302
09464;      Hof (Krfr.St);48 bis unter 49;659;335;324
09464;      Hof (Krfr.St);49 bis unter 50;667;322;345
09464;      Hof (Krfr.St);50 bis unter 51;695;339;356
09464;      Hof (Krfr.St);51 bis unter 52;690;345;345
09464;      Hof (Krfr.St);52 bis unter 53;733;358;375
09464;      Hof (Krfr.St);53 bis unter 54;714;362;352
09464;      Hof (Krfr.St);54 bis unter 55;740;376;364
09464;      Hof (Krfr.St);55 bis unter 56;724;340;384
09464;      Hof (Krfr.St);56 bis unter 57;678;357;321
09464;      Hof (Krfr.St);57 bis unter 58;700;328;372
09464;      Hof (Krfr.St);58 bis unter 59;687;367;320
09464;      Hof (Krfr.St);59 bis unter 60;662;326;336
09464;      Hof (Krfr.St);60 bis unter 61;639;310;329
09464;      Hof (Krfr.St);61 bis unter 62;645;305;340
09464;      Hof (Krfr.St);62 bis unter 63;617;302;315
09464;      Hof (Krfr.St);63 bis unter 64;617;292;325
09464;      Hof (Krfr.St);64 bis unter 65;621;297;324
09464;      Hof (Krfr.St);65 bis unter 66;555;258;297
09464;      Hof (Krfr.St);66 bis unter 67;544;227;317
09464;      Hof (Krfr.St);67 bis unter 68;593;236;357
09464;      Hof (Krfr.St);68 bis unter 69;522;242;280
09464;      Hof (Krfr.St);69 bis unter 70;548;247;301
09464;      Hof (Krfr.St);70 bis unter 71;539;220;319
09464;      Hof (Krfr.St);71 bis unter 72;587;282;305
09464;      Hof (Krfr.St);72 bis unter 73;447;196;251
09464;      Hof (Krfr.St);73 bis unter 74;376;173;203
09464;      Hof (Krfr.St);74 bis unter 75;462;202;260
09464;      Hof (Krfr.St);75 bis unter 76;452;209;243
09464;      Hof (Krfr.St);76 bis unter 77;422;188;234
09464;      Hof (Krfr.St);77 bis unter 78;510;211;299
09464;      Hof (Krfr.St);78 bis unter 79;525;206;319
09464;      Hof (Krfr.St);79 bis unter 80;552;224;328
09464;      Hof (Krfr.St);80 bis unter 81;432;186;246
09464;      Hof (Krfr.St);81 bis unter 82;397;148;249
09464;      Hof (Krfr.St);82 bis unter 83;361;139;222
09464;      Hof (Krfr.St);83 bis unter 84;362;125;237
09464;      Hof (Krfr.St);84 bis unter 85;315;103;212
09464;      Hof (Krfr.St);85 bis unter 90;946;285;661
09464;      Hof (Krfr.St);90 bis unter 95;458;110;348
09464;      Hof (Krfr.St);95 oder älter;96;13;83
09464;      Hof (Krfr.St);Insgesamt;45930;22098;23832
KS094;    Kreisfreie Städte Oberfranken;unter 1;2229;1180;1049
KS094;    Kreisfreie Städte Oberfranken;1 bis unter 2;2260;1116;1144
KS094;    Kreisfreie Städte Oberfranken;2 bis unter 3;2054;1091;963
KS094;    Kreisfreie Städte Oberfranken;3 bis unter 4;2000;1021;979
KS094;    Kreisfreie Städte Oberfranken;4 bis unter 5;1908;974;934
KS094;    Kreisfreie Städte Oberfranken;5 bis unter 6;1812;917;895
KS094;    Kreisfreie Städte Oberfranken;6 bis unter 7;1865;956;909
KS094;    Kreisfreie Städte Oberfranken;7 bis unter 8;1733;878;855
KS094;    Kreisfreie Städte Oberfranken;8 bis unter 9;1759;881;878
KS094;    Kreisfreie Städte Oberfranken;9 bis unter 10;1729;891;838
KS094;    Kreisfreie Städte Oberfranken;10 bis unter 11;1804;911;893
KS094;    Kreisfreie Städte Oberfranken;11 bis unter 12;1847;929;918
KS094;    Kreisfreie Städte Oberfranken;12 bis unter 13;1742;864;878
KS094;    Kreisfreie Städte Oberfranken;13 bis unter 14;1793;916;877
KS094;    Kreisfreie Städte Oberfranken;14 bis unter 15;1748;900;848
KS094;    Kreisfreie Städte Oberfranken;15 bis unter 16;1785;926;859
KS094;    Kreisfreie Städte Oberfranken;16 bis unter 17;1876;978;898
KS094;    Kreisfreie Städte Oberfranken;17 bis unter 18;1895;1004;891
KS094;    Kreisfreie Städte Oberfranken;18 bis unter 19;2489;1278;1211
KS094;    Kreisfreie Städte Oberfranken;19 bis unter 20;2952;1552;1400
KS094;    Kreisfreie Städte Oberfranken;20 bis unter 21;3765;1930;1835
KS094;    Kreisfreie Städte Oberfranken;21 bis unter 22;3931;1949;1982
KS094;    Kreisfreie Städte Oberfranken;22 bis unter 23;4068;2014;2054
KS094;    Kreisfreie Städte Oberfranken;23 bis unter 24;4086;2076;2010
KS094;    Kreisfreie Städte Oberfranken;24 bis unter 25;4154;2073;2081
KS094;    Kreisfreie Städte Oberfranken;25 bis unter 26;4132;2117;2015
KS094;    Kreisfreie Städte Oberfranken;26 bis unter 27;4145;2169;1976
KS094;    Kreisfreie Städte Oberfranken;27 bis unter 28;4108;2130;1978
KS094;    Kreisfreie Städte Oberfranken;28 bis unter 29;4134;2170;1964
KS094;    Kreisfreie Städte Oberfranken;29 bis unter 30;4006;2035;1971
KS094;    Kreisfreie Städte Oberfranken;30 bis unter 31;3942;2130;1812
KS094;    Kreisfreie Städte Oberfranken;31 bis unter 32;3682;1965;1717
KS094;    Kreisfreie Städte Oberfranken;32 bis unter 33;3541;1877;1664
KS094;    Kreisfreie Städte Oberfranken;33 bis unter 34;3222;1712;1510
KS094;    Kreisfreie Städte Oberfranken;34 bis unter 35;3042;1638;1404
KS094;    Kreisfreie Städte Oberfranken;35 bis unter 36;2969;1558;1411
KS094;    Kreisfreie Städte Oberfranken;36 bis unter 37;3034;1636;1398
KS094;    Kreisfreie Städte Oberfranken;37 bis unter 38;2797;1481;1316
KS094;    Kreisfreie Städte Oberfranken;38 bis unter 39;2744;1347;1397
KS094;    Kreisfreie Städte Oberfranken;39 bis unter 40;2702;1375;1327
KS094;    Kreisfreie Städte Oberfranken;40 bis unter 41;2565;1287;1278
KS094;    Kreisfreie Städte Oberfranken;41 bis unter 42;2540;1244;1296
KS094;    Kreisfreie Städte Oberfranken;42 bis unter 43;2476;1242;1234
KS094;    Kreisfreie Städte Oberfranken;43 bis unter 44;2511;1277;1234
KS094;    Kreisfreie Städte Oberfranken;44 bis unter 45;2428;1212;1216
KS094;    Kreisfreie Städte Oberfranken;45 bis unter 46;2537;1231;1306
KS094;    Kreisfreie Städte Oberfranken;46 bis unter 47;2653;1264;1389
KS094;    Kreisfreie Städte Oberfranken;47 bis unter 48;2965;1459;1506
KS094;    Kreisfreie Städte Oberfranken;48 bis unter 49;3149;1551;1598
KS094;    Kreisfreie Städte Oberfranken;49 bis unter 50;3292;1647;1645
KS094;    Kreisfreie Städte Oberfranken;50 bis unter 51;3506;1739;1767
KS094;    Kreisfreie Städte Oberfranken;51 bis unter 52;3431;1734;1697
KS094;    Kreisfreie Städte Oberfranken;52 bis unter 53;3436;1708;1728
KS094;    Kreisfreie Städte Oberfranken;53 bis unter 54;3467;1724;1743
KS094;    Kreisfreie Städte Oberfranken;54 bis unter 55;3619;1750;1869
KS094;    Kreisfreie Städte Oberfranken;55 bis unter 56;3653;1795;1858
KS094;    Kreisfreie Städte Oberfranken;56 bis unter 57;3396;1686;1710
KS094;    Kreisfreie Städte Oberfranken;57 bis unter 58;3426;1676;1750
KS094;    Kreisfreie Städte Oberfranken;58 bis unter 59;3358;1660;1698
KS094;    Kreisfreie Städte Oberfranken;59 bis unter 60;3262;1561;1701
KS094;    Kreisfreie Städte Oberfranken;60 bis unter 61;3142;1478;1664
KS094;    Kreisfreie Städte Oberfranken;61 bis unter 62;3056;1453;1603
KS094;    Kreisfreie Städte Oberfranken;62 bis unter 63;2938;1374;1564
KS094;    Kreisfreie Städte Oberfranken;63 bis unter 64;2833;1323;1510
KS094;    Kreisfreie Städte Oberfranken;64 bis unter 65;2777;1301;1476
KS094;    Kreisfreie Städte Oberfranken;65 bis unter 66;2604;1201;1403
KS094;    Kreisfreie Städte Oberfranken;66 bis unter 67;2588;1157;1431
KS094;    Kreisfreie Städte Oberfranken;67 bis unter 68;2558;1131;1427
KS094;    Kreisfreie Städte Oberfranken;68 bis unter 69;2574;1188;1386
KS094;    Kreisfreie Städte Oberfranken;69 bis unter 70;2483;1119;1364
KS094;    Kreisfreie Städte Oberfranken;70 bis unter 71;2532;1131;1401
KS094;    Kreisfreie Städte Oberfranken;71 bis unter 72;2475;1110;1365
KS094;    Kreisfreie Städte Oberfranken;72 bis unter 73;2052;942;1110
KS094;    Kreisfreie Städte Oberfranken;73 bis unter 74;1615;735;880
KS094;    Kreisfreie Städte Oberfranken;74 bis unter 75;2185;987;1198
KS094;    Kreisfreie Städte Oberfranken;75 bis unter 76;2149;980;1169
KS094;    Kreisfreie Städte Oberfranken;76 bis unter 77;1986;890;1096
KS094;    Kreisfreie Städte Oberfranken;77 bis unter 78;2439;1018;1421
KS094;    Kreisfreie Städte Oberfranken;78 bis unter 79;2575;1092;1483
KS094;    Kreisfreie Städte Oberfranken;79 bis unter 80;2466;989;1477
KS094;    Kreisfreie Städte Oberfranken;80 bis unter 81;2151;895;1256
KS094;    Kreisfreie Städte Oberfranken;81 bis unter 82;1923;774;1149
KS094;    Kreisfreie Städte Oberfranken;82 bis unter 83;1709;674;1035
KS094;    Kreisfreie Städte Oberfranken;83 bis unter 84;1630;604;1026
KS094;    Kreisfreie Städte Oberfranken;84 bis unter 85;1447;491;956
KS094;    Kreisfreie Städte Oberfranken;85 bis unter 90;4541;1512;3029
KS094;    Kreisfreie Städte Oberfranken;90 bis unter 95;2243;574;1669
KS094;    Kreisfreie Städte Oberfranken;95 oder älter;603;78;525
KS094;    Kreisfreie Städte Oberfranken;Insgesamt;239428;116193;123235
09471;      Bamberg (Lkr);unter 1;1432;701;731
09471;      Bamberg (Lkr);1 bis unter 2;1392;661;731
09471;      Bamberg (Lkr);2 bis unter 3;1545;797;748
09471;      Bamberg (Lkr);3 bis unter 4;1379;719;660
09471;      Bamberg (Lkr);4 bis unter 5;1403;712;691
09471;      Bamberg (Lkr);5 bis unter 6;1363;701;662
09471;      Bamberg (Lkr);6 bis unter 7;1312;670;642
09471;      Bamberg (Lkr);7 bis unter 8;1323;684;639
09471;      Bamberg (Lkr);8 bis unter 9;1306;622;684
09471;      Bamberg (Lkr);9 bis unter 10;1309;711;598
09471;      Bamberg (Lkr);10 bis unter 11;1382;722;660
09471;      Bamberg (Lkr);11 bis unter 12;1329;698;631
09471;      Bamberg (Lkr);12 bis unter 13;1300;657;643
09471;      Bamberg (Lkr);13 bis unter 14;1400;710;690
09471;      Bamberg (Lkr);14 bis unter 15;1375;684;691
09471;      Bamberg (Lkr);15 bis unter 16;1405;705;700
09471;      Bamberg (Lkr);16 bis unter 17;1544;764;780
09471;      Bamberg (Lkr);17 bis unter 18;1542;835;707
09471;      Bamberg (Lkr);18 bis unter 19;1548;831;717
09471;      Bamberg (Lkr);19 bis unter 20;1651;879;772
09471;      Bamberg (Lkr);20 bis unter 21;1590;878;712
09471;      Bamberg (Lkr);21 bis unter 22;1638;914;724
09471;      Bamberg (Lkr);22 bis unter 23;1515;820;695
09471;      Bamberg (Lkr);23 bis unter 24;1416;776;640
09471;      Bamberg (Lkr);24 bis unter 25;1581;843;738
09471;      Bamberg (Lkr);25 bis unter 26;1657;884;773
09471;      Bamberg (Lkr);26 bis unter 27;1649;898;751
09471;      Bamberg (Lkr);27 bis unter 28;1687;893;794
09471;      Bamberg (Lkr);28 bis unter 29;1818;939;879
09471;      Bamberg (Lkr);29 bis unter 30;1760;938;822
09471;      Bamberg (Lkr);30 bis unter 31;1846;917;929
09471;      Bamberg (Lkr);31 bis unter 32;1820;951;869
09471;      Bamberg (Lkr);32 bis unter 33;1814;892;922
09471;      Bamberg (Lkr);33 bis unter 34;1733;877;856
09471;      Bamberg (Lkr);34 bis unter 35;1794;901;893
09471;      Bamberg (Lkr);35 bis unter 36;1832;920;912
09471;      Bamberg (Lkr);36 bis unter 37;1884;965;919
09471;      Bamberg (Lkr);37 bis unter 38;1884;944;940
09471;      Bamberg (Lkr);38 bis unter 39;1918;975;943
09471;      Bamberg (Lkr);39 bis unter 40;1804;874;930
09471;      Bamberg (Lkr);40 bis unter 41;1823;915;908
09471;      Bamberg (Lkr);41 bis unter 42;1734;895;839
09471;      Bamberg (Lkr);42 bis unter 43;1740;864;876
09471;      Bamberg (Lkr);43 bis unter 44;1782;927;855
09471;      Bamberg (Lkr);44 bis unter 45;1744;878;866
09471;      Bamberg (Lkr);45 bis unter 46;1892;955;937
09471;      Bamberg (Lkr);46 bis unter 47;2029;1016;1013
09471;      Bamberg (Lkr);47 bis unter 48;2213;1145;1068
09471;      Bamberg (Lkr);48 bis unter 49;2220;1127;1093
09471;      Bamberg (Lkr);49 bis unter 50;2458;1225;1233
09471;      Bamberg (Lkr);50 bis unter 51;2518;1274;1244
09471;      Bamberg (Lkr);51 bis unter 52;2609;1315;1294
09471;      Bamberg (Lkr);52 bis unter 53;2657;1346;1311
09471;      Bamberg (Lkr);53 bis unter 54;2724;1383;1341
09471;      Bamberg (Lkr);54 bis unter 55;2718;1393;1325
09471;      Bamberg (Lkr);55 bis unter 56;2662;1320;1342
09471;      Bamberg (Lkr);56 bis unter 57;2666;1339;1327
09471;      Bamberg (Lkr);57 bis unter 58;2758;1436;1322
09471;      Bamberg (Lkr);58 bis unter 59;2507;1291;1216
09471;      Bamberg (Lkr);59 bis unter 60;2398;1206;1192
09471;      Bamberg (Lkr);60 bis unter 61;2299;1182;1117
09471;      Bamberg (Lkr);61 bis unter 62;2196;1135;1061
09471;      Bamberg (Lkr);62 bis unter 63;2037;1014;1023
09471;      Bamberg (Lkr);63 bis unter 64;1938;984;954
09471;      Bamberg (Lkr);64 bis unter 65;1901;941;960
09471;      Bamberg (Lkr);65 bis unter 66;1758;882;876
09471;      Bamberg (Lkr);66 bis unter 67;1797;869;928
09471;      Bamberg (Lkr);67 bis unter 68;1707;880;827
09471;      Bamberg (Lkr);68 bis unter 69;1581;811;770
09471;      Bamberg (Lkr);69 bis unter 70;1579;815;764
09471;      Bamberg (Lkr);70 bis unter 71;1408;728;680
09471;      Bamberg (Lkr);71 bis unter 72;1305;632;673
09471;      Bamberg (Lkr);72 bis unter 73;1170;569;601
09471;      Bamberg (Lkr);73 bis unter 74;767;384;383
09471;      Bamberg (Lkr);74 bis unter 75;1031;495;536
09471;      Bamberg (Lkr);75 bis unter 76;978;449;529
09471;      Bamberg (Lkr);76 bis unter 77;994;484;510
09471;      Bamberg (Lkr);77 bis unter 78;1270;596;674
09471;      Bamberg (Lkr);78 bis unter 79;1352;639;713
09471;      Bamberg (Lkr);79 bis unter 80;1264;536;728
09471;      Bamberg (Lkr);80 bis unter 81;1208;492;716
09471;      Bamberg (Lkr);81 bis unter 82;1042;430;612
09471;      Bamberg (Lkr);82 bis unter 83;992;411;581
09471;      Bamberg (Lkr);83 bis unter 84;783;302;481
09471;      Bamberg (Lkr);84 bis unter 85;721;295;426
09471;      Bamberg (Lkr);85 bis unter 90;2207;765;1442
09471;      Bamberg (Lkr);90 bis unter 95;872;251;621
09471;      Bamberg (Lkr);95 oder älter;197;42;155
09471;      Bamberg (Lkr);Insgesamt;147086;73725;73361
09472;      Bayreuth (Lkr);unter 1;838;435;403
09472;      Bayreuth (Lkr);1 bis unter 2;867;448;419
09472;      Bayreuth (Lkr);2 bis unter 3;872;468;404
09472;      Bayreuth (Lkr);3 bis unter 4;862;425;437
09472;      Bayreuth (Lkr);4 bis unter 5;873;447;426
09472;      Bayreuth (Lkr);5 bis unter 6;895;445;450
09472;      Bayreuth (Lkr);6 bis unter 7;874;459;415
09472;      Bayreuth (Lkr);7 bis unter 8;853;446;407
09472;      Bayreuth (Lkr);8 bis unter 9;945;471;474
09472;      Bayreuth (Lkr);9 bis unter 10;881;456;425
09472;      Bayreuth (Lkr);10 bis unter 11;903;474;429
09472;      Bayreuth (Lkr);11 bis unter 12;893;480;413
09472;      Bayreuth (Lkr);12 bis unter 13;926;475;451
09472;      Bayreuth (Lkr);13 bis unter 14;911;456;455
09472;      Bayreuth (Lkr);14 bis unter 15;944;456;488
09472;      Bayreuth (Lkr);15 bis unter 16;1025;540;485
09472;      Bayreuth (Lkr);16 bis unter 17;1005;507;498
09472;      Bayreuth (Lkr);17 bis unter 18;1061;563;498
09472;      Bayreuth (Lkr);18 bis unter 19;1102;585;517
09472;      Bayreuth (Lkr);19 bis unter 20;1077;566;511
09472;      Bayreuth (Lkr);20 bis unter 21;1040;529;511
09472;      Bayreuth (Lkr);21 bis unter 22;1079;576;503
09472;      Bayreuth (Lkr);22 bis unter 23;998;541;457
09472;      Bayreuth (Lkr);23 bis unter 24;1007;537;470
09472;      Bayreuth (Lkr);24 bis unter 25;996;549;447
09472;      Bayreuth (Lkr);25 bis unter 26;1022;543;479
09472;      Bayreuth (Lkr);26 bis unter 27;1040;525;515
09472;      Bayreuth (Lkr);27 bis unter 28;1059;572;487
09472;      Bayreuth (Lkr);28 bis unter 29;1097;546;551
09472;      Bayreuth (Lkr);29 bis unter 30;1059;560;499
09472;      Bayreuth (Lkr);30 bis unter 31;1110;551;559
09472;      Bayreuth (Lkr);31 bis unter 32;1098;572;526
09472;      Bayreuth (Lkr);32 bis unter 33;1122;544;578
09472;      Bayreuth (Lkr);33 bis unter 34;1118;563;555
09472;      Bayreuth (Lkr);34 bis unter 35;1126;555;571
09472;      Bayreuth (Lkr);35 bis unter 36;1221;635;586
09472;      Bayreuth (Lkr);36 bis unter 37;1203;600;603
09472;      Bayreuth (Lkr);37 bis unter 38;1283;662;621
09472;      Bayreuth (Lkr);38 bis unter 39;1269;624;645
09472;      Bayreuth (Lkr);39 bis unter 40;1144;536;608
09472;      Bayreuth (Lkr);40 bis unter 41;1198;624;574
09472;      Bayreuth (Lkr);41 bis unter 42;1128;570;558
09472;      Bayreuth (Lkr);42 bis unter 43;1218;617;601
09472;      Bayreuth (Lkr);43 bis unter 44;1125;560;565
09472;      Bayreuth (Lkr);44 bis unter 45;1260;617;643
09472;      Bayreuth (Lkr);45 bis unter 46;1295;644;651
09472;      Bayreuth (Lkr);46 bis unter 47;1446;695;751
09472;      Bayreuth (Lkr);47 bis unter 48;1574;797;777
09472;      Bayreuth (Lkr);48 bis unter 49;1619;770;849
09472;      Bayreuth (Lkr);49 bis unter 50;1740;877;863
09472;      Bayreuth (Lkr);50 bis unter 51;1834;939;895
09472;      Bayreuth (Lkr);51 bis unter 52;1867;924;943
09472;      Bayreuth (Lkr);52 bis unter 53;1851;911;940
09472;      Bayreuth (Lkr);53 bis unter 54;1858;980;878
09472;      Bayreuth (Lkr);54 bis unter 55;1912;943;969
09472;      Bayreuth (Lkr);55 bis unter 56;1886;980;906
09472;      Bayreuth (Lkr);56 bis unter 57;1893;984;909
09472;      Bayreuth (Lkr);57 bis unter 58;1916;956;960
09472;      Bayreuth (Lkr);58 bis unter 59;1804;922;882
09472;      Bayreuth (Lkr);59 bis unter 60;1750;918;832
09472;      Bayreuth (Lkr);60 bis unter 61;1616;808;808
09472;      Bayreuth (Lkr);61 bis unter 62;1618;803;815
09472;      Bayreuth (Lkr);62 bis unter 63;1537;780;757
09472;      Bayreuth (Lkr);63 bis unter 64;1433;703;730
09472;      Bayreuth (Lkr);64 bis unter 65;1369;704;665
09472;      Bayreuth (Lkr);65 bis unter 66;1388;701;687
09472;      Bayreuth (Lkr);66 bis unter 67;1377;703;674
09472;      Bayreuth (Lkr);67 bis unter 68;1283;636;647
09472;      Bayreuth (Lkr);68 bis unter 69;1235;634;601
09472;      Bayreuth (Lkr);69 bis unter 70;1202;575;627
09472;      Bayreuth (Lkr);70 bis unter 71;1172;558;614
09472;      Bayreuth (Lkr);71 bis unter 72;1089;532;557
09472;      Bayreuth (Lkr);72 bis unter 73;902;426;476
09472;      Bayreuth (Lkr);73 bis unter 74;706;357;349
09472;      Bayreuth (Lkr);74 bis unter 75;906;439;467
09472;      Bayreuth (Lkr);75 bis unter 76;900;440;460
09472;      Bayreuth (Lkr);76 bis unter 77;795;364;431
09472;      Bayreuth (Lkr);77 bis unter 78;1083;484;599
09472;      Bayreuth (Lkr);78 bis unter 79;1212;555;657
09472;      Bayreuth (Lkr);79 bis unter 80;1114;502;612
09472;      Bayreuth (Lkr);80 bis unter 81;974;410;564
09472;      Bayreuth (Lkr);81 bis unter 82;816;332;484
09472;      Bayreuth (Lkr);82 bis unter 83;803;316;487
09472;      Bayreuth (Lkr);83 bis unter 84;732;304;428
09472;      Bayreuth (Lkr);84 bis unter 85;611;195;416
09472;      Bayreuth (Lkr);85 bis unter 90;1894;626;1268
09472;      Bayreuth (Lkr);90 bis unter 95;837;234;603
09472;      Bayreuth (Lkr);95 oder älter;180;39;141
09472;      Bayreuth (Lkr);Insgesamt;103656;51310;52346
09473;      Coburg (Lkr);unter 1;707;360;347
09473;      Coburg (Lkr);1 bis unter 2;789;391;398
09473;      Coburg (Lkr);2 bis unter 3;791;408;383
09473;      Coburg (Lkr);3 bis unter 4;704;350;354
09473;      Coburg (Lkr);4 bis unter 5;798;418;380
09473;      Coburg (Lkr);5 bis unter 6;734;377;357
09473;      Coburg (Lkr);6 bis unter 7;708;384;324
09473;      Coburg (Lkr);7 bis unter 8;716;376;340
09473;      Coburg (Lkr);8 bis unter 9;694;351;343
09473;      Coburg (Lkr);9 bis unter 10;675;353;322
09473;      Coburg (Lkr);10 bis unter 11;740;381;359
09473;      Coburg (Lkr);11 bis unter 12;713;378;335
09473;      Coburg (Lkr);12 bis unter 13;752;377;375
09473;      Coburg (Lkr);13 bis unter 14;714;377;337
09473;      Coburg (Lkr);14 bis unter 15;819;404;415
09473;      Coburg (Lkr);15 bis unter 16;760;383;377
09473;      Coburg (Lkr);16 bis unter 17;807;408;399
09473;      Coburg (Lkr);17 bis unter 18;872;492;380
09473;      Coburg (Lkr);18 bis unter 19;926;493;433
09473;      Coburg (Lkr);19 bis unter 20;851;456;395
09473;      Coburg (Lkr);20 bis unter 21;888;473;415
09473;      Coburg (Lkr);21 bis unter 22;852;457;395
09473;      Coburg (Lkr);22 bis unter 23;839;465;374
09473;      Coburg (Lkr);23 bis unter 24;782;418;364
09473;      Coburg (Lkr);24 bis unter 25;854;437;417
09473;      Coburg (Lkr);25 bis unter 26;869;464;405
09473;      Coburg (Lkr);26 bis unter 27;863;457;406
09473;      Coburg (Lkr);27 bis unter 28;909;499;410
09473;      Coburg (Lkr);28 bis unter 29;957;511;446
09473;      Coburg (Lkr);29 bis unter 30;978;527;451
09473;      Coburg (Lkr);30 bis unter 31;982;520;462
09473;      Coburg (Lkr);31 bis unter 32;1022;512;510
09473;      Coburg (Lkr);32 bis unter 33;999;500;499
09473;      Coburg (Lkr);33 bis unter 34;1003;505;498
09473;      Coburg (Lkr);34 bis unter 35;987;471;516
09473;      Coburg (Lkr);35 bis unter 36;1010;499;511
09473;      Coburg (Lkr);36 bis unter 37;1080;589;491
09473;      Coburg (Lkr);37 bis unter 38;959;473;486
09473;      Coburg (Lkr);38 bis unter 39;1066;528;538
09473;      Coburg (Lkr);39 bis unter 40;979;510;469
09473;      Coburg (Lkr);40 bis unter 41;977;477;500
09473;      Coburg (Lkr);41 bis unter 42;975;516;459
09473;      Coburg (Lkr);42 bis unter 43;952;470;482
09473;      Coburg (Lkr);43 bis unter 44;895;419;476
09473;      Coburg (Lkr);44 bis unter 45;961;504;457
09473;      Coburg (Lkr);45 bis unter 46;965;456;509
09473;      Coburg (Lkr);46 bis unter 47;1094;517;577
09473;      Coburg (Lkr);47 bis unter 48;1245;604;641
09473;      Coburg (Lkr);48 bis unter 49;1298;652;646
09473;      Coburg (Lkr);49 bis unter 50;1483;730;753
09473;      Coburg (Lkr);50 bis unter 51;1501;760;741
09473;      Coburg (Lkr);51 bis unter 52;1498;802;696
09473;      Coburg (Lkr);52 bis unter 53;1526;776;750
09473;      Coburg (Lkr);53 bis unter 54;1547;742;805
09473;      Coburg (Lkr);54 bis unter 55;1592;796;796
09473;      Coburg (Lkr);55 bis unter 56;1585;829;756
09473;      Coburg (Lkr);56 bis unter 57;1614;802;812
09473;      Coburg (Lkr);57 bis unter 58;1576;782;794
09473;      Coburg (Lkr);58 bis unter 59;1501;732;769
09473;      Coburg (Lkr);59 bis unter 60;1445;731;714
09473;      Coburg (Lkr);60 bis unter 61;1364;704;660
09473;      Coburg (Lkr);61 bis unter 62;1366;676;690
09473;      Coburg (Lkr);62 bis unter 63;1345;683;662
09473;      Coburg (Lkr);63 bis unter 64;1225;606;619
09473;      Coburg (Lkr);64 bis unter 65;1192;574;618
09473;      Coburg (Lkr);65 bis unter 66;1099;509;590
09473;      Coburg (Lkr);66 bis unter 67;1119;553;566
09473;      Coburg (Lkr);67 bis unter 68;1146;531;615
09473;      Coburg (Lkr);68 bis unter 69;1084;527;557
09473;      Coburg (Lkr);69 bis unter 70;1057;535;522
09473;      Coburg (Lkr);70 bis unter 71;1029;486;543
09473;      Coburg (Lkr);71 bis unter 72;951;477;474
09473;      Coburg (Lkr);72 bis unter 73;776;368;408
09473;      Coburg (Lkr);73 bis unter 74;542;270;272
09473;      Coburg (Lkr);74 bis unter 75;736;337;399
09473;      Coburg (Lkr);75 bis unter 76;738;344;394
09473;      Coburg (Lkr);76 bis unter 77;713;342;371
09473;      Coburg (Lkr);77 bis unter 78;921;398;523
09473;      Coburg (Lkr);78 bis unter 79;1001;444;557
09473;      Coburg (Lkr);79 bis unter 80;1016;452;564
09473;      Coburg (Lkr);80 bis unter 81;837;353;484
09473;      Coburg (Lkr);81 bis unter 82;774;310;464
09473;      Coburg (Lkr);82 bis unter 83;689;266;423
09473;      Coburg (Lkr);83 bis unter 84;639;261;378
09473;      Coburg (Lkr);84 bis unter 85;536;200;336
09473;      Coburg (Lkr);85 bis unter 90;1741;613;1128
09473;      Coburg (Lkr);90 bis unter 95;719;221;498
09473;      Coburg (Lkr);95 oder älter;173;43;130
09473;      Coburg (Lkr);Insgesamt;86906;42912;43994
09474;      Forchheim (Lkr);unter 1;1047;526;521
09474;      Forchheim (Lkr);1 bis unter 2;1115;573;542
09474;      Forchheim (Lkr);2 bis unter 3;1099;561;538
09474;      Forchheim (Lkr);3 bis unter 4;1147;578;569
09474;      Forchheim (Lkr);4 bis unter 5;1079;557;522
09474;      Forchheim (Lkr);5 bis unter 6;1080;522;558
09474;      Forchheim (Lkr);6 bis unter 7;1127;564;563
09474;      Forchheim (Lkr);7 bis unter 8;966;514;452
09474;      Forchheim (Lkr);8 bis unter 9;1009;505;504
09474;      Forchheim (Lkr);9 bis unter 10;1030;502;528
09474;      Forchheim (Lkr);10 bis unter 11;1060;561;499
09474;      Forchheim (Lkr);11 bis unter 12;1053;496;557
09474;      Forchheim (Lkr);12 bis unter 13;1057;533;524
09474;      Forchheim (Lkr);13 bis unter 14;1061;529;532
09474;      Forchheim (Lkr);14 bis unter 15;1039;531;508
09474;      Forchheim (Lkr);15 bis unter 16;1132;567;565
09474;      Forchheim (Lkr);16 bis unter 17;1150;585;565
09474;      Forchheim (Lkr);17 bis unter 18;1229;664;565
09474;      Forchheim (Lkr);18 bis unter 19;1248;627;621
09474;      Forchheim (Lkr);19 bis unter 20;1232;640;592
09474;      Forchheim (Lkr);20 bis unter 21;1241;677;564
09474;      Forchheim (Lkr);21 bis unter 22;1324;719;605
09474;      Forchheim (Lkr);22 bis unter 23;1206;666;540
09474;      Forchheim (Lkr);23 bis unter 24;1226;652;574
09474;      Forchheim (Lkr);24 bis unter 25;1234;668;566
09474;      Forchheim (Lkr);25 bis unter 26;1264;681;583
09474;      Forchheim (Lkr);26 bis unter 27;1312;688;624
09474;      Forchheim (Lkr);27 bis unter 28;1278;673;605
09474;      Forchheim (Lkr);28 bis unter 29;1373;725;648
09474;      Forchheim (Lkr);29 bis unter 30;1311;690;621
09474;      Forchheim (Lkr);30 bis unter 31;1428;745;683
09474;      Forchheim (Lkr);31 bis unter 32;1272;656;616
09474;      Forchheim (Lkr);32 bis unter 33;1389;701;688
09474;      Forchheim (Lkr);33 bis unter 34;1328;653;675
09474;      Forchheim (Lkr);34 bis unter 35;1366;677;689
09474;      Forchheim (Lkr);35 bis unter 36;1394;695;699
09474;      Forchheim (Lkr);36 bis unter 37;1455;731;724
09474;      Forchheim (Lkr);37 bis unter 38;1504;732;772
09474;      Forchheim (Lkr);38 bis unter 39;1455;719;736
09474;      Forchheim (Lkr);39 bis unter 40;1394;734;660
09474;      Forchheim (Lkr);40 bis unter 41;1402;720;682
09474;      Forchheim (Lkr);41 bis unter 42;1444;742;702
09474;      Forchheim (Lkr);42 bis unter 43;1375;685;690
09474;      Forchheim (Lkr);43 bis unter 44;1325;703;622
09474;      Forchheim (Lkr);44 bis unter 45;1310;630;680
09474;      Forchheim (Lkr);45 bis unter 46;1320;672;648
09474;      Forchheim (Lkr);46 bis unter 47;1459;721;738
09474;      Forchheim (Lkr);47 bis unter 48;1634;783;851
09474;      Forchheim (Lkr);48 bis unter 49;1689;826;863
09474;      Forchheim (Lkr);49 bis unter 50;1818;905;913
09474;      Forchheim (Lkr);50 bis unter 51;1979;946;1033
09474;      Forchheim (Lkr);51 bis unter 52;2019;1018;1001
09474;      Forchheim (Lkr);52 bis unter 53;2075;1065;1010
09474;      Forchheim (Lkr);53 bis unter 54;2123;1047;1076
09474;      Forchheim (Lkr);54 bis unter 55;2206;1192;1014
09474;      Forchheim (Lkr);55 bis unter 56;2210;1092;1118
09474;      Forchheim (Lkr);56 bis unter 57;2089;1062;1027
09474;      Forchheim (Lkr);57 bis unter 58;2052;985;1067
09474;      Forchheim (Lkr);58 bis unter 59;2087;1053;1034
09474;      Forchheim (Lkr);59 bis unter 60;1935;1037;898
09474;      Forchheim (Lkr);60 bis unter 61;1852;928;924
09474;      Forchheim (Lkr);61 bis unter 62;1777;890;887
09474;      Forchheim (Lkr);62 bis unter 63;1689;891;798
09474;      Forchheim (Lkr);63 bis unter 64;1520;756;764
09474;      Forchheim (Lkr);64 bis unter 65;1513;722;791
09474;      Forchheim (Lkr);65 bis unter 66;1408;723;685
09474;      Forchheim (Lkr);66 bis unter 67;1372;690;682
09474;      Forchheim (Lkr);67 bis unter 68;1371;651;720
09474;      Forchheim (Lkr);68 bis unter 69;1338;655;683
09474;      Forchheim (Lkr);69 bis unter 70;1301;651;650
09474;      Forchheim (Lkr);70 bis unter 71;1189;572;617
09474;      Forchheim (Lkr);71 bis unter 72;1119;542;577
09474;      Forchheim (Lkr);72 bis unter 73;907;421;486
09474;      Forchheim (Lkr);73 bis unter 74;708;332;376
09474;      Forchheim (Lkr);74 bis unter 75;903;445;458
09474;      Forchheim (Lkr);75 bis unter 76;889;429;460
09474;      Forchheim (Lkr);76 bis unter 77;831;390;441
09474;      Forchheim (Lkr);77 bis unter 78;1084;523;561
09474;      Forchheim (Lkr);78 bis unter 79;1138;491;647
09474;      Forchheim (Lkr);79 bis unter 80;1136;518;618
09474;      Forchheim (Lkr);80 bis unter 81;1026;432;594
09474;      Forchheim (Lkr);81 bis unter 82;827;344;483
09474;      Forchheim (Lkr);82 bis unter 83;777;315;462
09474;      Forchheim (Lkr);83 bis unter 84;728;304;424
09474;      Forchheim (Lkr);84 bis unter 85;604;228;376
09474;      Forchheim (Lkr);85 bis unter 90;1955;715;1240
09474;      Forchheim (Lkr);90 bis unter 95;698;198;500
09474;      Forchheim (Lkr);95 oder älter;174;46;128
09474;      Forchheim (Lkr);Insgesamt;116099;57703;58396
09475;      Hof (Lkr);unter 1;693;346;347
09475;      Hof (Lkr);1 bis unter 2;733;362;371
09475;      Hof (Lkr);2 bis unter 3;748;373;375
09475;      Hof (Lkr);3 bis unter 4;719;348;371
09475;      Hof (Lkr);4 bis unter 5;754;387;367
09475;      Hof (Lkr);5 bis unter 6;695;367;328
09475;      Hof (Lkr);6 bis unter 7;701;349;352
09475;      Hof (Lkr);7 bis unter 8;737;379;358
09475;      Hof (Lkr);8 bis unter 9;732;383;349
09475;      Hof (Lkr);9 bis unter 10;709;363;346
09475;      Hof (Lkr);10 bis unter 11;775;390;385
09475;      Hof (Lkr);11 bis unter 12;735;371;364
09475;      Hof (Lkr);12 bis unter 13;776;383;393
09475;      Hof (Lkr);13 bis unter 14;790;422;368
09475;      Hof (Lkr);14 bis unter 15;811;404;407
09475;      Hof (Lkr);15 bis unter 16;844;407;437
09475;      Hof (Lkr);16 bis unter 17;958;516;442
09475;      Hof (Lkr);17 bis unter 18;894;457;437
09475;      Hof (Lkr);18 bis unter 19;945;511;434
09475;      Hof (Lkr);19 bis unter 20;996;525;471
09475;      Hof (Lkr);20 bis unter 21;994;549;445
09475;      Hof (Lkr);21 bis unter 22;918;466;452
09475;      Hof (Lkr);22 bis unter 23;905;507;398
09475;      Hof (Lkr);23 bis unter 24;839;437;402
09475;      Hof (Lkr);24 bis unter 25;860;462;398
09475;      Hof (Lkr);25 bis unter 26;967;529;438
09475;      Hof (Lkr);26 bis unter 27;925;486;439
09475;      Hof (Lkr);27 bis unter 28;1022;535;487
09475;      Hof (Lkr);28 bis unter 29;977;526;451
09475;      Hof (Lkr);29 bis unter 30;935;477;458
09475;      Hof (Lkr);30 bis unter 31;967;512;455
09475;      Hof (Lkr);31 bis unter 32;1017;525;492
09475;      Hof (Lkr);32 bis unter 33;905;478;427
09475;      Hof (Lkr);33 bis unter 34;885;447;438
09475;      Hof (Lkr);34 bis unter 35;913;459;454
09475;      Hof (Lkr);35 bis unter 36;962;500;462
09475;      Hof (Lkr);36 bis unter 37;1064;516;548
09475;      Hof (Lkr);37 bis unter 38;1036;530;506
09475;      Hof (Lkr);38 bis unter 39;990;475;515
09475;      Hof (Lkr);39 bis unter 40;980;497;483
09475;      Hof (Lkr);40 bis unter 41;941;478;463
09475;      Hof (Lkr);41 bis unter 42;951;469;482
09475;      Hof (Lkr);42 bis unter 43;994;505;489
09475;      Hof (Lkr);43 bis unter 44;1006;495;511
09475;      Hof (Lkr);44 bis unter 45;1025;497;528
09475;      Hof (Lkr);45 bis unter 46;1118;546;572
09475;      Hof (Lkr);46 bis unter 47;1195;583;612
09475;      Hof (Lkr);47 bis unter 48;1394;665;729
09475;      Hof (Lkr);48 bis unter 49;1512;711;801
09475;      Hof (Lkr);49 bis unter 50;1599;801;798
09475;      Hof (Lkr);50 bis unter 51;1681;873;808
09475;      Hof (Lkr);51 bis unter 52;1636;831;805
09475;      Hof (Lkr);52 bis unter 53;1695;843;852
09475;      Hof (Lkr);53 bis unter 54;1659;850;809
09475;      Hof (Lkr);54 bis unter 55;1812;892;920
09475;      Hof (Lkr);55 bis unter 56;1805;967;838
09475;      Hof (Lkr);56 bis unter 57;1711;883;828
09475;      Hof (Lkr);57 bis unter 58;1716;871;845
09475;      Hof (Lkr);58 bis unter 59;1664;828;836
09475;      Hof (Lkr);59 bis unter 60;1693;847;846
09475;      Hof (Lkr);60 bis unter 61;1544;788;756
09475;      Hof (Lkr);61 bis unter 62;1541;768;773
09475;      Hof (Lkr);62 bis unter 63;1413;725;688
09475;      Hof (Lkr);63 bis unter 64;1357;651;706
09475;      Hof (Lkr);64 bis unter 65;1330;653;677
09475;      Hof (Lkr);65 bis unter 66;1290;635;655
09475;      Hof (Lkr);66 bis unter 67;1271;633;638
09475;      Hof (Lkr);67 bis unter 68;1274;635;639
09475;      Hof (Lkr);68 bis unter 69;1329;622;707
09475;      Hof (Lkr);69 bis unter 70;1228;567;661
09475;      Hof (Lkr);70 bis unter 71;1123;522;601
09475;      Hof (Lkr);71 bis unter 72;1154;543;611
09475;      Hof (Lkr);72 bis unter 73;891;458;433
09475;      Hof (Lkr);73 bis unter 74;683;330;353
09475;      Hof (Lkr);74 bis unter 75;1027;484;543
09475;      Hof (Lkr);75 bis unter 76;949;426;523
09475;      Hof (Lkr);76 bis unter 77;854;390;464
09475;      Hof (Lkr);77 bis unter 78;1072;478;594
09475;      Hof (Lkr);78 bis unter 79;1218;500;718
09475;      Hof (Lkr);79 bis unter 80;1187;516;671
09475;      Hof (Lkr);80 bis unter 81;1023;456;567
09475;      Hof (Lkr);81 bis unter 82;960;403;557
09475;      Hof (Lkr);82 bis unter 83;905;346;559
09475;      Hof (Lkr);83 bis unter 84;848;335;513
09475;      Hof (Lkr);84 bis unter 85;723;272;451
09475;      Hof (Lkr);85 bis unter 90;2340;799;1541
09475;      Hof (Lkr);90 bis unter 95;960;269;691
09475;      Hof (Lkr);95 oder älter;204;51;153
09475;      Hof (Lkr);Insgesamt;95311;46646;48665
09476;      Kronach (Lkr);unter 1;468;237;231
09476;      Kronach (Lkr);1 bis unter 2;476;248;228
09476;      Kronach (Lkr);2 bis unter 3;496;240;256
09476;      Kronach (Lkr);3 bis unter 4;509;243;266
09476;      Kronach (Lkr);4 bis unter 5;459;241;218
09476;      Kronach (Lkr);5 bis unter 6;474;246;228
09476;      Kronach (Lkr);6 bis unter 7;507;260;247
09476;      Kronach (Lkr);7 bis unter 8;537;267;270
09476;      Kronach (Lkr);8 bis unter 9;505;266;239
09476;      Kronach (Lkr);9 bis unter 10;536;250;286
09476;      Kronach (Lkr);10 bis unter 11;484;252;232
09476;      Kronach (Lkr);11 bis unter 12;494;244;250
09476;      Kronach (Lkr);12 bis unter 13;509;263;246
09476;      Kronach (Lkr);13 bis unter 14;519;265;254
09476;      Kronach (Lkr);14 bis unter 15;581;283;298
09476;      Kronach (Lkr);15 bis unter 16;591;294;297
09476;      Kronach (Lkr);16 bis unter 17;622;323;299
09476;      Kronach (Lkr);17 bis unter 18;672;342;330
09476;      Kronach (Lkr);18 bis unter 19;675;383;292
09476;      Kronach (Lkr);19 bis unter 20;668;371;297
09476;      Kronach (Lkr);20 bis unter 21;625;329;296
09476;      Kronach (Lkr);21 bis unter 22;690;372;318
09476;      Kronach (Lkr);22 bis unter 23;630;319;311
09476;      Kronach (Lkr);23 bis unter 24;582;311;271
09476;      Kronach (Lkr);24 bis unter 25;633;325;308
09476;      Kronach (Lkr);25 bis unter 26;683;397;286
09476;      Kronach (Lkr);26 bis unter 27;703;360;343
09476;      Kronach (Lkr);27 bis unter 28;664;354;310
09476;      Kronach (Lkr);28 bis unter 29;760;395;365
09476;      Kronach (Lkr);29 bis unter 30;670;349;321
09476;      Kronach (Lkr);30 bis unter 31;712;375;337
09476;      Kronach (Lkr);31 bis unter 32;677;388;289
09476;      Kronach (Lkr);32 bis unter 33;730;361;369
09476;      Kronach (Lkr);33 bis unter 34;706;370;336
09476;      Kronach (Lkr);34 bis unter 35;713;367;346
09476;      Kronach (Lkr);35 bis unter 36;711;399;312
09476;      Kronach (Lkr);36 bis unter 37;736;386;350
09476;      Kronach (Lkr);37 bis unter 38;769;375;394
09476;      Kronach (Lkr);38 bis unter 39;707;375;332
09476;      Kronach (Lkr);39 bis unter 40;762;379;383
09476;      Kronach (Lkr);40 bis unter 41;710;372;338
09476;      Kronach (Lkr);41 bis unter 42;741;376;365
09476;      Kronach (Lkr);42 bis unter 43;749;340;409
09476;      Kronach (Lkr);43 bis unter 44;723;392;331
09476;      Kronach (Lkr);44 bis unter 45;761;371;390
09476;      Kronach (Lkr);45 bis unter 46;834;413;421
09476;      Kronach (Lkr);46 bis unter 47;959;461;498
09476;      Kronach (Lkr);47 bis unter 48;982;488;494
09476;      Kronach (Lkr);48 bis unter 49;1069;572;497
09476;      Kronach (Lkr);49 bis unter 50;1114;562;552
09476;      Kronach (Lkr);50 bis unter 51;1184;575;609
09476;      Kronach (Lkr);51 bis unter 52;1217;614;603
09476;      Kronach (Lkr);52 bis unter 53;1251;672;579
09476;      Kronach (Lkr);53 bis unter 54;1256;647;609
09476;      Kronach (Lkr);54 bis unter 55;1257;625;632
09476;      Kronach (Lkr);55 bis unter 56;1299;690;609
09476;      Kronach (Lkr);56 bis unter 57;1220;614;606
09476;      Kronach (Lkr);57 bis unter 58;1280;647;633
09476;      Kronach (Lkr);58 bis unter 59;1230;620;610
09476;      Kronach (Lkr);59 bis unter 60;1196;589;607
09476;      Kronach (Lkr);60 bis unter 61;1123;572;551
09476;      Kronach (Lkr);61 bis unter 62;1089;546;543
09476;      Kronach (Lkr);62 bis unter 63;1011;527;484
09476;      Kronach (Lkr);63 bis unter 64;1018;508;510
09476;      Kronach (Lkr);64 bis unter 65;988;506;482
09476;      Kronach (Lkr);65 bis unter 66;955;462;493
09476;      Kronach (Lkr);66 bis unter 67;899;450;449
09476;      Kronach (Lkr);67 bis unter 68;914;439;475
09476;      Kronach (Lkr);68 bis unter 69;860;409;451
09476;      Kronach (Lkr);69 bis unter 70;874;440;434
09476;      Kronach (Lkr);70 bis unter 71;778;383;395
09476;      Kronach (Lkr);71 bis unter 72;693;333;360
09476;      Kronach (Lkr);72 bis unter 73;644;322;322
09476;      Kronach (Lkr);73 bis unter 74;455;230;225
09476;      Kronach (Lkr);74 bis unter 75;568;281;287
09476;      Kronach (Lkr);75 bis unter 76;590;245;345
09476;      Kronach (Lkr);76 bis unter 77;510;240;270
09476;      Kronach (Lkr);77 bis unter 78;686;272;414
09476;      Kronach (Lkr);78 bis unter 79;810;368;442
09476;      Kronach (Lkr);79 bis unter 80;809;328;481
09476;      Kronach (Lkr);80 bis unter 81;724;288;436
09476;      Kronach (Lkr);81 bis unter 82;696;288;408
09476;      Kronach (Lkr);82 bis unter 83;589;243;346
09476;      Kronach (Lkr);83 bis unter 84;561;211;350
09476;      Kronach (Lkr);84 bis unter 85;481;177;304
09476;      Kronach (Lkr);85 bis unter 90;1424;485;939
09476;      Kronach (Lkr);90 bis unter 95;610;166;444
09476;      Kronach (Lkr);95 oder älter;99;21;78
09476;      Kronach (Lkr);Insgesamt;67135;33184;33951
09477;      Kulmbach (Lkr);unter 1;580;295;285
09477;      Kulmbach (Lkr);1 bis unter 2;547;275;272
09477;      Kulmbach (Lkr);2 bis unter 3;549;287;262
09477;      Kulmbach (Lkr);3 bis unter 4;506;245;261
09477;      Kulmbach (Lkr);4 bis unter 5;545;279;266
09477;      Kulmbach (Lkr);5 bis unter 6;475;251;224
09477;      Kulmbach (Lkr);6 bis unter 7;535;272;263
09477;      Kulmbach (Lkr);7 bis unter 8;538;287;251
09477;      Kulmbach (Lkr);8 bis unter 9;562;278;284
09477;      Kulmbach (Lkr);9 bis unter 10;559;275;284
09477;      Kulmbach (Lkr);10 bis unter 11;590;292;298
09477;      Kulmbach (Lkr);11 bis unter 12;583;310;273
09477;      Kulmbach (Lkr);12 bis unter 13;632;344;288
09477;      Kulmbach (Lkr);13 bis unter 14;597;307;290
09477;      Kulmbach (Lkr);14 bis unter 15;600;310;290
09477;      Kulmbach (Lkr);15 bis unter 16;670;344;326
09477;      Kulmbach (Lkr);16 bis unter 17;704;364;340
09477;      Kulmbach (Lkr);17 bis unter 18;694;348;346
09477;      Kulmbach (Lkr);18 bis unter 19;724;402;322
09477;      Kulmbach (Lkr);19 bis unter 20;742;428;314
09477;      Kulmbach (Lkr);20 bis unter 21;737;434;303
09477;      Kulmbach (Lkr);21 bis unter 22;789;404;385
09477;      Kulmbach (Lkr);22 bis unter 23;665;365;300
09477;      Kulmbach (Lkr);23 bis unter 24;695;348;347
09477;      Kulmbach (Lkr);24 bis unter 25;698;378;320
09477;      Kulmbach (Lkr);25 bis unter 26;785;416;369
09477;      Kulmbach (Lkr);26 bis unter 27;716;386;330
09477;      Kulmbach (Lkr);27 bis unter 28;761;429;332
09477;      Kulmbach (Lkr);28 bis unter 29;736;398;338
09477;      Kulmbach (Lkr);29 bis unter 30;708;386;322
09477;      Kulmbach (Lkr);30 bis unter 31;766;405;361
09477;      Kulmbach (Lkr);31 bis unter 32;748;372;376
09477;      Kulmbach (Lkr);32 bis unter 33;785;438;347
09477;      Kulmbach (Lkr);33 bis unter 34;713;369;344
09477;      Kulmbach (Lkr);34 bis unter 35;717;371;346
09477;      Kulmbach (Lkr);35 bis unter 36;733;393;340
09477;      Kulmbach (Lkr);36 bis unter 37;843;410;433
09477;      Kulmbach (Lkr);37 bis unter 38;787;398;389
09477;      Kulmbach (Lkr);38 bis unter 39;798;376;422
09477;      Kulmbach (Lkr);39 bis unter 40;782;397;385
09477;      Kulmbach (Lkr);40 bis unter 41;783;402;381
09477;      Kulmbach (Lkr);41 bis unter 42;793;403;390
09477;      Kulmbach (Lkr);42 bis unter 43;782;381;401
09477;      Kulmbach (Lkr);43 bis unter 44;847;413;434
09477;      Kulmbach (Lkr);44 bis unter 45;854;408;446
09477;      Kulmbach (Lkr);45 bis unter 46;871;412;459
09477;      Kulmbach (Lkr);46 bis unter 47;977;472;505
09477;      Kulmbach (Lkr);47 bis unter 48;1015;493;522
09477;      Kulmbach (Lkr);48 bis unter 49;1104;563;541
09477;      Kulmbach (Lkr);49 bis unter 50;1211;580;631
09477;      Kulmbach (Lkr);50 bis unter 51;1324;653;671
09477;      Kulmbach (Lkr);51 bis unter 52;1250;632;618
09477;      Kulmbach (Lkr);52 bis unter 53;1313;651;662
09477;      Kulmbach (Lkr);53 bis unter 54;1328;689;639
09477;      Kulmbach (Lkr);54 bis unter 55;1316;692;624
09477;      Kulmbach (Lkr);55 bis unter 56;1248;652;596
09477;      Kulmbach (Lkr);56 bis unter 57;1297;644;653
09477;      Kulmbach (Lkr);57 bis unter 58;1382;684;698
09477;      Kulmbach (Lkr);58 bis unter 59;1248;639;609
09477;      Kulmbach (Lkr);59 bis unter 60;1241;624;617
09477;      Kulmbach (Lkr);60 bis unter 61;1145;576;569
09477;      Kulmbach (Lkr);61 bis unter 62;1132;557;575
09477;      Kulmbach (Lkr);62 bis unter 63;1171;571;600
09477;      Kulmbach (Lkr);63 bis unter 64;1048;499;549
09477;      Kulmbach (Lkr);64 bis unter 65;976;471;505
09477;      Kulmbach (Lkr);65 bis unter 66;981;502;479
09477;      Kulmbach (Lkr);66 bis unter 67;1042;500;542
09477;      Kulmbach (Lkr);67 bis unter 68;993;483;510
09477;      Kulmbach (Lkr);68 bis unter 69;980;482;498
09477;      Kulmbach (Lkr);69 bis unter 70;883;404;479
09477;      Kulmbach (Lkr);70 bis unter 71;882;437;445
09477;      Kulmbach (Lkr);71 bis unter 72;818;399;419
09477;      Kulmbach (Lkr);72 bis unter 73;677;327;350
09477;      Kulmbach (Lkr);73 bis unter 74;521;259;262
09477;      Kulmbach (Lkr);74 bis unter 75;683;316;367
09477;      Kulmbach (Lkr);75 bis unter 76;604;275;329
09477;      Kulmbach (Lkr);76 bis unter 77;572;280;292
09477;      Kulmbach (Lkr);77 bis unter 78;737;335;402
09477;      Kulmbach (Lkr);78 bis unter 79;795;329;466
09477;      Kulmbach (Lkr);79 bis unter 80;843;347;496
09477;      Kulmbach (Lkr);80 bis unter 81;727;306;421
09477;      Kulmbach (Lkr);81 bis unter 82;629;269;360
09477;      Kulmbach (Lkr);82 bis unter 83;598;216;382
09477;      Kulmbach (Lkr);83 bis unter 84;525;192;333
09477;      Kulmbach (Lkr);84 bis unter 85;480;168;312
09477;      Kulmbach (Lkr);85 bis unter 90;1510;476;1034
09477;      Kulmbach (Lkr);90 bis unter 95;691;188;503
09477;      Kulmbach (Lkr);95 oder älter;124;28;96
09477;      Kulmbach (Lkr);Insgesamt;71845;35345;36500
09478;      Lichtenfels (Lkr);unter 1;558;292;266
09478;      Lichtenfels (Lkr);1 bis unter 2;569;296;273
09478;      Lichtenfels (Lkr);2 bis unter 3;586;299;287
09478;      Lichtenfels (Lkr);3 bis unter 4;577;289;288
09478;      Lichtenfels (Lkr);4 bis unter 5;569;307;262
09478;      Lichtenfels (Lkr);5 bis unter 6;512;244;268
09478;      Lichtenfels (Lkr);6 bis unter 7;587;282;305
09478;      Lichtenfels (Lkr);7 bis unter 8;555;301;254
09478;      Lichtenfels (Lkr);8 bis unter 9;565;271;294
09478;      Lichtenfels (Lkr);9 bis unter 10;552;291;261
09478;      Lichtenfels (Lkr);10 bis unter 11;585;296;289
09478;      Lichtenfels (Lkr);11 bis unter 12;556;276;280
09478;      Lichtenfels (Lkr);12 bis unter 13;522;256;266
09478;      Lichtenfels (Lkr);13 bis unter 14;531;266;265
09478;      Lichtenfels (Lkr);14 bis unter 15;547;260;287
09478;      Lichtenfels (Lkr);15 bis unter 16;600;305;295
09478;      Lichtenfels (Lkr);16 bis unter 17;611;314;297
09478;      Lichtenfels (Lkr);17 bis unter 18;638;351;287
09478;      Lichtenfels (Lkr);18 bis unter 19;655;361;294
09478;      Lichtenfels (Lkr);19 bis unter 20;697;338;359
09478;      Lichtenfels (Lkr);20 bis unter 21;695;386;309
09478;      Lichtenfels (Lkr);21 bis unter 22;687;364;323
09478;      Lichtenfels (Lkr);22 bis unter 23;709;380;329
09478;      Lichtenfels (Lkr);23 bis unter 24;687;358;329
09478;      Lichtenfels (Lkr);24 bis unter 25;747;401;346
09478;      Lichtenfels (Lkr);25 bis unter 26;747;402;345
09478;      Lichtenfels (Lkr);26 bis unter 27;699;382;317
09478;      Lichtenfels (Lkr);27 bis unter 28;786;412;374
09478;      Lichtenfels (Lkr);28 bis unter 29;789;413;376
09478;      Lichtenfels (Lkr);29 bis unter 30;754;397;357
09478;      Lichtenfels (Lkr);30 bis unter 31;750;389;361
09478;      Lichtenfels (Lkr);31 bis unter 32;709;380;329
09478;      Lichtenfels (Lkr);32 bis unter 33;720;360;360
09478;      Lichtenfels (Lkr);33 bis unter 34;812;406;406
09478;      Lichtenfels (Lkr);34 bis unter 35;681;359;322
09478;      Lichtenfels (Lkr);35 bis unter 36;730;359;371
09478;      Lichtenfels (Lkr);36 bis unter 37;762;375;387
09478;      Lichtenfels (Lkr);37 bis unter 38;786;391;395
09478;      Lichtenfels (Lkr);38 bis unter 39;810;398;412
09478;      Lichtenfels (Lkr);39 bis unter 40;809;431;378
09478;      Lichtenfels (Lkr);40 bis unter 41;766;380;386
09478;      Lichtenfels (Lkr);41 bis unter 42;761;386;375
09478;      Lichtenfels (Lkr);42 bis unter 43;782;382;400
09478;      Lichtenfels (Lkr);43 bis unter 44;737;376;361
09478;      Lichtenfels (Lkr);44 bis unter 45;764;401;363
09478;      Lichtenfels (Lkr);45 bis unter 46;817;397;420
09478;      Lichtenfels (Lkr);46 bis unter 47;911;445;466
09478;      Lichtenfels (Lkr);47 bis unter 48;934;468;466
09478;      Lichtenfels (Lkr);48 bis unter 49;1016;487;529
09478;      Lichtenfels (Lkr);49 bis unter 50;1057;547;510
09478;      Lichtenfels (Lkr);50 bis unter 51;1091;563;528
09478;      Lichtenfels (Lkr);51 bis unter 52;1153;560;593
09478;      Lichtenfels (Lkr);52 bis unter 53;1156;565;591
09478;      Lichtenfels (Lkr);53 bis unter 54;1227;619;608
09478;      Lichtenfels (Lkr);54 bis unter 55;1294;677;617
09478;      Lichtenfels (Lkr);55 bis unter 56;1200;612;588
09478;      Lichtenfels (Lkr);56 bis unter 57;1192;611;581
09478;      Lichtenfels (Lkr);57 bis unter 58;1221;624;597
09478;      Lichtenfels (Lkr);58 bis unter 59;1136;587;549
09478;      Lichtenfels (Lkr);59 bis unter 60;1146;555;591
09478;      Lichtenfels (Lkr);60 bis unter 61;1100;529;571
09478;      Lichtenfels (Lkr);61 bis unter 62;977;481;496
09478;      Lichtenfels (Lkr);62 bis unter 63;988;482;506
09478;      Lichtenfels (Lkr);63 bis unter 64;993;532;461
09478;      Lichtenfels (Lkr);64 bis unter 65;893;431;462
09478;      Lichtenfels (Lkr);65 bis unter 66;892;444;448
09478;      Lichtenfels (Lkr);66 bis unter 67;874;433;441
09478;      Lichtenfels (Lkr);67 bis unter 68;850;437;413
09478;      Lichtenfels (Lkr);68 bis unter 69;807;379;428
09478;      Lichtenfels (Lkr);69 bis unter 70;733;370;363
09478;      Lichtenfels (Lkr);70 bis unter 71;715;344;371
09478;      Lichtenfels (Lkr);71 bis unter 72;695;347;348
09478;      Lichtenfels (Lkr);72 bis unter 73;557;247;310
09478;      Lichtenfels (Lkr);73 bis unter 74;439;204;235
09478;      Lichtenfels (Lkr);74 bis unter 75;580;269;311
09478;      Lichtenfels (Lkr);75 bis unter 76;542;253;289
09478;      Lichtenfels (Lkr);76 bis unter 77;586;271;315
09478;      Lichtenfels (Lkr);77 bis unter 78;684;329;355
09478;      Lichtenfels (Lkr);78 bis unter 79;787;356;431
09478;      Lichtenfels (Lkr);79 bis unter 80;744;321;423
09478;      Lichtenfels (Lkr);80 bis unter 81;665;276;389
09478;      Lichtenfels (Lkr);81 bis unter 82;578;239;339
09478;      Lichtenfels (Lkr);82 bis unter 83;544;228;316
09478;      Lichtenfels (Lkr);83 bis unter 84;499;212;287
09478;      Lichtenfels (Lkr);84 bis unter 85;411;141;270
09478;      Lichtenfels (Lkr);85 bis unter 90;1299;444;855
09478;      Lichtenfels (Lkr);90 bis unter 95;498;133;365
09478;      Lichtenfels (Lkr);95 oder älter;106;15;91
09478;      Lichtenfels (Lkr);Insgesamt;66838;33027;33811
09479;      Wunsiedel i.Fichtelgebirge (Lkr);unter 1;565;287;278
09479;      Wunsiedel i.Fichtelgebirge (Lkr);1 bis unter 2;653;330;323
09479;      Wunsiedel i.Fichtelgebirge (Lkr);2 bis unter 3;606;315;291
09479;      Wunsiedel i.Fichtelgebirge (Lkr);3 bis unter 4;551;284;267
09479;      Wunsiedel i.Fichtelgebirge (Lkr);4 bis unter 5;550;307;243
09479;      Wunsiedel i.Fichtelgebirge (Lkr);5 bis unter 6;521;277;244
09479;      Wunsiedel i.Fichtelgebirge (Lkr);6 bis unter 7;561;298;263
09479;      Wunsiedel i.Fichtelgebirge (Lkr);7 bis unter 8;576;307;269
09479;      Wunsiedel i.Fichtelgebirge (Lkr);8 bis unter 9;569;299;270
09479;      Wunsiedel i.Fichtelgebirge (Lkr);9 bis unter 10;523;255;268
09479;      Wunsiedel i.Fichtelgebirge (Lkr);10 bis unter 11;577;307;270
09479;      Wunsiedel i.Fichtelgebirge (Lkr);11 bis unter 12;566;290;276
09479;      Wunsiedel i.Fichtelgebirge (Lkr);12 bis unter 13;563;289;274
09479;      Wunsiedel i.Fichtelgebirge (Lkr);13 bis unter 14;606;297;309
09479;      Wunsiedel i.Fichtelgebirge (Lkr);14 bis unter 15;596;287;309
09479;      Wunsiedel i.Fichtelgebirge (Lkr);15 bis unter 16;662;341;321
09479;      Wunsiedel i.Fichtelgebirge (Lkr);16 bis unter 17;663;353;310
09479;      Wunsiedel i.Fichtelgebirge (Lkr);17 bis unter 18;705;361;344
09479;      Wunsiedel i.Fichtelgebirge (Lkr);18 bis unter 19;726;413;313
09479;      Wunsiedel i.Fichtelgebirge (Lkr);19 bis unter 20;720;401;319
09479;      Wunsiedel i.Fichtelgebirge (Lkr);20 bis unter 21;736;398;338
09479;      Wunsiedel i.Fichtelgebirge (Lkr);21 bis unter 22;760;403;357
09479;      Wunsiedel i.Fichtelgebirge (Lkr);22 bis unter 23;675;332;343
09479;      Wunsiedel i.Fichtelgebirge (Lkr);23 bis unter 24;712;370;342
09479;      Wunsiedel i.Fichtelgebirge (Lkr);24 bis unter 25;750;411;339
09479;      Wunsiedel i.Fichtelgebirge (Lkr);25 bis unter 26;746;389;357
09479;      Wunsiedel i.Fichtelgebirge (Lkr);26 bis unter 27;760;386;374
09479;      Wunsiedel i.Fichtelgebirge (Lkr);27 bis unter 28;738;416;322
09479;      Wunsiedel i.Fichtelgebirge (Lkr);28 bis unter 29;749;394;355
09479;      Wunsiedel i.Fichtelgebirge (Lkr);29 bis unter 30;733;386;347
09479;      Wunsiedel i.Fichtelgebirge (Lkr);30 bis unter 31;725;410;315
09479;      Wunsiedel i.Fichtelgebirge (Lkr);31 bis unter 32;709;351;358
09479;      Wunsiedel i.Fichtelgebirge (Lkr);32 bis unter 33;710;377;333
09479;      Wunsiedel i.Fichtelgebirge (Lkr);33 bis unter 34;732;380;352
09479;      Wunsiedel i.Fichtelgebirge (Lkr);34 bis unter 35;769;393;376
09479;      Wunsiedel i.Fichtelgebirge (Lkr);35 bis unter 36;768;385;383
09479;      Wunsiedel i.Fichtelgebirge (Lkr);36 bis unter 37;790;380;410
09479;      Wunsiedel i.Fichtelgebirge (Lkr);37 bis unter 38;748;397;351
09479;      Wunsiedel i.Fichtelgebirge (Lkr);38 bis unter 39;789;391;398
09479;      Wunsiedel i.Fichtelgebirge (Lkr);39 bis unter 40;774;397;377
09479;      Wunsiedel i.Fichtelgebirge (Lkr);40 bis unter 41;735;363;372
09479;      Wunsiedel i.Fichtelgebirge (Lkr);41 bis unter 42;739;362;377
09479;      Wunsiedel i.Fichtelgebirge (Lkr);42 bis unter 43;746;377;369
09479;      Wunsiedel i.Fichtelgebirge (Lkr);43 bis unter 44;713;342;371
09479;      Wunsiedel i.Fichtelgebirge (Lkr);44 bis unter 45;766;379;387
09479;      Wunsiedel i.Fichtelgebirge (Lkr);45 bis unter 46;781;367;414
09479;      Wunsiedel i.Fichtelgebirge (Lkr);46 bis unter 47;878;456;422
09479;      Wunsiedel i.Fichtelgebirge (Lkr);47 bis unter 48;1031;510;521
09479;      Wunsiedel i.Fichtelgebirge (Lkr);48 bis unter 49;1073;521;552
09479;      Wunsiedel i.Fichtelgebirge (Lkr);49 bis unter 50;1131;584;547
09479;      Wunsiedel i.Fichtelgebirge (Lkr);50 bis unter 51;1197;588;609
09479;      Wunsiedel i.Fichtelgebirge (Lkr);51 bis unter 52;1281;662;619
09479;      Wunsiedel i.Fichtelgebirge (Lkr);52 bis unter 53;1241;612;629
09479;      Wunsiedel i.Fichtelgebirge (Lkr);53 bis unter 54;1269;617;652
09479;      Wunsiedel i.Fichtelgebirge (Lkr);54 bis unter 55;1314;636;678
09479;      Wunsiedel i.Fichtelgebirge (Lkr);55 bis unter 56;1343;669;674
09479;      Wunsiedel i.Fichtelgebirge (Lkr);56 bis unter 57;1295;663;632
09479;      Wunsiedel i.Fichtelgebirge (Lkr);57 bis unter 58;1299;670;629
09479;      Wunsiedel i.Fichtelgebirge (Lkr);58 bis unter 59;1324;674;650
09479;      Wunsiedel i.Fichtelgebirge (Lkr);59 bis unter 60;1308;658;650
09479;      Wunsiedel i.Fichtelgebirge (Lkr);60 bis unter 61;1205;600;605
09479;      Wunsiedel i.Fichtelgebirge (Lkr);61 bis unter 62;1166;593;573
09479;      Wunsiedel i.Fichtelgebirge (Lkr);62 bis unter 63;1113;532;581
09479;      Wunsiedel i.Fichtelgebirge (Lkr);63 bis unter 64;996;508;488
09479;      Wunsiedel i.Fichtelgebirge (Lkr);64 bis unter 65;1009;510;499
09479;      Wunsiedel i.Fichtelgebirge (Lkr);65 bis unter 66;1041;483;558
09479;      Wunsiedel i.Fichtelgebirge (Lkr);66 bis unter 67;1094;515;579
09479;      Wunsiedel i.Fichtelgebirge (Lkr);67 bis unter 68;967;444;523
09479;      Wunsiedel i.Fichtelgebirge (Lkr);68 bis unter 69;984;473;511
09479;      Wunsiedel i.Fichtelgebirge (Lkr);69 bis unter 70;997;505;492
09479;      Wunsiedel i.Fichtelgebirge (Lkr);70 bis unter 71;941;440;501
09479;      Wunsiedel i.Fichtelgebirge (Lkr);71 bis unter 72;884;446;438
09479;      Wunsiedel i.Fichtelgebirge (Lkr);72 bis unter 73;724;329;395
09479;      Wunsiedel i.Fichtelgebirge (Lkr);73 bis unter 74;624;291;333
09479;      Wunsiedel i.Fichtelgebirge (Lkr);74 bis unter 75;758;349;409
09479;      Wunsiedel i.Fichtelgebirge (Lkr);75 bis unter 76;746;343;403
09479;      Wunsiedel i.Fichtelgebirge (Lkr);76 bis unter 77;715;327;388
09479;      Wunsiedel i.Fichtelgebirge (Lkr);77 bis unter 78;866;362;504
09479;      Wunsiedel i.Fichtelgebirge (Lkr);78 bis unter 79;961;425;536
09479;      Wunsiedel i.Fichtelgebirge (Lkr);79 bis unter 80;909;406;503
09479;      Wunsiedel i.Fichtelgebirge (Lkr);80 bis unter 81;872;333;539
09479;      Wunsiedel i.Fichtelgebirge (Lkr);81 bis unter 82;704;284;420
09479;      Wunsiedel i.Fichtelgebirge (Lkr);82 bis unter 83;686;263;423
09479;      Wunsiedel i.Fichtelgebirge (Lkr);83 bis unter 84;629;223;406
09479;      Wunsiedel i.Fichtelgebirge (Lkr);84 bis unter 85;536;187;349
09479;      Wunsiedel i.Fichtelgebirge (Lkr);85 bis unter 90;1799;572;1227
09479;      Wunsiedel i.Fichtelgebirge (Lkr);90 bis unter 95;694;192;502
09479;      Wunsiedel i.Fichtelgebirge (Lkr);95 oder älter;162;29;133
09479;      Wunsiedel i.Fichtelgebirge (Lkr);Insgesamt;73178;35718;37460
LK094;    Landkreise Oberfranken;unter 1;6888;3479;3409
LK094;    Landkreise Oberfranken;1 bis unter 2;7141;3584;3557
LK094;    Landkreise Oberfranken;2 bis unter 3;7292;3748;3544
LK094;    Landkreise Oberfranken;3 bis unter 4;6954;3481;3473
LK094;    Landkreise Oberfranken;4 bis unter 5;7030;3655;3375
LK094;    Landkreise Oberfranken;5 bis unter 6;6749;3430;3319
LK094;    Landkreise Oberfranken;6 bis unter 7;6912;3538;3374
LK094;    Landkreise Oberfranken;7 bis unter 8;6801;3561;3240
LK094;    Landkreise Oberfranken;8 bis unter 9;6887;3446;3441
LK094;    Landkreise Oberfranken;9 bis unter 10;6774;3456;3318
LK094;    Landkreise Oberfranken;10 bis unter 11;7096;3675;3421
LK094;    Landkreise Oberfranken;11 bis unter 12;6922;3543;3379
LK094;    Landkreise Oberfranken;12 bis unter 13;7037;3577;3460
LK094;    Landkreise Oberfranken;13 bis unter 14;7129;3629;3500
LK094;    Landkreise Oberfranken;14 bis unter 15;7312;3619;3693
LK094;    Landkreise Oberfranken;15 bis unter 16;7689;3886;3803
LK094;    Landkreise Oberfranken;16 bis unter 17;8064;4134;3930
LK094;    Landkreise Oberfranken;17 bis unter 18;8307;4413;3894
LK094;    Landkreise Oberfranken;18 bis unter 19;8549;4606;3943
LK094;    Landkreise Oberfranken;19 bis unter 20;8634;4604;4030
LK094;    Landkreise Oberfranken;20 bis unter 21;8546;4653;3893
LK094;    Landkreise Oberfranken;21 bis unter 22;8737;4675;4062
LK094;    Landkreise Oberfranken;22 bis unter 23;8142;4395;3747
LK094;    Landkreise Oberfranken;23 bis unter 24;7946;4207;3739
LK094;    Landkreise Oberfranken;24 bis unter 25;8353;4474;3879
LK094;    Landkreise Oberfranken;25 bis unter 26;8740;4705;4035
LK094;    Landkreise Oberfranken;26 bis unter 27;8667;4568;4099
LK094;    Landkreise Oberfranken;27 bis unter 28;8904;4783;4121
LK094;    Landkreise Oberfranken;28 bis unter 29;9256;4847;4409
LK094;    Landkreise Oberfranken;29 bis unter 30;8908;4710;4198
LK094;    Landkreise Oberfranken;30 bis unter 31;9286;4824;4462
LK094;    Landkreise Oberfranken;31 bis unter 32;9072;4707;4365
LK094;    Landkreise Oberfranken;32 bis unter 33;9174;4651;4523
LK094;    Landkreise Oberfranken;33 bis unter 34;9030;4570;4460
LK094;    Landkreise Oberfranken;34 bis unter 35;9066;4553;4513
LK094;    Landkreise Oberfranken;35 bis unter 36;9361;4785;4576
LK094;    Landkreise Oberfranken;36 bis unter 37;9817;4952;4865
LK094;    Landkreise Oberfranken;37 bis unter 38;9756;4902;4854
LK094;    Landkreise Oberfranken;38 bis unter 39;9802;4861;4941
LK094;    Landkreise Oberfranken;39 bis unter 40;9428;4755;4673
LK094;    Landkreise Oberfranken;40 bis unter 41;9335;4731;4604
LK094;    Landkreise Oberfranken;41 bis unter 42;9266;4719;4547
LK094;    Landkreise Oberfranken;42 bis unter 43;9338;4621;4717
LK094;    Landkreise Oberfranken;43 bis unter 44;9153;4627;4526
LK094;    Landkreise Oberfranken;44 bis unter 45;9445;4685;4760
LK094;    Landkreise Oberfranken;45 bis unter 46;9893;4862;5031
LK094;    Landkreise Oberfranken;46 bis unter 47;10948;5366;5582
LK094;    Landkreise Oberfranken;47 bis unter 48;12022;5953;6069
LK094;    Landkreise Oberfranken;48 bis unter 49;12600;6229;6371
LK094;    Landkreise Oberfranken;49 bis unter 50;13611;6811;6800
LK094;    Landkreise Oberfranken;50 bis unter 51;14309;7171;7138
LK094;    Landkreise Oberfranken;51 bis unter 52;14530;7358;7172
LK094;    Landkreise Oberfranken;52 bis unter 53;14765;7441;7324
LK094;    Landkreise Oberfranken;53 bis unter 54;14991;7574;7417
LK094;    Landkreise Oberfranken;54 bis unter 55;15421;7846;7575
LK094;    Landkreise Oberfranken;55 bis unter 56;15238;7811;7427
LK094;    Landkreise Oberfranken;56 bis unter 57;14977;7602;7375
LK094;    Landkreise Oberfranken;57 bis unter 58;15200;7655;7545
LK094;    Landkreise Oberfranken;58 bis unter 59;14501;7346;7155
LK094;    Landkreise Oberfranken;59 bis unter 60;14112;7165;6947
LK094;    Landkreise Oberfranken;60 bis unter 61;13248;6687;6561
LK094;    Landkreise Oberfranken;61 bis unter 62;12862;6449;6413
LK094;    Landkreise Oberfranken;62 bis unter 63;12304;6205;6099
LK094;    Landkreise Oberfranken;63 bis unter 64;11528;5747;5781
LK094;    Landkreise Oberfranken;64 bis unter 65;11171;5512;5659
LK094;    Landkreise Oberfranken;65 bis unter 66;10812;5341;5471
LK094;    Landkreise Oberfranken;66 bis unter 67;10845;5346;5499
LK094;    Landkreise Oberfranken;67 bis unter 68;10505;5136;5369
LK094;    Landkreise Oberfranken;68 bis unter 69;10198;4992;5206
LK094;    Landkreise Oberfranken;69 bis unter 70;9854;4862;4992
LK094;    Landkreise Oberfranken;70 bis unter 71;9237;4470;4767
LK094;    Landkreise Oberfranken;71 bis unter 72;8708;4251;4457
LK094;    Landkreise Oberfranken;72 bis unter 73;7248;3467;3781
LK094;    Landkreise Oberfranken;73 bis unter 74;5445;2657;2788
LK094;    Landkreise Oberfranken;74 bis unter 75;7192;3415;3777
LK094;    Landkreise Oberfranken;75 bis unter 76;6936;3204;3732
LK094;    Landkreise Oberfranken;76 bis unter 77;6570;3088;3482
LK094;    Landkreise Oberfranken;77 bis unter 78;8403;3777;4626
LK094;    Landkreise Oberfranken;78 bis unter 79;9274;4107;5167
LK094;    Landkreise Oberfranken;79 bis unter 80;9022;3926;5096
LK094;    Landkreise Oberfranken;80 bis unter 81;8056;3346;4710
LK094;    Landkreise Oberfranken;81 bis unter 82;7026;2899;4127
LK094;    Landkreise Oberfranken;82 bis unter 83;6583;2604;3979
LK094;    Landkreise Oberfranken;83 bis unter 84;5944;2344;3600
LK094;    Landkreise Oberfranken;84 bis unter 85;5103;1863;3240
LK094;    Landkreise Oberfranken;85 bis unter 90;16169;5495;10674
LK094;    Landkreise Oberfranken;90 bis unter 95;6579;1852;4727
LK094;    Landkreise Oberfranken;95 oder älter;1419;314;1105
LK094;    Landkreise Oberfranken;Insgesamt;828054;409570;418484
094;  Oberfranken;unter 1;9117;4659;4458
094;  Oberfranken;1 bis unter 2;9401;4700;4701
094;  Oberfranken;2 bis unter 3;9346;4839;4507
094;  Oberfranken;3 bis unter 4;8954;4502;4452
094;  Oberfranken;4 bis unter 5;8938;4629;4309
094;  Oberfranken;5 bis unter 6;8561;4347;4214
094;  Oberfranken;6 bis unter 7;8777;4494;4283
094;  Oberfranken;7 bis unter 8;8534;4439;4095
094;  Oberfranken;8 bis unter 9;8646;4327;4319
094;  Oberfranken;9 bis unter 10;8503;4347;4156
094;  Oberfranken;10 bis unter 11;8900;4586;4314
094;  Oberfranken;11 bis unter 12;8769;4472;4297
094;  Oberfranken;12 bis unter 13;8779;4441;4338
094;  Oberfranken;13 bis unter 14;8922;4545;4377
094;  Oberfranken;14 bis unter 15;9060;4519;4541
094;  Oberfranken;15 bis unter 16;9474;4812;4662
094;  Oberfranken;16 bis unter 17;9940;5112;4828
094;  Oberfranken;17 bis unter 18;10202;5417;4785
094;  Oberfranken;18 bis unter 19;11038;5884;5154
094;  Oberfranken;19 bis unter 20;11586;6156;5430
094;  Oberfranken;20 bis unter 21;12311;6583;5728
094;  Oberfranken;21 bis unter 22;12668;6624;6044
094;  Oberfranken;22 bis unter 23;12210;6409;5801
094;  Oberfranken;23 bis unter 24;12032;6283;5749
094;  Oberfranken;24 bis unter 25;12507;6547;5960
094;  Oberfranken;25 bis unter 26;12872;6822;6050
094;  Oberfranken;26 bis unter 27;12812;6737;6075
094;  Oberfranken;27 bis unter 28;13012;6913;6099
094;  Oberfranken;28 bis unter 29;13390;7017;6373
094;  Oberfranken;29 bis unter 30;12914;6745;6169
094;  Oberfranken;30 bis unter 31;13228;6954;6274
094;  Oberfranken;31 bis unter 32;12754;6672;6082
094;  Oberfranken;32 bis unter 33;12715;6528;6187
094;  Oberfranken;33 bis unter 34;12252;6282;5970
094;  Oberfranken;34 bis unter 35;12108;6191;5917
094;  Oberfranken;35 bis unter 36;12330;6343;5987
094;  Oberfranken;36 bis unter 37;12851;6588;6263
094;  Oberfranken;37 bis unter 38;12553;6383;6170
094;  Oberfranken;38 bis unter 39;12546;6208;6338
094;  Oberfranken;39 bis unter 40;12130;6130;6000
094;  Oberfranken;40 bis unter 41;11900;6018;5882
094;  Oberfranken;41 bis unter 42;11806;5963;5843
094;  Oberfranken;42 bis unter 43;11814;5863;5951
094;  Oberfranken;43 bis unter 44;11664;5904;5760
094;  Oberfranken;44 bis unter 45;11873;5897;5976
094;  Oberfranken;45 bis unter 46;12430;6093;6337
094;  Oberfranken;46 bis unter 47;13601;6630;6971
094;  Oberfranken;47 bis unter 48;14987;7412;7575
094;  Oberfranken;48 bis unter 49;15749;7780;7969
094;  Oberfranken;49 bis unter 50;16903;8458;8445
094;  Oberfranken;50 bis unter 51;17815;8910;8905
094;  Oberfranken;51 bis unter 52;17961;9092;8869
094;  Oberfranken;52 bis unter 53;18201;9149;9052
094;  Oberfranken;53 bis unter 54;18458;9298;9160
094;  Oberfranken;54 bis unter 55;19040;9596;9444
094;  Oberfranken;55 bis unter 56;18891;9606;9285
094;  Oberfranken;56 bis unter 57;18373;9288;9085
094;  Oberfranken;57 bis unter 58;18626;9331;9295
094;  Oberfranken;58 bis unter 59;17859;9006;8853
094;  Oberfranken;59 bis unter 60;17374;8726;8648
094;  Oberfranken;60 bis unter 61;16390;8165;8225
094;  Oberfranken;61 bis unter 62;15918;7902;8016
094;  Oberfranken;62 bis unter 63;15242;7579;7663
094;  Oberfranken;63 bis unter 64;14361;7070;7291
094;  Oberfranken;64 bis unter 65;13948;6813;7135
094;  Oberfranken;65 bis unter 66;13416;6542;6874
094;  Oberfranken;66 bis unter 67;13433;6503;6930
094;  Oberfranken;67 bis unter 68;13063;6267;6796
094;  Oberfranken;68 bis unter 69;12772;6180;6592
094;  Oberfranken;69 bis unter 70;12337;5981;6356
094;  Oberfranken;70 bis unter 71;11769;5601;6168
094;  Oberfranken;71 bis unter 72;11183;5361;5822
094;  Oberfranken;72 bis unter 73;9300;4409;4891
094;  Oberfranken;73 bis unter 74;7060;3392;3668
094;  Oberfranken;74 bis unter 75;9377;4402;4975
094;  Oberfranken;75 bis unter 76;9085;4184;4901
094;  Oberfranken;76 bis unter 77;8556;3978;4578
094;  Oberfranken;77 bis unter 78;10842;4795;6047
094;  Oberfranken;78 bis unter 79;11849;5199;6650
094;  Oberfranken;79 bis unter 80;11488;4915;6573
094;  Oberfranken;80 bis unter 81;10207;4241;5966
094;  Oberfranken;81 bis unter 82;8949;3673;5276
094;  Oberfranken;82 bis unter 83;8292;3278;5014
094;  Oberfranken;83 bis unter 84;7574;2948;4626
094;  Oberfranken;84 bis unter 85;6550;2354;4196
094;  Oberfranken;85 bis unter 90;20710;7007;13703
094;  Oberfranken;90 bis unter 95;8822;2426;6396
094;  Oberfranken;95 oder älter;2022;392;1630
094;  Oberfranken;Insgesamt;1067482;525763;541719
09561;      Ansbach (Krfr.St);unter 1;445;225;220
09561;      Ansbach (Krfr.St);1 bis unter 2;428;206;222
09561;      Ansbach (Krfr.St);2 bis unter 3;424;213;211
09561;      Ansbach (Krfr.St);3 bis unter 4;384;194;190
09561;      Ansbach (Krfr.St);4 bis unter 5;407;205;202
09561;      Ansbach (Krfr.St);5 bis unter 6;383;200;183
09561;      Ansbach (Krfr.St);6 bis unter 7;327;174;153
09561;      Ansbach (Krfr.St);7 bis unter 8;353;170;183
09561;      Ansbach (Krfr.St);8 bis unter 9;367;192;175
09561;      Ansbach (Krfr.St);9 bis unter 10;358;177;181
09561;      Ansbach (Krfr.St);10 bis unter 11;371;181;190
09561;      Ansbach (Krfr.St);11 bis unter 12;329;167;162
09561;      Ansbach (Krfr.St);12 bis unter 13;403;202;201
09561;      Ansbach (Krfr.St);13 bis unter 14;393;191;202
09561;      Ansbach (Krfr.St);14 bis unter 15;366;196;170
09561;      Ansbach (Krfr.St);15 bis unter 16;368;184;184
09561;      Ansbach (Krfr.St);16 bis unter 17;374;197;177
09561;      Ansbach (Krfr.St);17 bis unter 18;411;217;194
09561;      Ansbach (Krfr.St);18 bis unter 19;427;214;213
09561;      Ansbach (Krfr.St);19 bis unter 20;488;257;231
09561;      Ansbach (Krfr.St);20 bis unter 21;470;242;228
09561;      Ansbach (Krfr.St);21 bis unter 22;484;250;234
09561;      Ansbach (Krfr.St);22 bis unter 23;546;290;256
09561;      Ansbach (Krfr.St);23 bis unter 24;553;278;275
09561;      Ansbach (Krfr.St);24 bis unter 25;519;257;262
09561;      Ansbach (Krfr.St);25 bis unter 26;557;280;277
09561;      Ansbach (Krfr.St);26 bis unter 27;615;289;326
09561;      Ansbach (Krfr.St);27 bis unter 28;595;299;296
09561;      Ansbach (Krfr.St);28 bis unter 29;601;300;301
09561;      Ansbach (Krfr.St);29 bis unter 30;559;286;273
09561;      Ansbach (Krfr.St);30 bis unter 31;540;267;273
09561;      Ansbach (Krfr.St);31 bis unter 32;532;304;228
09561;      Ansbach (Krfr.St);32 bis unter 33;526;264;262
09561;      Ansbach (Krfr.St);33 bis unter 34;548;278;270
09561;      Ansbach (Krfr.St);34 bis unter 35;523;255;268
09561;      Ansbach (Krfr.St);35 bis unter 36;517;263;254
09561;      Ansbach (Krfr.St);36 bis unter 37;527;286;241
09561;      Ansbach (Krfr.St);37 bis unter 38;508;258;250
09561;      Ansbach (Krfr.St);38 bis unter 39;531;250;281
09561;      Ansbach (Krfr.St);39 bis unter 40;496;245;251
09561;      Ansbach (Krfr.St);40 bis unter 41;484;234;250
09561;      Ansbach (Krfr.St);41 bis unter 42;470;228;242
09561;      Ansbach (Krfr.St);42 bis unter 43;474;239;235
09561;      Ansbach (Krfr.St);43 bis unter 44;476;214;262
09561;      Ansbach (Krfr.St);44 bis unter 45;458;218;240
09561;      Ansbach (Krfr.St);45 bis unter 46;486;237;249
09561;      Ansbach (Krfr.St);46 bis unter 47;498;243;255
09561;      Ansbach (Krfr.St);47 bis unter 48;558;245;313
09561;      Ansbach (Krfr.St);48 bis unter 49;567;286;281
09561;      Ansbach (Krfr.St);49 bis unter 50;621;301;320
09561;      Ansbach (Krfr.St);50 bis unter 51;648;324;324
09561;      Ansbach (Krfr.St);51 bis unter 52;610;312;298
09561;      Ansbach (Krfr.St);52 bis unter 53;708;350;358
09561;      Ansbach (Krfr.St);53 bis unter 54;654;298;356
09561;      Ansbach (Krfr.St);54 bis unter 55;685;329;356
09561;      Ansbach (Krfr.St);55 bis unter 56;662;302;360
09561;      Ansbach (Krfr.St);56 bis unter 57;648;328;320
09561;      Ansbach (Krfr.St);57 bis unter 58;709;360;349
09561;      Ansbach (Krfr.St);58 bis unter 59;616;307;309
09561;      Ansbach (Krfr.St);59 bis unter 60;629;302;327
09561;      Ansbach (Krfr.St);60 bis unter 61;582;269;313
09561;      Ansbach (Krfr.St);61 bis unter 62;562;254;308
09561;      Ansbach (Krfr.St);62 bis unter 63;570;258;312
09561;      Ansbach (Krfr.St);63 bis unter 64;531;263;268
09561;      Ansbach (Krfr.St);64 bis unter 65;503;229;274
09561;      Ansbach (Krfr.St);65 bis unter 66;434;205;229
09561;      Ansbach (Krfr.St);66 bis unter 67;491;224;267
09561;      Ansbach (Krfr.St);67 bis unter 68;439;198;241
09561;      Ansbach (Krfr.St);68 bis unter 69;451;199;252
09561;      Ansbach (Krfr.St);69 bis unter 70;472;229;243
09561;      Ansbach (Krfr.St);70 bis unter 71;439;201;238
09561;      Ansbach (Krfr.St);71 bis unter 72;407;184;223
09561;      Ansbach (Krfr.St);72 bis unter 73;360;149;211
09561;      Ansbach (Krfr.St);73 bis unter 74;250;103;147
09561;      Ansbach (Krfr.St);74 bis unter 75;346;149;197
09561;      Ansbach (Krfr.St);75 bis unter 76;344;161;183
09561;      Ansbach (Krfr.St);76 bis unter 77;347;159;188
09561;      Ansbach (Krfr.St);77 bis unter 78;466;195;271
09561;      Ansbach (Krfr.St);78 bis unter 79;431;181;250
09561;      Ansbach (Krfr.St);79 bis unter 80;428;173;255
09561;      Ansbach (Krfr.St);80 bis unter 81;368;161;207
09561;      Ansbach (Krfr.St);81 bis unter 82;341;143;198
09561;      Ansbach (Krfr.St);82 bis unter 83;284;118;166
09561;      Ansbach (Krfr.St);83 bis unter 84;299;100;199
09561;      Ansbach (Krfr.St);84 bis unter 85;243;91;152
09561;      Ansbach (Krfr.St);85 bis unter 90;772;278;494
09561;      Ansbach (Krfr.St);90 bis unter 95;360;97;263
09561;      Ansbach (Krfr.St);95 oder älter;113;17;96
09561;      Ansbach (Krfr.St);Insgesamt;41847;20048;21799
09562;      Erlangen (Krfr.St);unter 1;1147;591;556
09562;      Erlangen (Krfr.St);1 bis unter 2;1087;556;531
09562;      Erlangen (Krfr.St);2 bis unter 3;1123;579;544
09562;      Erlangen (Krfr.St);3 bis unter 4;1110;579;531
09562;      Erlangen (Krfr.St);4 bis unter 5;1010;522;488
09562;      Erlangen (Krfr.St);5 bis unter 6;1023;488;535
09562;      Erlangen (Krfr.St);6 bis unter 7;925;476;449
09562;      Erlangen (Krfr.St);7 bis unter 8;922;470;452
09562;      Erlangen (Krfr.St);8 bis unter 9;951;515;436
09562;      Erlangen (Krfr.St);9 bis unter 10;940;474;466
09562;      Erlangen (Krfr.St);10 bis unter 11;950;499;451
09562;      Erlangen (Krfr.St);11 bis unter 12;938;479;459
09562;      Erlangen (Krfr.St);12 bis unter 13;921;485;436
09562;      Erlangen (Krfr.St);13 bis unter 14;914;488;426
09562;      Erlangen (Krfr.St);14 bis unter 15;932;488;444
09562;      Erlangen (Krfr.St);15 bis unter 16;910;474;436
09562;      Erlangen (Krfr.St);16 bis unter 17;945;464;481
09562;      Erlangen (Krfr.St);17 bis unter 18;929;513;416
09562;      Erlangen (Krfr.St);18 bis unter 19;1060;548;512
09562;      Erlangen (Krfr.St);19 bis unter 20;1325;669;656
09562;      Erlangen (Krfr.St);20 bis unter 21;1663;837;826
09562;      Erlangen (Krfr.St);21 bis unter 22;1753;841;912
09562;      Erlangen (Krfr.St);22 bis unter 23;1909;948;961
09562;      Erlangen (Krfr.St);23 bis unter 24;2017;1039;978
09562;      Erlangen (Krfr.St);24 bis unter 25;2082;1066;1016
09562;      Erlangen (Krfr.St);25 bis unter 26;2229;1170;1059
09562;      Erlangen (Krfr.St);26 bis unter 27;2209;1180;1029
09562;      Erlangen (Krfr.St);27 bis unter 28;2307;1291;1016
09562;      Erlangen (Krfr.St);28 bis unter 29;2351;1263;1088
09562;      Erlangen (Krfr.St);29 bis unter 30;2207;1204;1003
09562;      Erlangen (Krfr.St);30 bis unter 31;2097;1130;967
09562;      Erlangen (Krfr.St);31 bis unter 32;1985;1101;884
09562;      Erlangen (Krfr.St);32 bis unter 33;1771;942;829
09562;      Erlangen (Krfr.St);33 bis unter 34;1730;864;866
09562;      Erlangen (Krfr.St);34 bis unter 35;1645;869;776
09562;      Erlangen (Krfr.St);35 bis unter 36;1665;883;782
09562;      Erlangen (Krfr.St);36 bis unter 37;1631;844;787
09562;      Erlangen (Krfr.St);37 bis unter 38;1566;815;751
09562;      Erlangen (Krfr.St);38 bis unter 39;1480;811;669
09562;      Erlangen (Krfr.St);39 bis unter 40;1424;744;680
09562;      Erlangen (Krfr.St);40 bis unter 41;1357;691;666
09562;      Erlangen (Krfr.St);41 bis unter 42;1282;626;656
09562;      Erlangen (Krfr.St);42 bis unter 43;1230;630;600
09562;      Erlangen (Krfr.St);43 bis unter 44;1169;590;579
09562;      Erlangen (Krfr.St);44 bis unter 45;1218;609;609
09562;      Erlangen (Krfr.St);45 bis unter 46;1208;594;614
09562;      Erlangen (Krfr.St);46 bis unter 47;1276;633;643
09562;      Erlangen (Krfr.St);47 bis unter 48;1402;715;687
09562;      Erlangen (Krfr.St);48 bis unter 49;1472;733;739
09562;      Erlangen (Krfr.St);49 bis unter 50;1466;773;693
09562;      Erlangen (Krfr.St);50 bis unter 51;1623;797;826
09562;      Erlangen (Krfr.St);51 bis unter 52;1637;824;813
09562;      Erlangen (Krfr.St);52 bis unter 53;1722;887;835
09562;      Erlangen (Krfr.St);53 bis unter 54;1627;799;828
09562;      Erlangen (Krfr.St);54 bis unter 55;1560;779;781
09562;      Erlangen (Krfr.St);55 bis unter 56;1607;810;797
09562;      Erlangen (Krfr.St);56 bis unter 57;1491;778;713
09562;      Erlangen (Krfr.St);57 bis unter 58;1511;741;770
09562;      Erlangen (Krfr.St);58 bis unter 59;1414;705;709
09562;      Erlangen (Krfr.St);59 bis unter 60;1388;677;711
09562;      Erlangen (Krfr.St);60 bis unter 61;1240;636;604
09562;      Erlangen (Krfr.St);61 bis unter 62;1200;596;604
09562;      Erlangen (Krfr.St);62 bis unter 63;1153;568;585
09562;      Erlangen (Krfr.St);63 bis unter 64;1095;519;576
09562;      Erlangen (Krfr.St);64 bis unter 65;1046;498;548
09562;      Erlangen (Krfr.St);65 bis unter 66;951;452;499
09562;      Erlangen (Krfr.St);66 bis unter 67;1015;474;541
09562;      Erlangen (Krfr.St);67 bis unter 68;984;431;553
09562;      Erlangen (Krfr.St);68 bis unter 69;950;440;510
09562;      Erlangen (Krfr.St);69 bis unter 70;918;409;509
09562;      Erlangen (Krfr.St);70 bis unter 71;905;425;480
09562;      Erlangen (Krfr.St);71 bis unter 72;886;413;473
09562;      Erlangen (Krfr.St);72 bis unter 73;803;349;454
09562;      Erlangen (Krfr.St);73 bis unter 74;615;289;326
09562;      Erlangen (Krfr.St);74 bis unter 75;843;391;452
09562;      Erlangen (Krfr.St);75 bis unter 76;852;377;475
09562;      Erlangen (Krfr.St);76 bis unter 77;756;350;406
09562;      Erlangen (Krfr.St);77 bis unter 78;987;420;567
09562;      Erlangen (Krfr.St);78 bis unter 79;974;408;566
09562;      Erlangen (Krfr.St);79 bis unter 80;931;400;531
09562;      Erlangen (Krfr.St);80 bis unter 81;847;360;487
09562;      Erlangen (Krfr.St);81 bis unter 82;721;294;427
09562;      Erlangen (Krfr.St);82 bis unter 83;740;313;427
09562;      Erlangen (Krfr.St);83 bis unter 84;631;248;383
09562;      Erlangen (Krfr.St);84 bis unter 85;580;215;365
09562;      Erlangen (Krfr.St);85 bis unter 90;1853;690;1163
09562;      Erlangen (Krfr.St);90 bis unter 95;851;264;587
09562;      Erlangen (Krfr.St);95 oder älter;192;45;147
09562;      Erlangen (Krfr.St);Insgesamt;111962;55864;56098
09563;      Fürth (Krfr.St);unter 1;1357;677;680
09563;      Fürth (Krfr.St);1 bis unter 2;1390;711;679
09563;      Fürth (Krfr.St);2 bis unter 3;1342;684;658
09563;      Fürth (Krfr.St);3 bis unter 4;1270;672;598
09563;      Fürth (Krfr.St);4 bis unter 5;1208;611;597
09563;      Fürth (Krfr.St);5 bis unter 6;1165;608;557
09563;      Fürth (Krfr.St);6 bis unter 7;1096;559;537
09563;      Fürth (Krfr.St);7 bis unter 8;1043;538;505
09563;      Fürth (Krfr.St);8 bis unter 9;1070;600;470
09563;      Fürth (Krfr.St);9 bis unter 10;1043;570;473
09563;      Fürth (Krfr.St);10 bis unter 11;1042;565;477
09563;      Fürth (Krfr.St);11 bis unter 12;1085;552;533
09563;      Fürth (Krfr.St);12 bis unter 13;1033;524;509
09563;      Fürth (Krfr.St);13 bis unter 14;1037;549;488
09563;      Fürth (Krfr.St);14 bis unter 15;1074;548;526
09563;      Fürth (Krfr.St);15 bis unter 16;1115;572;543
09563;      Fürth (Krfr.St);16 bis unter 17;1070;576;494
09563;      Fürth (Krfr.St);17 bis unter 18;1173;617;556
09563;      Fürth (Krfr.St);18 bis unter 19;1264;671;593
09563;      Fürth (Krfr.St);19 bis unter 20;1344;696;648
09563;      Fürth (Krfr.St);20 bis unter 21;1386;714;672
09563;      Fürth (Krfr.St);21 bis unter 22;1415;741;674
09563;      Fürth (Krfr.St);22 bis unter 23;1533;774;759
09563;      Fürth (Krfr.St);23 bis unter 24;1541;820;721
09563;      Fürth (Krfr.St);24 bis unter 25;1637;849;788
09563;      Fürth (Krfr.St);25 bis unter 26;1652;873;779
09563;      Fürth (Krfr.St);26 bis unter 27;1736;913;823
09563;      Fürth (Krfr.St);27 bis unter 28;1815;931;884
09563;      Fürth (Krfr.St);28 bis unter 29;1894;937;957
09563;      Fürth (Krfr.St);29 bis unter 30;1920;1022;898
09563;      Fürth (Krfr.St);30 bis unter 31;1970;1006;964
09563;      Fürth (Krfr.St);31 bis unter 32;1912;977;935
09563;      Fürth (Krfr.St);32 bis unter 33;1919;970;949
09563;      Fürth (Krfr.St);33 bis unter 34;1812;914;898
09563;      Fürth (Krfr.St);34 bis unter 35;1886;952;934
09563;      Fürth (Krfr.St);35 bis unter 36;1874;976;898
09563;      Fürth (Krfr.St);36 bis unter 37;1943;989;954
09563;      Fürth (Krfr.St);37 bis unter 38;1847;880;967
09563;      Fürth (Krfr.St);38 bis unter 39;1863;942;921
09563;      Fürth (Krfr.St);39 bis unter 40;1812;865;947
09563;      Fürth (Krfr.St);40 bis unter 41;1765;858;907
09563;      Fürth (Krfr.St);41 bis unter 42;1665;828;837
09563;      Fürth (Krfr.St);42 bis unter 43;1733;862;871
09563;      Fürth (Krfr.St);43 bis unter 44;1651;844;807
09563;      Fürth (Krfr.St);44 bis unter 45;1634;818;816
09563;      Fürth (Krfr.St);45 bis unter 46;1579;755;824
09563;      Fürth (Krfr.St);46 bis unter 47;1711;857;854
09563;      Fürth (Krfr.St);47 bis unter 48;1840;885;955
09563;      Fürth (Krfr.St);48 bis unter 49;1783;868;915
09563;      Fürth (Krfr.St);49 bis unter 50;2063;1000;1063
09563;      Fürth (Krfr.St);50 bis unter 51;2206;1119;1087
09563;      Fürth (Krfr.St);51 bis unter 52;2106;1038;1068
09563;      Fürth (Krfr.St);52 bis unter 53;2139;1056;1083
09563;      Fürth (Krfr.St);53 bis unter 54;2106;1057;1049
09563;      Fürth (Krfr.St);54 bis unter 55;2110;1093;1017
09563;      Fürth (Krfr.St);55 bis unter 56;2151;1048;1103
09563;      Fürth (Krfr.St);56 bis unter 57;2096;1039;1057
09563;      Fürth (Krfr.St);57 bis unter 58;1956;967;989
09563;      Fürth (Krfr.St);58 bis unter 59;1874;941;933
09563;      Fürth (Krfr.St);59 bis unter 60;1724;818;906
09563;      Fürth (Krfr.St);60 bis unter 61;1765;863;902
09563;      Fürth (Krfr.St);61 bis unter 62;1562;788;774
09563;      Fürth (Krfr.St);62 bis unter 63;1627;817;810
09563;      Fürth (Krfr.St);63 bis unter 64;1524;728;796
09563;      Fürth (Krfr.St);64 bis unter 65;1404;678;726
09563;      Fürth (Krfr.St);65 bis unter 66;1308;604;704
09563;      Fürth (Krfr.St);66 bis unter 67;1294;573;721
09563;      Fürth (Krfr.St);67 bis unter 68;1273;581;692
09563;      Fürth (Krfr.St);68 bis unter 69;1188;549;639
09563;      Fürth (Krfr.St);69 bis unter 70;1144;500;644
09563;      Fürth (Krfr.St);70 bis unter 71;1168;552;616
09563;      Fürth (Krfr.St);71 bis unter 72;1165;539;626
09563;      Fürth (Krfr.St);72 bis unter 73;984;430;554
09563;      Fürth (Krfr.St);73 bis unter 74;882;399;483
09563;      Fürth (Krfr.St);74 bis unter 75;1004;462;542
09563;      Fürth (Krfr.St);75 bis unter 76;1130;523;607
09563;      Fürth (Krfr.St);76 bis unter 77;912;394;518
09563;      Fürth (Krfr.St);77 bis unter 78;1127;488;639
09563;      Fürth (Krfr.St);78 bis unter 79;1118;465;653
09563;      Fürth (Krfr.St);79 bis unter 80;1071;428;643
09563;      Fürth (Krfr.St);80 bis unter 81;959;393;566
09563;      Fürth (Krfr.St);81 bis unter 82;831;302;529
09563;      Fürth (Krfr.St);82 bis unter 83;768;315;453
09563;      Fürth (Krfr.St);83 bis unter 84;678;243;435
09563;      Fürth (Krfr.St);84 bis unter 85;579;217;362
09563;      Fürth (Krfr.St);85 bis unter 90;1853;623;1230
09563;      Fürth (Krfr.St);90 bis unter 95;761;213;548
09563;      Fürth (Krfr.St);95 oder älter;189;40;149
09563;      Fürth (Krfr.St);Insgesamt;127748;62603;65145
09564;      Nürnberg (Krfr.St);unter 1;5516;2807;2709
09564;      Nürnberg (Krfr.St);1 bis unter 2;5303;2734;2569
09564;      Nürnberg (Krfr.St);2 bis unter 3;5278;2753;2525
09564;      Nürnberg (Krfr.St);3 bis unter 4;4889;2540;2349
09564;      Nürnberg (Krfr.St);4 bis unter 5;4905;2498;2407
09564;      Nürnberg (Krfr.St);5 bis unter 6;4519;2317;2202
09564;      Nürnberg (Krfr.St);6 bis unter 7;4534;2355;2179
09564;      Nürnberg (Krfr.St);7 bis unter 8;4328;2198;2130
09564;      Nürnberg (Krfr.St);8 bis unter 9;4353;2252;2101
09564;      Nürnberg (Krfr.St);9 bis unter 10;4250;2207;2043
09564;      Nürnberg (Krfr.St);10 bis unter 11;4306;2217;2089
09564;      Nürnberg (Krfr.St);11 bis unter 12;4518;2328;2190
09564;      Nürnberg (Krfr.St);12 bis unter 13;4320;2241;2079
09564;      Nürnberg (Krfr.St);13 bis unter 14;4223;2160;2063
09564;      Nürnberg (Krfr.St);14 bis unter 15;4333;2171;2162
09564;      Nürnberg (Krfr.St);15 bis unter 16;4207;2196;2011
09564;      Nürnberg (Krfr.St);16 bis unter 17;4322;2266;2056
09564;      Nürnberg (Krfr.St);17 bis unter 18;4395;2303;2092
09564;      Nürnberg (Krfr.St);18 bis unter 19;4696;2427;2269
09564;      Nürnberg (Krfr.St);19 bis unter 20;5154;2673;2481
09564;      Nürnberg (Krfr.St);20 bis unter 21;5659;2874;2785
09564;      Nürnberg (Krfr.St);21 bis unter 22;6285;3167;3118
09564;      Nürnberg (Krfr.St);22 bis unter 23;6566;3253;3313
09564;      Nürnberg (Krfr.St);23 bis unter 24;6848;3415;3433
09564;      Nürnberg (Krfr.St);24 bis unter 25;7477;3798;3679
09564;      Nürnberg (Krfr.St);25 bis unter 26;7793;3944;3849
09564;      Nürnberg (Krfr.St);26 bis unter 27;8063;4049;4014
09564;      Nürnberg (Krfr.St);27 bis unter 28;8322;4197;4125
09564;      Nürnberg (Krfr.St);28 bis unter 29;8878;4434;4444
09564;      Nürnberg (Krfr.St);29 bis unter 30;8680;4436;4244
09564;      Nürnberg (Krfr.St);30 bis unter 31;8688;4504;4184
09564;      Nürnberg (Krfr.St);31 bis unter 32;8324;4310;4014
09564;      Nürnberg (Krfr.St);32 bis unter 33;8031;4097;3934
09564;      Nürnberg (Krfr.St);33 bis unter 34;7478;3843;3635
09564;      Nürnberg (Krfr.St);34 bis unter 35;7545;3800;3745
09564;      Nürnberg (Krfr.St);35 bis unter 36;7439;3904;3535
09564;      Nürnberg (Krfr.St);36 bis unter 37;7520;3750;3770
09564;      Nürnberg (Krfr.St);37 bis unter 38;7459;3754;3705
09564;      Nürnberg (Krfr.St);38 bis unter 39;7367;3666;3701
09564;      Nürnberg (Krfr.St);39 bis unter 40;6912;3420;3492
09564;      Nürnberg (Krfr.St);40 bis unter 41;6768;3391;3377
09564;      Nürnberg (Krfr.St);41 bis unter 42;6569;3328;3241
09564;      Nürnberg (Krfr.St);42 bis unter 43;6748;3330;3418
09564;      Nürnberg (Krfr.St);43 bis unter 44;6325;3111;3214
09564;      Nürnberg (Krfr.St);44 bis unter 45;6344;3086;3258
09564;      Nürnberg (Krfr.St);45 bis unter 46;6103;3051;3052
09564;      Nürnberg (Krfr.St);46 bis unter 47;6581;3300;3281
09564;      Nürnberg (Krfr.St);47 bis unter 48;6886;3407;3479
09564;      Nürnberg (Krfr.St);48 bis unter 49;7228;3590;3638
09564;      Nürnberg (Krfr.St);49 bis unter 50;7558;3844;3714
09564;      Nürnberg (Krfr.St);50 bis unter 51;7784;4056;3728
09564;      Nürnberg (Krfr.St);51 bis unter 52;8031;4053;3978
09564;      Nürnberg (Krfr.St);52 bis unter 53;7663;3952;3711
09564;      Nürnberg (Krfr.St);53 bis unter 54;7705;3967;3738
09564;      Nürnberg (Krfr.St);54 bis unter 55;7789;3966;3823
09564;      Nürnberg (Krfr.St);55 bis unter 56;7474;3738;3736
09564;      Nürnberg (Krfr.St);56 bis unter 57;7152;3598;3554
09564;      Nürnberg (Krfr.St);57 bis unter 58;7002;3409;3593
09564;      Nürnberg (Krfr.St);58 bis unter 59;6889;3373;3516
09564;      Nürnberg (Krfr.St);59 bis unter 60;6482;3206;3276
09564;      Nürnberg (Krfr.St);60 bis unter 61;6294;3087;3207
09564;      Nürnberg (Krfr.St);61 bis unter 62;6110;2940;3170
09564;      Nürnberg (Krfr.St);62 bis unter 63;5953;2905;3048
09564;      Nürnberg (Krfr.St);63 bis unter 64;5707;2714;2993
09564;      Nürnberg (Krfr.St);64 bis unter 65;5484;2498;2986
09564;      Nürnberg (Krfr.St);65 bis unter 66;5167;2380;2787
09564;      Nürnberg (Krfr.St);66 bis unter 67;5304;2409;2895
09564;      Nürnberg (Krfr.St);67 bis unter 68;5042;2273;2769
09564;      Nürnberg (Krfr.St);68 bis unter 69;5076;2222;2854
09564;      Nürnberg (Krfr.St);69 bis unter 70;5010;2250;2760
09564;      Nürnberg (Krfr.St);70 bis unter 71;4895;2245;2650
09564;      Nürnberg (Krfr.St);71 bis unter 72;4911;2253;2658
09564;      Nürnberg (Krfr.St);72 bis unter 73;4334;1953;2381
09564;      Nürnberg (Krfr.St);73 bis unter 74;3732;1691;2041
09564;      Nürnberg (Krfr.St);74 bis unter 75;4622;2089;2533
09564;      Nürnberg (Krfr.St);75 bis unter 76;4485;2012;2473
09564;      Nürnberg (Krfr.St);76 bis unter 77;4198;1854;2344
09564;      Nürnberg (Krfr.St);77 bis unter 78;4939;2116;2823
09564;      Nürnberg (Krfr.St);78 bis unter 79;5287;2202;3085
09564;      Nürnberg (Krfr.St);79 bis unter 80;4874;2072;2802
09564;      Nürnberg (Krfr.St);80 bis unter 81;4449;1805;2644
09564;      Nürnberg (Krfr.St);81 bis unter 82;3969;1585;2384
09564;      Nürnberg (Krfr.St);82 bis unter 83;3711;1473;2238
09564;      Nürnberg (Krfr.St);83 bis unter 84;3267;1246;2021
09564;      Nürnberg (Krfr.St);84 bis unter 85;2781;1045;1736
09564;      Nürnberg (Krfr.St);85 bis unter 90;8989;3167;5822
09564;      Nürnberg (Krfr.St);90 bis unter 95;4025;1123;2902
09564;      Nürnberg (Krfr.St);95 oder älter;986;184;802
09564;      Nürnberg (Krfr.St);Insgesamt;518365;252807;265558
09565;      Schwabach (Krfr.St);unter 1;417;205;212
09565;      Schwabach (Krfr.St);1 bis unter 2;395;212;183
09565;      Schwabach (Krfr.St);2 bis unter 3;402;205;197
09565;      Schwabach (Krfr.St);3 bis unter 4;404;205;199
09565;      Schwabach (Krfr.St);4 bis unter 5;400;188;212
09565;      Schwabach (Krfr.St);5 bis unter 6;369;194;175
09565;      Schwabach (Krfr.St);6 bis unter 7;376;196;180
09565;      Schwabach (Krfr.St);7 bis unter 8;380;213;167
09565;      Schwabach (Krfr.St);8 bis unter 9;351;175;176
09565;      Schwabach (Krfr.St);9 bis unter 10;338;169;169
09565;      Schwabach (Krfr.St);10 bis unter 11;401;202;199
09565;      Schwabach (Krfr.St);11 bis unter 12;400;199;201
09565;      Schwabach (Krfr.St);12 bis unter 13;350;185;165
09565;      Schwabach (Krfr.St);13 bis unter 14;373;193;180
09565;      Schwabach (Krfr.St);14 bis unter 15;394;189;205
09565;      Schwabach (Krfr.St);15 bis unter 16;365;188;177
09565;      Schwabach (Krfr.St);16 bis unter 17;372;179;193
09565;      Schwabach (Krfr.St);17 bis unter 18;426;233;193
09565;      Schwabach (Krfr.St);18 bis unter 19;420;225;195
09565;      Schwabach (Krfr.St);19 bis unter 20;429;242;187
09565;      Schwabach (Krfr.St);20 bis unter 21;454;249;205
09565;      Schwabach (Krfr.St);21 bis unter 22;426;231;195
09565;      Schwabach (Krfr.St);22 bis unter 23;444;254;190
09565;      Schwabach (Krfr.St);23 bis unter 24;409;209;200
09565;      Schwabach (Krfr.St);24 bis unter 25;415;232;183
09565;      Schwabach (Krfr.St);25 bis unter 26;470;239;231
09565;      Schwabach (Krfr.St);26 bis unter 27;449;216;233
09565;      Schwabach (Krfr.St);27 bis unter 28;442;213;229
09565;      Schwabach (Krfr.St);28 bis unter 29;501;249;252
09565;      Schwabach (Krfr.St);29 bis unter 30;451;215;236
09565;      Schwabach (Krfr.St);30 bis unter 31;457;224;233
09565;      Schwabach (Krfr.St);31 bis unter 32;480;244;236
09565;      Schwabach (Krfr.St);32 bis unter 33;510;228;282
09565;      Schwabach (Krfr.St);33 bis unter 34;476;240;236
09565;      Schwabach (Krfr.St);34 bis unter 35;475;233;242
09565;      Schwabach (Krfr.St);35 bis unter 36;458;223;235
09565;      Schwabach (Krfr.St);36 bis unter 37;525;277;248
09565;      Schwabach (Krfr.St);37 bis unter 38;528;289;239
09565;      Schwabach (Krfr.St);38 bis unter 39;508;266;242
09565;      Schwabach (Krfr.St);39 bis unter 40;495;237;258
09565;      Schwabach (Krfr.St);40 bis unter 41;525;247;278
09565;      Schwabach (Krfr.St);41 bis unter 42;465;232;233
09565;      Schwabach (Krfr.St);42 bis unter 43;490;253;237
09565;      Schwabach (Krfr.St);43 bis unter 44;467;218;249
09565;      Schwabach (Krfr.St);44 bis unter 45;479;257;222
09565;      Schwabach (Krfr.St);45 bis unter 46;489;217;272
09565;      Schwabach (Krfr.St);46 bis unter 47;498;233;265
09565;      Schwabach (Krfr.St);47 bis unter 48;573;295;278
09565;      Schwabach (Krfr.St);48 bis unter 49;603;306;297
09565;      Schwabach (Krfr.St);49 bis unter 50;691;326;365
09565;      Schwabach (Krfr.St);50 bis unter 51;711;363;348
09565;      Schwabach (Krfr.St);51 bis unter 52;793;402;391
09565;      Schwabach (Krfr.St);52 bis unter 53;782;386;396
09565;      Schwabach (Krfr.St);53 bis unter 54;713;342;371
09565;      Schwabach (Krfr.St);54 bis unter 55;736;376;360
09565;      Schwabach (Krfr.St);55 bis unter 56;680;343;337
09565;      Schwabach (Krfr.St);56 bis unter 57;665;355;310
09565;      Schwabach (Krfr.St);57 bis unter 58;656;306;350
09565;      Schwabach (Krfr.St);58 bis unter 59;628;315;313
09565;      Schwabach (Krfr.St);59 bis unter 60;561;294;267
09565;      Schwabach (Krfr.St);60 bis unter 61;550;277;273
09565;      Schwabach (Krfr.St);61 bis unter 62;555;286;269
09565;      Schwabach (Krfr.St);62 bis unter 63;511;277;234
09565;      Schwabach (Krfr.St);63 bis unter 64;489;223;266
09565;      Schwabach (Krfr.St);64 bis unter 65;449;219;230
09565;      Schwabach (Krfr.St);65 bis unter 66;445;191;254
09565;      Schwabach (Krfr.St);66 bis unter 67;458;202;256
09565;      Schwabach (Krfr.St);67 bis unter 68;418;178;240
09565;      Schwabach (Krfr.St);68 bis unter 69;438;188;250
09565;      Schwabach (Krfr.St);69 bis unter 70;414;185;229
09565;      Schwabach (Krfr.St);70 bis unter 71;435;197;238
09565;      Schwabach (Krfr.St);71 bis unter 72;458;212;246
09565;      Schwabach (Krfr.St);72 bis unter 73;390;182;208
09565;      Schwabach (Krfr.St);73 bis unter 74;304;145;159
09565;      Schwabach (Krfr.St);74 bis unter 75;431;210;221
09565;      Schwabach (Krfr.St);75 bis unter 76;402;196;206
09565;      Schwabach (Krfr.St);76 bis unter 77;344;147;197
09565;      Schwabach (Krfr.St);77 bis unter 78;458;202;256
09565;      Schwabach (Krfr.St);78 bis unter 79;487;208;279
09565;      Schwabach (Krfr.St);79 bis unter 80;425;192;233
09565;      Schwabach (Krfr.St);80 bis unter 81;348;144;204
09565;      Schwabach (Krfr.St);81 bis unter 82;324;142;182
09565;      Schwabach (Krfr.St);82 bis unter 83;310;128;182
09565;      Schwabach (Krfr.St);83 bis unter 84;276;102;174
09565;      Schwabach (Krfr.St);84 bis unter 85;216;84;132
09565;      Schwabach (Krfr.St);85 bis unter 90;700;239;461
09565;      Schwabach (Krfr.St);90 bis unter 95;317;92;225
09565;      Schwabach (Krfr.St);95 oder älter;100;16;84
09565;      Schwabach (Krfr.St);Insgesamt;40792;19895;20897
KS095;    Kreisfreie Städte Mittelfranken;unter 1;8882;4505;4377
KS095;    Kreisfreie Städte Mittelfranken;1 bis unter 2;8603;4419;4184
KS095;    Kreisfreie Städte Mittelfranken;2 bis unter 3;8569;4434;4135
KS095;    Kreisfreie Städte Mittelfranken;3 bis unter 4;8057;4190;3867
KS095;    Kreisfreie Städte Mittelfranken;4 bis unter 5;7930;4024;3906
KS095;    Kreisfreie Städte Mittelfranken;5 bis unter 6;7459;3807;3652
KS095;    Kreisfreie Städte Mittelfranken;6 bis unter 7;7258;3760;3498
KS095;    Kreisfreie Städte Mittelfranken;7 bis unter 8;7026;3589;3437
KS095;    Kreisfreie Städte Mittelfranken;8 bis unter 9;7092;3734;3358
KS095;    Kreisfreie Städte Mittelfranken;9 bis unter 10;6929;3597;3332
KS095;    Kreisfreie Städte Mittelfranken;10 bis unter 11;7070;3664;3406
KS095;    Kreisfreie Städte Mittelfranken;11 bis unter 12;7270;3725;3545
KS095;    Kreisfreie Städte Mittelfranken;12 bis unter 13;7027;3637;3390
KS095;    Kreisfreie Städte Mittelfranken;13 bis unter 14;6940;3581;3359
KS095;    Kreisfreie Städte Mittelfranken;14 bis unter 15;7099;3592;3507
KS095;    Kreisfreie Städte Mittelfranken;15 bis unter 16;6965;3614;3351
KS095;    Kreisfreie Städte Mittelfranken;16 bis unter 17;7083;3682;3401
KS095;    Kreisfreie Städte Mittelfranken;17 bis unter 18;7334;3883;3451
KS095;    Kreisfreie Städte Mittelfranken;18 bis unter 19;7867;4085;3782
KS095;    Kreisfreie Städte Mittelfranken;19 bis unter 20;8740;4537;4203
KS095;    Kreisfreie Städte Mittelfranken;20 bis unter 21;9632;4916;4716
KS095;    Kreisfreie Städte Mittelfranken;21 bis unter 22;10363;5230;5133
KS095;    Kreisfreie Städte Mittelfranken;22 bis unter 23;10998;5519;5479
KS095;    Kreisfreie Städte Mittelfranken;23 bis unter 24;11368;5761;5607
KS095;    Kreisfreie Städte Mittelfranken;24 bis unter 25;12130;6202;5928
KS095;    Kreisfreie Städte Mittelfranken;25 bis unter 26;12701;6506;6195
KS095;    Kreisfreie Städte Mittelfranken;26 bis unter 27;13072;6647;6425
KS095;    Kreisfreie Städte Mittelfranken;27 bis unter 28;13481;6931;6550
KS095;    Kreisfreie Städte Mittelfranken;28 bis unter 29;14225;7183;7042
KS095;    Kreisfreie Städte Mittelfranken;29 bis unter 30;13817;7163;6654
KS095;    Kreisfreie Städte Mittelfranken;30 bis unter 31;13752;7131;6621
KS095;    Kreisfreie Städte Mittelfranken;31 bis unter 32;13233;6936;6297
KS095;    Kreisfreie Städte Mittelfranken;32 bis unter 33;12757;6501;6256
KS095;    Kreisfreie Städte Mittelfranken;33 bis unter 34;12044;6139;5905
KS095;    Kreisfreie Städte Mittelfranken;34 bis unter 35;12074;6109;5965
KS095;    Kreisfreie Städte Mittelfranken;35 bis unter 36;11953;6249;5704
KS095;    Kreisfreie Städte Mittelfranken;36 bis unter 37;12146;6146;6000
KS095;    Kreisfreie Städte Mittelfranken;37 bis unter 38;11908;5996;5912
KS095;    Kreisfreie Städte Mittelfranken;38 bis unter 39;11749;5935;5814
KS095;    Kreisfreie Städte Mittelfranken;39 bis unter 40;11139;5511;5628
KS095;    Kreisfreie Städte Mittelfranken;40 bis unter 41;10899;5421;5478
KS095;    Kreisfreie Städte Mittelfranken;41 bis unter 42;10451;5242;5209
KS095;    Kreisfreie Städte Mittelfranken;42 bis unter 43;10675;5314;5361
KS095;    Kreisfreie Städte Mittelfranken;43 bis unter 44;10088;4977;5111
KS095;    Kreisfreie Städte Mittelfranken;44 bis unter 45;10133;4988;5145
KS095;    Kreisfreie Städte Mittelfranken;45 bis unter 46;9865;4854;5011
KS095;    Kreisfreie Städte Mittelfranken;46 bis unter 47;10564;5266;5298
KS095;    Kreisfreie Städte Mittelfranken;47 bis unter 48;11259;5547;5712
KS095;    Kreisfreie Städte Mittelfranken;48 bis unter 49;11653;5783;5870
KS095;    Kreisfreie Städte Mittelfranken;49 bis unter 50;12399;6244;6155
KS095;    Kreisfreie Städte Mittelfranken;50 bis unter 51;12972;6659;6313
KS095;    Kreisfreie Städte Mittelfranken;51 bis unter 52;13177;6629;6548
KS095;    Kreisfreie Städte Mittelfranken;52 bis unter 53;13014;6631;6383
KS095;    Kreisfreie Städte Mittelfranken;53 bis unter 54;12805;6463;6342
KS095;    Kreisfreie Städte Mittelfranken;54 bis unter 55;12880;6543;6337
KS095;    Kreisfreie Städte Mittelfranken;55 bis unter 56;12574;6241;6333
KS095;    Kreisfreie Städte Mittelfranken;56 bis unter 57;12052;6098;5954
KS095;    Kreisfreie Städte Mittelfranken;57 bis unter 58;11834;5783;6051
KS095;    Kreisfreie Städte Mittelfranken;58 bis unter 59;11421;5641;5780
KS095;    Kreisfreie Städte Mittelfranken;59 bis unter 60;10784;5297;5487
KS095;    Kreisfreie Städte Mittelfranken;60 bis unter 61;10431;5132;5299
KS095;    Kreisfreie Städte Mittelfranken;61 bis unter 62;9989;4864;5125
KS095;    Kreisfreie Städte Mittelfranken;62 bis unter 63;9814;4825;4989
KS095;    Kreisfreie Städte Mittelfranken;63 bis unter 64;9346;4447;4899
KS095;    Kreisfreie Städte Mittelfranken;64 bis unter 65;8886;4122;4764
KS095;    Kreisfreie Städte Mittelfranken;65 bis unter 66;8305;3832;4473
KS095;    Kreisfreie Städte Mittelfranken;66 bis unter 67;8562;3882;4680
KS095;    Kreisfreie Städte Mittelfranken;67 bis unter 68;8156;3661;4495
KS095;    Kreisfreie Städte Mittelfranken;68 bis unter 69;8103;3598;4505
KS095;    Kreisfreie Städte Mittelfranken;69 bis unter 70;7958;3573;4385
KS095;    Kreisfreie Städte Mittelfranken;70 bis unter 71;7842;3620;4222
KS095;    Kreisfreie Städte Mittelfranken;71 bis unter 72;7827;3601;4226
KS095;    Kreisfreie Städte Mittelfranken;72 bis unter 73;6871;3063;3808
KS095;    Kreisfreie Städte Mittelfranken;73 bis unter 74;5783;2627;3156
KS095;    Kreisfreie Städte Mittelfranken;74 bis unter 75;7246;3301;3945
KS095;    Kreisfreie Städte Mittelfranken;75 bis unter 76;7213;3269;3944
KS095;    Kreisfreie Städte Mittelfranken;76 bis unter 77;6557;2904;3653
KS095;    Kreisfreie Städte Mittelfranken;77 bis unter 78;7977;3421;4556
KS095;    Kreisfreie Städte Mittelfranken;78 bis unter 79;8297;3464;4833
KS095;    Kreisfreie Städte Mittelfranken;79 bis unter 80;7729;3265;4464
KS095;    Kreisfreie Städte Mittelfranken;80 bis unter 81;6971;2863;4108
KS095;    Kreisfreie Städte Mittelfranken;81 bis unter 82;6186;2466;3720
KS095;    Kreisfreie Städte Mittelfranken;82 bis unter 83;5813;2347;3466
KS095;    Kreisfreie Städte Mittelfranken;83 bis unter 84;5151;1939;3212
KS095;    Kreisfreie Städte Mittelfranken;84 bis unter 85;4399;1652;2747
KS095;    Kreisfreie Städte Mittelfranken;85 bis unter 90;14167;4997;9170
KS095;    Kreisfreie Städte Mittelfranken;90 bis unter 95;6314;1789;4525
KS095;    Kreisfreie Städte Mittelfranken;95 oder älter;1580;302;1278
KS095;    Kreisfreie Städte Mittelfranken;Insgesamt;840714;411217;429497
09571;      Ansbach (Lkr);unter 1;1705;848;857
09571;      Ansbach (Lkr);1 bis unter 2;1871;936;935
09571;      Ansbach (Lkr);2 bis unter 3;1817;933;884
09571;      Ansbach (Lkr);3 bis unter 4;1739;905;834
09571;      Ansbach (Lkr);4 bis unter 5;1685;864;821
09571;      Ansbach (Lkr);5 bis unter 6;1637;877;760
09571;      Ansbach (Lkr);6 bis unter 7;1651;840;811
09571;      Ansbach (Lkr);7 bis unter 8;1584;774;810
09571;      Ansbach (Lkr);8 bis unter 9;1661;857;804
09571;      Ansbach (Lkr);9 bis unter 10;1671;881;790
09571;      Ansbach (Lkr);10 bis unter 11;1669;888;781
09571;      Ansbach (Lkr);11 bis unter 12;1790;941;849
09571;      Ansbach (Lkr);12 bis unter 13;1691;835;856
09571;      Ansbach (Lkr);13 bis unter 14;1753;934;819
09571;      Ansbach (Lkr);14 bis unter 15;1783;941;842
09571;      Ansbach (Lkr);15 bis unter 16;1870;1002;868
09571;      Ansbach (Lkr);16 bis unter 17;1843;948;895
09571;      Ansbach (Lkr);17 bis unter 18;1871;974;897
09571;      Ansbach (Lkr);18 bis unter 19;2004;1048;956
09571;      Ansbach (Lkr);19 bis unter 20;2131;1158;973
09571;      Ansbach (Lkr);20 bis unter 21;2159;1138;1021
09571;      Ansbach (Lkr);21 bis unter 22;2216;1187;1029
09571;      Ansbach (Lkr);22 bis unter 23;2168;1203;965
09571;      Ansbach (Lkr);23 bis unter 24;2043;1124;919
09571;      Ansbach (Lkr);24 bis unter 25;2062;1123;939
09571;      Ansbach (Lkr);25 bis unter 26;2150;1158;992
09571;      Ansbach (Lkr);26 bis unter 27;2119;1152;967
09571;      Ansbach (Lkr);27 bis unter 28;2144;1149;995
09571;      Ansbach (Lkr);28 bis unter 29;2292;1211;1081
09571;      Ansbach (Lkr);29 bis unter 30;2227;1144;1083
09571;      Ansbach (Lkr);30 bis unter 31;2335;1250;1085
09571;      Ansbach (Lkr);31 bis unter 32;2200;1166;1034
09571;      Ansbach (Lkr);32 bis unter 33;2188;1122;1066
09571;      Ansbach (Lkr);33 bis unter 34;2101;1064;1037
09571;      Ansbach (Lkr);34 bis unter 35;2234;1150;1084
09571;      Ansbach (Lkr);35 bis unter 36;2290;1192;1098
09571;      Ansbach (Lkr);36 bis unter 37;2196;1123;1073
09571;      Ansbach (Lkr);37 bis unter 38;2358;1193;1165
09571;      Ansbach (Lkr);38 bis unter 39;2211;1146;1065
09571;      Ansbach (Lkr);39 bis unter 40;2173;1103;1070
09571;      Ansbach (Lkr);40 bis unter 41;2164;1087;1077
09571;      Ansbach (Lkr);41 bis unter 42;2180;1116;1064
09571;      Ansbach (Lkr);42 bis unter 43;2135;1061;1074
09571;      Ansbach (Lkr);43 bis unter 44;2071;1047;1024
09571;      Ansbach (Lkr);44 bis unter 45;2217;1101;1116
09571;      Ansbach (Lkr);45 bis unter 46;2215;1126;1089
09571;      Ansbach (Lkr);46 bis unter 47;2423;1245;1178
09571;      Ansbach (Lkr);47 bis unter 48;2598;1332;1266
09571;      Ansbach (Lkr);48 bis unter 49;2714;1377;1337
09571;      Ansbach (Lkr);49 bis unter 50;2905;1456;1449
09571;      Ansbach (Lkr);50 bis unter 51;3057;1477;1580
09571;      Ansbach (Lkr);51 bis unter 52;3124;1607;1517
09571;      Ansbach (Lkr);52 bis unter 53;3230;1632;1598
09571;      Ansbach (Lkr);53 bis unter 54;3116;1601;1515
09571;      Ansbach (Lkr);54 bis unter 55;3298;1678;1620
09571;      Ansbach (Lkr);55 bis unter 56;3235;1620;1615
09571;      Ansbach (Lkr);56 bis unter 57;3205;1642;1563
09571;      Ansbach (Lkr);57 bis unter 58;3143;1651;1492
09571;      Ansbach (Lkr);58 bis unter 59;2983;1500;1483
09571;      Ansbach (Lkr);59 bis unter 60;2896;1507;1389
09571;      Ansbach (Lkr);60 bis unter 61;2764;1382;1382
09571;      Ansbach (Lkr);61 bis unter 62;2755;1365;1390
09571;      Ansbach (Lkr);62 bis unter 63;2553;1306;1247
09571;      Ansbach (Lkr);63 bis unter 64;2463;1221;1242
09571;      Ansbach (Lkr);64 bis unter 65;2364;1197;1167
09571;      Ansbach (Lkr);65 bis unter 66;2327;1223;1104
09571;      Ansbach (Lkr);66 bis unter 67;2180;1076;1104
09571;      Ansbach (Lkr);67 bis unter 68;2114;1026;1088
09571;      Ansbach (Lkr);68 bis unter 69;2085;1053;1032
09571;      Ansbach (Lkr);69 bis unter 70;1949;966;983
09571;      Ansbach (Lkr);70 bis unter 71;1837;907;930
09571;      Ansbach (Lkr);71 bis unter 72;1625;800;825
09571;      Ansbach (Lkr);72 bis unter 73;1387;704;683
09571;      Ansbach (Lkr);73 bis unter 74;935;486;449
09571;      Ansbach (Lkr);74 bis unter 75;1298;644;654
09571;      Ansbach (Lkr);75 bis unter 76;1251;584;667
09571;      Ansbach (Lkr);76 bis unter 77;1290;588;702
09571;      Ansbach (Lkr);77 bis unter 78;1632;728;904
09571;      Ansbach (Lkr);78 bis unter 79;1841;828;1013
09571;      Ansbach (Lkr);79 bis unter 80;1857;785;1072
09571;      Ansbach (Lkr);80 bis unter 81;1594;686;908
09571;      Ansbach (Lkr);81 bis unter 82;1404;632;772
09571;      Ansbach (Lkr);82 bis unter 83;1266;551;715
09571;      Ansbach (Lkr);83 bis unter 84;1124;438;686
09571;      Ansbach (Lkr);84 bis unter 85;1030;401;629
09571;      Ansbach (Lkr);85 bis unter 90;3254;1121;2133
09571;      Ansbach (Lkr);90 bis unter 95;1249;347;902
09571;      Ansbach (Lkr);95 oder älter;320;60;260
09571;      Ansbach (Lkr);Insgesamt;183949;92450;91499
09572;      Erlangen-Höchstadt (Lkr);unter 1;1279;652;627
09572;      Erlangen-Höchstadt (Lkr);1 bis unter 2;1384;723;661
09572;      Erlangen-Höchstadt (Lkr);2 bis unter 3;1426;742;684
09572;      Erlangen-Höchstadt (Lkr);3 bis unter 4;1385;720;665
09572;      Erlangen-Höchstadt (Lkr);4 bis unter 5;1369;687;682
09572;      Erlangen-Höchstadt (Lkr);5 bis unter 6;1409;738;671
09572;      Erlangen-Höchstadt (Lkr);6 bis unter 7;1314;665;649
09572;      Erlangen-Höchstadt (Lkr);7 bis unter 8;1293;701;592
09572;      Erlangen-Höchstadt (Lkr);8 bis unter 9;1320;688;632
09572;      Erlangen-Höchstadt (Lkr);9 bis unter 10;1304;643;661
09572;      Erlangen-Höchstadt (Lkr);10 bis unter 11;1320;650;670
09572;      Erlangen-Höchstadt (Lkr);11 bis unter 12;1342;716;626
09572;      Erlangen-Höchstadt (Lkr);12 bis unter 13;1236;630;606
09572;      Erlangen-Höchstadt (Lkr);13 bis unter 14;1309;669;640
09572;      Erlangen-Höchstadt (Lkr);14 bis unter 15;1293;686;607
09572;      Erlangen-Höchstadt (Lkr);15 bis unter 16;1286;659;627
09572;      Erlangen-Höchstadt (Lkr);16 bis unter 17;1364;677;687
09572;      Erlangen-Höchstadt (Lkr);17 bis unter 18;1382;707;675
09572;      Erlangen-Höchstadt (Lkr);18 bis unter 19;1466;742;724
09572;      Erlangen-Höchstadt (Lkr);19 bis unter 20;1407;747;660
09572;      Erlangen-Höchstadt (Lkr);20 bis unter 21;1365;757;608
09572;      Erlangen-Höchstadt (Lkr);21 bis unter 22;1404;754;650
09572;      Erlangen-Höchstadt (Lkr);22 bis unter 23;1371;742;629
09572;      Erlangen-Höchstadt (Lkr);23 bis unter 24;1301;684;617
09572;      Erlangen-Höchstadt (Lkr);24 bis unter 25;1383;730;653
09572;      Erlangen-Höchstadt (Lkr);25 bis unter 26;1263;692;571
09572;      Erlangen-Höchstadt (Lkr);26 bis unter 27;1401;723;678
09572;      Erlangen-Höchstadt (Lkr);27 bis unter 28;1406;746;660
09572;      Erlangen-Höchstadt (Lkr);28 bis unter 29;1476;778;698
09572;      Erlangen-Höchstadt (Lkr);29 bis unter 30;1499;746;753
09572;      Erlangen-Höchstadt (Lkr);30 bis unter 31;1560;775;785
09572;      Erlangen-Höchstadt (Lkr);31 bis unter 32;1594;792;802
09572;      Erlangen-Höchstadt (Lkr);32 bis unter 33;1584;777;807
09572;      Erlangen-Höchstadt (Lkr);33 bis unter 34;1639;806;833
09572;      Erlangen-Höchstadt (Lkr);34 bis unter 35;1650;812;838
09572;      Erlangen-Höchstadt (Lkr);35 bis unter 36;1730;871;859
09572;      Erlangen-Höchstadt (Lkr);36 bis unter 37;1818;912;906
09572;      Erlangen-Höchstadt (Lkr);37 bis unter 38;1878;925;953
09572;      Erlangen-Höchstadt (Lkr);38 bis unter 39;1838;936;902
09572;      Erlangen-Höchstadt (Lkr);39 bis unter 40;1809;874;935
09572;      Erlangen-Höchstadt (Lkr);40 bis unter 41;1784;887;897
09572;      Erlangen-Höchstadt (Lkr);41 bis unter 42;1661;852;809
09572;      Erlangen-Höchstadt (Lkr);42 bis unter 43;1666;816;850
09572;      Erlangen-Höchstadt (Lkr);43 bis unter 44;1633;816;817
09572;      Erlangen-Höchstadt (Lkr);44 bis unter 45;1620;812;808
09572;      Erlangen-Höchstadt (Lkr);45 bis unter 46;1647;820;827
09572;      Erlangen-Höchstadt (Lkr);46 bis unter 47;1805;898;907
09572;      Erlangen-Höchstadt (Lkr);47 bis unter 48;1956;1007;949
09572;      Erlangen-Höchstadt (Lkr);48 bis unter 49;2018;961;1057
09572;      Erlangen-Höchstadt (Lkr);49 bis unter 50;2223;1109;1114
09572;      Erlangen-Höchstadt (Lkr);50 bis unter 51;2283;1138;1145
09572;      Erlangen-Höchstadt (Lkr);51 bis unter 52;2371;1152;1219
09572;      Erlangen-Höchstadt (Lkr);52 bis unter 53;2307;1186;1121
09572;      Erlangen-Höchstadt (Lkr);53 bis unter 54;2327;1158;1169
09572;      Erlangen-Höchstadt (Lkr);54 bis unter 55;2383;1236;1147
09572;      Erlangen-Höchstadt (Lkr);55 bis unter 56;2472;1242;1230
09572;      Erlangen-Höchstadt (Lkr);56 bis unter 57;2327;1149;1178
09572;      Erlangen-Höchstadt (Lkr);57 bis unter 58;2283;1139;1144
09572;      Erlangen-Höchstadt (Lkr);58 bis unter 59;2156;1095;1061
09572;      Erlangen-Höchstadt (Lkr);59 bis unter 60;2120;1068;1052
09572;      Erlangen-Höchstadt (Lkr);60 bis unter 61;2076;1003;1073
09572;      Erlangen-Höchstadt (Lkr);61 bis unter 62;1994;969;1025
09572;      Erlangen-Höchstadt (Lkr);62 bis unter 63;1900;937;963
09572;      Erlangen-Höchstadt (Lkr);63 bis unter 64;1835;895;940
09572;      Erlangen-Höchstadt (Lkr);64 bis unter 65;1781;877;904
09572;      Erlangen-Höchstadt (Lkr);65 bis unter 66;1642;856;786
09572;      Erlangen-Höchstadt (Lkr);66 bis unter 67;1681;806;875
09572;      Erlangen-Höchstadt (Lkr);67 bis unter 68;1577;764;813
09572;      Erlangen-Höchstadt (Lkr);68 bis unter 69;1503;708;795
09572;      Erlangen-Höchstadt (Lkr);69 bis unter 70;1530;762;768
09572;      Erlangen-Höchstadt (Lkr);70 bis unter 71;1424;692;732
09572;      Erlangen-Höchstadt (Lkr);71 bis unter 72;1393;720;673
09572;      Erlangen-Höchstadt (Lkr);72 bis unter 73;1138;550;588
09572;      Erlangen-Höchstadt (Lkr);73 bis unter 74;889;427;462
09572;      Erlangen-Höchstadt (Lkr);74 bis unter 75;1212;584;628
09572;      Erlangen-Höchstadt (Lkr);75 bis unter 76;1167;583;584
09572;      Erlangen-Höchstadt (Lkr);76 bis unter 77;1112;527;585
09572;      Erlangen-Höchstadt (Lkr);77 bis unter 78;1388;642;746
09572;      Erlangen-Höchstadt (Lkr);78 bis unter 79;1338;646;692
09572;      Erlangen-Höchstadt (Lkr);79 bis unter 80;1300;600;700
09572;      Erlangen-Höchstadt (Lkr);80 bis unter 81;1154;482;672
09572;      Erlangen-Höchstadt (Lkr);81 bis unter 82;939;423;516
09572;      Erlangen-Höchstadt (Lkr);82 bis unter 83;858;383;475
09572;      Erlangen-Höchstadt (Lkr);83 bis unter 84;790;331;459
09572;      Erlangen-Höchstadt (Lkr);84 bis unter 85;649;253;396
09572;      Erlangen-Höchstadt (Lkr);85 bis unter 90;2113;839;1274
09572;      Erlangen-Höchstadt (Lkr);90 bis unter 95;814;262;552
09572;      Erlangen-Höchstadt (Lkr);95 oder älter;175;27;148
09572;      Erlangen-Höchstadt (Lkr);Insgesamt;136271;67763;68508
09573;      Fürth (Lkr);unter 1;1108;551;557
09573;      Fürth (Lkr);1 bis unter 2;1126;584;542
09573;      Fürth (Lkr);2 bis unter 3;1178;595;583
09573;      Fürth (Lkr);3 bis unter 4;1158;582;576
09573;      Fürth (Lkr);4 bis unter 5;1077;571;506
09573;      Fürth (Lkr);5 bis unter 6;1132;572;560
09573;      Fürth (Lkr);6 bis unter 7;1098;548;550
09573;      Fürth (Lkr);7 bis unter 8;1042;528;514
09573;      Fürth (Lkr);8 bis unter 9;1025;555;470
09573;      Fürth (Lkr);9 bis unter 10;1044;527;517
09573;      Fürth (Lkr);10 bis unter 11;1056;546;510
09573;      Fürth (Lkr);11 bis unter 12;1058;533;525
09573;      Fürth (Lkr);12 bis unter 13;964;486;478
09573;      Fürth (Lkr);13 bis unter 14;971;494;477
09573;      Fürth (Lkr);14 bis unter 15;1003;499;504
09573;      Fürth (Lkr);15 bis unter 16;1003;512;491
09573;      Fürth (Lkr);16 bis unter 17;1043;511;532
09573;      Fürth (Lkr);17 bis unter 18;1120;571;549
09573;      Fürth (Lkr);18 bis unter 19;1131;569;562
09573;      Fürth (Lkr);19 bis unter 20;1172;602;570
09573;      Fürth (Lkr);20 bis unter 21;1140;609;531
09573;      Fürth (Lkr);21 bis unter 22;1212;624;588
09573;      Fürth (Lkr);22 bis unter 23;1161;615;546
09573;      Fürth (Lkr);23 bis unter 24;1101;587;514
09573;      Fürth (Lkr);24 bis unter 25;1092;597;495
09573;      Fürth (Lkr);25 bis unter 26;1149;589;560
09573;      Fürth (Lkr);26 bis unter 27;1129;592;537
09573;      Fürth (Lkr);27 bis unter 28;1212;626;586
09573;      Fürth (Lkr);28 bis unter 29;1162;562;600
09573;      Fürth (Lkr);29 bis unter 30;1228;632;596
09573;      Fürth (Lkr);30 bis unter 31;1274;608;666
09573;      Fürth (Lkr);31 bis unter 32;1326;656;670
09573;      Fürth (Lkr);32 bis unter 33;1285;638;647
09573;      Fürth (Lkr);33 bis unter 34;1338;667;671
09573;      Fürth (Lkr);34 bis unter 35;1372;660;712
09573;      Fürth (Lkr);35 bis unter 36;1352;662;690
09573;      Fürth (Lkr);36 bis unter 37;1468;715;753
09573;      Fürth (Lkr);37 bis unter 38;1554;750;804
09573;      Fürth (Lkr);38 bis unter 39;1469;694;775
09573;      Fürth (Lkr);39 bis unter 40;1398;667;731
09573;      Fürth (Lkr);40 bis unter 41;1424;688;736
09573;      Fürth (Lkr);41 bis unter 42;1500;733;767
09573;      Fürth (Lkr);42 bis unter 43;1443;706;737
09573;      Fürth (Lkr);43 bis unter 44;1409;689;720
09573;      Fürth (Lkr);44 bis unter 45;1325;655;670
09573;      Fürth (Lkr);45 bis unter 46;1383;710;673
09573;      Fürth (Lkr);46 bis unter 47;1503;723;780
09573;      Fürth (Lkr);47 bis unter 48;1621;788;833
09573;      Fürth (Lkr);48 bis unter 49;1721;836;885
09573;      Fürth (Lkr);49 bis unter 50;1916;962;954
09573;      Fürth (Lkr);50 bis unter 51;1983;942;1041
09573;      Fürth (Lkr);51 bis unter 52;2203;1128;1075
09573;      Fürth (Lkr);52 bis unter 53;2014;967;1047
09573;      Fürth (Lkr);53 bis unter 54;2150;1072;1078
09573;      Fürth (Lkr);54 bis unter 55;2115;1076;1039
09573;      Fürth (Lkr);55 bis unter 56;2048;1048;1000
09573;      Fürth (Lkr);56 bis unter 57;2078;1002;1076
09573;      Fürth (Lkr);57 bis unter 58;2028;983;1045
09573;      Fürth (Lkr);58 bis unter 59;1882;905;977
09573;      Fürth (Lkr);59 bis unter 60;1884;945;939
09573;      Fürth (Lkr);60 bis unter 61;1716;850;866
09573;      Fürth (Lkr);61 bis unter 62;1652;796;856
09573;      Fürth (Lkr);62 bis unter 63;1633;832;801
09573;      Fürth (Lkr);63 bis unter 64;1524;734;790
09573;      Fürth (Lkr);64 bis unter 65;1521;768;753
09573;      Fürth (Lkr);65 bis unter 66;1385;683;702
09573;      Fürth (Lkr);66 bis unter 67;1497;695;802
09573;      Fürth (Lkr);67 bis unter 68;1378;634;744
09573;      Fürth (Lkr);68 bis unter 69;1353;655;698
09573;      Fürth (Lkr);69 bis unter 70;1438;670;768
09573;      Fürth (Lkr);70 bis unter 71;1321;622;699
09573;      Fürth (Lkr);71 bis unter 72;1315;630;685
09573;      Fürth (Lkr);72 bis unter 73;1108;531;577
09573;      Fürth (Lkr);73 bis unter 74;934;460;474
09573;      Fürth (Lkr);74 bis unter 75;1214;571;643
09573;      Fürth (Lkr);75 bis unter 76;1171;543;628
09573;      Fürth (Lkr);76 bis unter 77;1097;492;605
09573;      Fürth (Lkr);77 bis unter 78;1280;578;702
09573;      Fürth (Lkr);78 bis unter 79;1286;589;697
09573;      Fürth (Lkr);79 bis unter 80;1311;573;738
09573;      Fürth (Lkr);80 bis unter 81;1120;471;649
09573;      Fürth (Lkr);81 bis unter 82;1010;436;574
09573;      Fürth (Lkr);82 bis unter 83;870;366;504
09573;      Fürth (Lkr);83 bis unter 84;776;329;447
09573;      Fürth (Lkr);84 bis unter 85;659;240;419
09573;      Fürth (Lkr);85 bis unter 90;2155;779;1376
09573;      Fürth (Lkr);90 bis unter 95;879;253;626
09573;      Fürth (Lkr);95 oder älter;223;40;183
09573;      Fürth (Lkr);Insgesamt;117387;57064;60323
09574;      Nürnberger Land (Lkr);unter 1;1500;748;752
09574;      Nürnberger Land (Lkr);1 bis unter 2;1584;791;793
09574;      Nürnberger Land (Lkr);2 bis unter 3;1643;852;791
09574;      Nürnberger Land (Lkr);3 bis unter 4;1614;817;797
09574;      Nürnberger Land (Lkr);4 bis unter 5;1548;780;768
09574;      Nürnberger Land (Lkr);5 bis unter 6;1569;821;748
09574;      Nürnberger Land (Lkr);6 bis unter 7;1556;795;761
09574;      Nürnberger Land (Lkr);7 bis unter 8;1446;809;637
09574;      Nürnberger Land (Lkr);8 bis unter 9;1492;778;714
09574;      Nürnberger Land (Lkr);9 bis unter 10;1465;774;691
09574;      Nürnberger Land (Lkr);10 bis unter 11;1599;851;748
09574;      Nürnberger Land (Lkr);11 bis unter 12;1453;746;707
09574;      Nürnberger Land (Lkr);12 bis unter 13;1455;749;706
09574;      Nürnberger Land (Lkr);13 bis unter 14;1478;788;690
09574;      Nürnberger Land (Lkr);14 bis unter 15;1600;823;777
09574;      Nürnberger Land (Lkr);15 bis unter 16;1602;852;750
09574;      Nürnberger Land (Lkr);16 bis unter 17;1629;840;789
09574;      Nürnberger Land (Lkr);17 bis unter 18;1657;847;810
09574;      Nürnberger Land (Lkr);18 bis unter 19;1734;940;794
09574;      Nürnberger Land (Lkr);19 bis unter 20;1710;916;794
09574;      Nürnberger Land (Lkr);20 bis unter 21;1828;999;829
09574;      Nürnberger Land (Lkr);21 bis unter 22;1739;910;829
09574;      Nürnberger Land (Lkr);22 bis unter 23;1791;965;826
09574;      Nürnberger Land (Lkr);23 bis unter 24;1658;878;780
09574;      Nürnberger Land (Lkr);24 bis unter 25;1641;876;765
09574;      Nürnberger Land (Lkr);25 bis unter 26;1694;874;820
09574;      Nürnberger Land (Lkr);26 bis unter 27;1695;914;781
09574;      Nürnberger Land (Lkr);27 bis unter 28;1820;947;873
09574;      Nürnberger Land (Lkr);28 bis unter 29;1803;922;881
09574;      Nürnberger Land (Lkr);29 bis unter 30;1840;949;891
09574;      Nürnberger Land (Lkr);30 bis unter 31;1930;1004;926
09574;      Nürnberger Land (Lkr);31 bis unter 32;1895;923;972
09574;      Nürnberger Land (Lkr);32 bis unter 33;1874;919;955
09574;      Nürnberger Land (Lkr);33 bis unter 34;1959;933;1026
09574;      Nürnberger Land (Lkr);34 bis unter 35;1996;978;1018
09574;      Nürnberger Land (Lkr);35 bis unter 36;2015;1032;983
09574;      Nürnberger Land (Lkr);36 bis unter 37;2147;1029;1118
09574;      Nürnberger Land (Lkr);37 bis unter 38;2205;1059;1146
09574;      Nürnberger Land (Lkr);38 bis unter 39;2215;1096;1119
09574;      Nürnberger Land (Lkr);39 bis unter 40;2018;1025;993
09574;      Nürnberger Land (Lkr);40 bis unter 41;2049;1012;1037
09574;      Nürnberger Land (Lkr);41 bis unter 42;1962;977;985
09574;      Nürnberger Land (Lkr);42 bis unter 43;2019;1032;987
09574;      Nürnberger Land (Lkr);43 bis unter 44;1900;960;940
09574;      Nürnberger Land (Lkr);44 bis unter 45;2006;993;1013
09574;      Nürnberger Land (Lkr);45 bis unter 46;2050;1009;1041
09574;      Nürnberger Land (Lkr);46 bis unter 47;2235;1102;1133
09574;      Nürnberger Land (Lkr);47 bis unter 48;2416;1172;1244
09574;      Nürnberger Land (Lkr);48 bis unter 49;2648;1301;1347
09574;      Nürnberger Land (Lkr);49 bis unter 50;2908;1466;1442
09574;      Nürnberger Land (Lkr);50 bis unter 51;3034;1536;1498
09574;      Nürnberger Land (Lkr);51 bis unter 52;3108;1606;1502
09574;      Nürnberger Land (Lkr);52 bis unter 53;2969;1449;1520
09574;      Nürnberger Land (Lkr);53 bis unter 54;2970;1527;1443
09574;      Nürnberger Land (Lkr);54 bis unter 55;3024;1515;1509
09574;      Nürnberger Land (Lkr);55 bis unter 56;3131;1630;1501
09574;      Nürnberger Land (Lkr);56 bis unter 57;2947;1414;1533
09574;      Nürnberger Land (Lkr);57 bis unter 58;2850;1425;1425
09574;      Nürnberger Land (Lkr);58 bis unter 59;2719;1331;1388
09574;      Nürnberger Land (Lkr);59 bis unter 60;2710;1293;1417
09574;      Nürnberger Land (Lkr);60 bis unter 61;2577;1316;1261
09574;      Nürnberger Land (Lkr);61 bis unter 62;2446;1242;1204
09574;      Nürnberger Land (Lkr);62 bis unter 63;2366;1162;1204
09574;      Nürnberger Land (Lkr);63 bis unter 64;2153;1056;1097
09574;      Nürnberger Land (Lkr);64 bis unter 65;2156;1030;1126
09574;      Nürnberger Land (Lkr);65 bis unter 66;2074;989;1085
09574;      Nürnberger Land (Lkr);66 bis unter 67;2057;924;1133
09574;      Nürnberger Land (Lkr);67 bis unter 68;2026;973;1053
09574;      Nürnberger Land (Lkr);68 bis unter 69;1947;937;1010
09574;      Nürnberger Land (Lkr);69 bis unter 70;1961;940;1021
09574;      Nürnberger Land (Lkr);70 bis unter 71;1813;843;970
09574;      Nürnberger Land (Lkr);71 bis unter 72;1798;869;929
09574;      Nürnberger Land (Lkr);72 bis unter 73;1518;717;801
09574;      Nürnberger Land (Lkr);73 bis unter 74;1270;625;645
09574;      Nürnberger Land (Lkr);74 bis unter 75;1674;799;875
09574;      Nürnberger Land (Lkr);75 bis unter 76;1602;716;886
09574;      Nürnberger Land (Lkr);76 bis unter 77;1597;746;851
09574;      Nürnberger Land (Lkr);77 bis unter 78;1891;823;1068
09574;      Nürnberger Land (Lkr);78 bis unter 79;1904;850;1054
09574;      Nürnberger Land (Lkr);79 bis unter 80;1942;893;1049
09574;      Nürnberger Land (Lkr);80 bis unter 81;1568;700;868
09574;      Nürnberger Land (Lkr);81 bis unter 82;1379;600;779
09574;      Nürnberger Land (Lkr);82 bis unter 83;1255;507;748
09574;      Nürnberger Land (Lkr);83 bis unter 84;1124;482;642
09574;      Nürnberger Land (Lkr);84 bis unter 85;941;360;581
09574;      Nürnberger Land (Lkr);85 bis unter 90;3012;1066;1946
09574;      Nürnberger Land (Lkr);90 bis unter 95;1278;420;858
09574;      Nürnberger Land (Lkr);95 oder älter;284;62;222
09574;      Nürnberger Land (Lkr);Insgesamt;170365;83946;86419
09575;      Neustadt a.d.Aisch-Bad Windsheim (Lkr);unter 1;937;470;467
09575;      Neustadt a.d.Aisch-Bad Windsheim (Lkr);1 bis unter 2;956;494;462
09575;      Neustadt a.d.Aisch-Bad Windsheim (Lkr);2 bis unter 3;932;481;451
09575;      Neustadt a.d.Aisch-Bad Windsheim (Lkr);3 bis unter 4;992;506;486
09575;      Neustadt a.d.Aisch-Bad Windsheim (Lkr);4 bis unter 5;888;443;445
09575;      Neustadt a.d.Aisch-Bad Windsheim (Lkr);5 bis unter 6;927;493;434
09575;      Neustadt a.d.Aisch-Bad Windsheim (Lkr);6 bis unter 7;880;452;428
09575;      Neustadt a.d.Aisch-Bad Windsheim (Lkr);7 bis unter 8;865;444;421
09575;      Neustadt a.d.Aisch-Bad Windsheim (Lkr);8 bis unter 9;873;434;439
09575;      Neustadt a.d.Aisch-Bad Windsheim (Lkr);9 bis unter 10;841;448;393
09575;      Neustadt a.d.Aisch-Bad Windsheim (Lkr);10 bis unter 11;932;495;437
09575;      Neustadt a.d.Aisch-Bad Windsheim (Lkr);11 bis unter 12;935;496;439
09575;      Neustadt a.d.Aisch-Bad Windsheim (Lkr);12 bis unter 13;846;425;421
09575;      Neustadt a.d.Aisch-Bad Windsheim (Lkr);13 bis unter 14;907;481;426
09575;      Neustadt a.d.Aisch-Bad Windsheim (Lkr);14 bis unter 15;956;478;478
09575;      Neustadt a.d.Aisch-Bad Windsheim (Lkr);15 bis unter 16;997;518;479
09575;      Neustadt a.d.Aisch-Bad Windsheim (Lkr);16 bis unter 17;1021;564;457
09575;      Neustadt a.d.Aisch-Bad Windsheim (Lkr);17 bis unter 18;1069;574;495
09575;      Neustadt a.d.Aisch-Bad Windsheim (Lkr);18 bis unter 19;1046;569;477
09575;      Neustadt a.d.Aisch-Bad Windsheim (Lkr);19 bis unter 20;1146;609;537
09575;      Neustadt a.d.Aisch-Bad Windsheim (Lkr);20 bis unter 21;1146;649;497
09575;      Neustadt a.d.Aisch-Bad Windsheim (Lkr);21 bis unter 22;1214;630;584
09575;      Neustadt a.d.Aisch-Bad Windsheim (Lkr);22 bis unter 23;1075;593;482
09575;      Neustadt a.d.Aisch-Bad Windsheim (Lkr);23 bis unter 24;1040;553;487
09575;      Neustadt a.d.Aisch-Bad Windsheim (Lkr);24 bis unter 25;1062;566;496
09575;      Neustadt a.d.Aisch-Bad Windsheim (Lkr);25 bis unter 26;1128;604;524
09575;      Neustadt a.d.Aisch-Bad Windsheim (Lkr);26 bis unter 27;1124;601;523
09575;      Neustadt a.d.Aisch-Bad Windsheim (Lkr);27 bis unter 28;1118;604;514
09575;      Neustadt a.d.Aisch-Bad Windsheim (Lkr);28 bis unter 29;1162;586;576
09575;      Neustadt a.d.Aisch-Bad Windsheim (Lkr);29 bis unter 30;1163;607;556
09575;      Neustadt a.d.Aisch-Bad Windsheim (Lkr);30 bis unter 31;1188;655;533
09575;      Neustadt a.d.Aisch-Bad Windsheim (Lkr);31 bis unter 32;1237;646;591
09575;      Neustadt a.d.Aisch-Bad Windsheim (Lkr);32 bis unter 33;1227;628;599
09575;      Neustadt a.d.Aisch-Bad Windsheim (Lkr);33 bis unter 34;1140;573;567
09575;      Neustadt a.d.Aisch-Bad Windsheim (Lkr);34 bis unter 35;1230;608;622
09575;      Neustadt a.d.Aisch-Bad Windsheim (Lkr);35 bis unter 36;1222;648;574
09575;      Neustadt a.d.Aisch-Bad Windsheim (Lkr);36 bis unter 37;1247;637;610
09575;      Neustadt a.d.Aisch-Bad Windsheim (Lkr);37 bis unter 38;1207;636;571
09575;      Neustadt a.d.Aisch-Bad Windsheim (Lkr);38 bis unter 39;1288;666;622
09575;      Neustadt a.d.Aisch-Bad Windsheim (Lkr);39 bis unter 40;1127;569;558
09575;      Neustadt a.d.Aisch-Bad Windsheim (Lkr);40 bis unter 41;1142;563;579
09575;      Neustadt a.d.Aisch-Bad Windsheim (Lkr);41 bis unter 42;1189;597;592
09575;      Neustadt a.d.Aisch-Bad Windsheim (Lkr);42 bis unter 43;1157;598;559
09575;      Neustadt a.d.Aisch-Bad Windsheim (Lkr);43 bis unter 44;1097;555;542
09575;      Neustadt a.d.Aisch-Bad Windsheim (Lkr);44 bis unter 45;1128;568;560
09575;      Neustadt a.d.Aisch-Bad Windsheim (Lkr);45 bis unter 46;1184;596;588
09575;      Neustadt a.d.Aisch-Bad Windsheim (Lkr);46 bis unter 47;1323;655;668
09575;      Neustadt a.d.Aisch-Bad Windsheim (Lkr);47 bis unter 48;1334;657;677
09575;      Neustadt a.d.Aisch-Bad Windsheim (Lkr);48 bis unter 49;1499;751;748
09575;      Neustadt a.d.Aisch-Bad Windsheim (Lkr);49 bis unter 50;1549;796;753
09575;      Neustadt a.d.Aisch-Bad Windsheim (Lkr);50 bis unter 51;1615;807;808
09575;      Neustadt a.d.Aisch-Bad Windsheim (Lkr);51 bis unter 52;1833;889;944
09575;      Neustadt a.d.Aisch-Bad Windsheim (Lkr);52 bis unter 53;1757;884;873
09575;      Neustadt a.d.Aisch-Bad Windsheim (Lkr);53 bis unter 54;1810;910;900
09575;      Neustadt a.d.Aisch-Bad Windsheim (Lkr);54 bis unter 55;1799;916;883
09575;      Neustadt a.d.Aisch-Bad Windsheim (Lkr);55 bis unter 56;1809;951;858
09575;      Neustadt a.d.Aisch-Bad Windsheim (Lkr);56 bis unter 57;1785;893;892
09575;      Neustadt a.d.Aisch-Bad Windsheim (Lkr);57 bis unter 58;1687;844;843
09575;      Neustadt a.d.Aisch-Bad Windsheim (Lkr);58 bis unter 59;1697;827;870
09575;      Neustadt a.d.Aisch-Bad Windsheim (Lkr);59 bis unter 60;1621;869;752
09575;      Neustadt a.d.Aisch-Bad Windsheim (Lkr);60 bis unter 61;1526;763;763
09575;      Neustadt a.d.Aisch-Bad Windsheim (Lkr);61 bis unter 62;1567;776;791
09575;      Neustadt a.d.Aisch-Bad Windsheim (Lkr);62 bis unter 63;1363;689;674
09575;      Neustadt a.d.Aisch-Bad Windsheim (Lkr);63 bis unter 64;1360;678;682
09575;      Neustadt a.d.Aisch-Bad Windsheim (Lkr);64 bis unter 65;1325;650;675
09575;      Neustadt a.d.Aisch-Bad Windsheim (Lkr);65 bis unter 66;1348;660;688
09575;      Neustadt a.d.Aisch-Bad Windsheim (Lkr);66 bis unter 67;1268;642;626
09575;      Neustadt a.d.Aisch-Bad Windsheim (Lkr);67 bis unter 68;1257;640;617
09575;      Neustadt a.d.Aisch-Bad Windsheim (Lkr);68 bis unter 69;1206;624;582
09575;      Neustadt a.d.Aisch-Bad Windsheim (Lkr);69 bis unter 70;1142;585;557
09575;      Neustadt a.d.Aisch-Bad Windsheim (Lkr);70 bis unter 71;1032;543;489
09575;      Neustadt a.d.Aisch-Bad Windsheim (Lkr);71 bis unter 72;943;469;474
09575;      Neustadt a.d.Aisch-Bad Windsheim (Lkr);72 bis unter 73;780;390;390
09575;      Neustadt a.d.Aisch-Bad Windsheim (Lkr);73 bis unter 74;554;246;308
09575;      Neustadt a.d.Aisch-Bad Windsheim (Lkr);74 bis unter 75;788;374;414
09575;      Neustadt a.d.Aisch-Bad Windsheim (Lkr);75 bis unter 76;739;344;395
09575;      Neustadt a.d.Aisch-Bad Windsheim (Lkr);76 bis unter 77;707;319;388
09575;      Neustadt a.d.Aisch-Bad Windsheim (Lkr);77 bis unter 78;888;400;488
09575;      Neustadt a.d.Aisch-Bad Windsheim (Lkr);78 bis unter 79;1007;470;537
09575;      Neustadt a.d.Aisch-Bad Windsheim (Lkr);79 bis unter 80;1009;454;555
09575;      Neustadt a.d.Aisch-Bad Windsheim (Lkr);80 bis unter 81;916;409;507
09575;      Neustadt a.d.Aisch-Bad Windsheim (Lkr);81 bis unter 82;747;324;423
09575;      Neustadt a.d.Aisch-Bad Windsheim (Lkr);82 bis unter 83;688;283;405
09575;      Neustadt a.d.Aisch-Bad Windsheim (Lkr);83 bis unter 84;626;245;381
09575;      Neustadt a.d.Aisch-Bad Windsheim (Lkr);84 bis unter 85;568;211;357
09575;      Neustadt a.d.Aisch-Bad Windsheim (Lkr);85 bis unter 90;1772;622;1150
09575;      Neustadt a.d.Aisch-Bad Windsheim (Lkr);90 bis unter 95;757;227;530
09575;      Neustadt a.d.Aisch-Bad Windsheim (Lkr);95 oder älter;175;35;140
09575;      Neustadt a.d.Aisch-Bad Windsheim (Lkr);Insgesamt;100364;50331;50033
09576;      Roth (Lkr);unter 1;1214;658;556
09576;      Roth (Lkr);1 bis unter 2;1287;654;633
09576;      Roth (Lkr);2 bis unter 3;1262;658;604
09576;      Roth (Lkr);3 bis unter 4;1185;633;552
09576;      Roth (Lkr);4 bis unter 5;1213;628;585
09576;      Roth (Lkr);5 bis unter 6;1121;571;550
09576;      Roth (Lkr);6 bis unter 7;1125;568;557
09576;      Roth (Lkr);7 bis unter 8;1081;571;510
09576;      Roth (Lkr);8 bis unter 9;1174;603;571
09576;      Roth (Lkr);9 bis unter 10;1068;544;524
09576;      Roth (Lkr);10 bis unter 11;1143;579;564
09576;      Roth (Lkr);11 bis unter 12;1178;597;581
09576;      Roth (Lkr);12 bis unter 13;1096;568;528
09576;      Roth (Lkr);13 bis unter 14;1166;604;562
09576;      Roth (Lkr);14 bis unter 15;1098;553;545
09576;      Roth (Lkr);15 bis unter 16;1227;624;603
09576;      Roth (Lkr);16 bis unter 17;1282;653;629
09576;      Roth (Lkr);17 bis unter 18;1359;724;635
09576;      Roth (Lkr);18 bis unter 19;1344;677;667
09576;      Roth (Lkr);19 bis unter 20;1408;753;655
09576;      Roth (Lkr);20 bis unter 21;1384;713;671
09576;      Roth (Lkr);21 bis unter 22;1436;749;687
09576;      Roth (Lkr);22 bis unter 23;1455;807;648
09576;      Roth (Lkr);23 bis unter 24;1343;720;623
09576;      Roth (Lkr);24 bis unter 25;1324;730;594
09576;      Roth (Lkr);25 bis unter 26;1374;759;615
09576;      Roth (Lkr);26 bis unter 27;1310;690;620
09576;      Roth (Lkr);27 bis unter 28;1355;707;648
09576;      Roth (Lkr);28 bis unter 29;1457;762;695
09576;      Roth (Lkr);29 bis unter 30;1493;790;703
09576;      Roth (Lkr);30 bis unter 31;1531;775;756
09576;      Roth (Lkr);31 bis unter 32;1432;724;708
09576;      Roth (Lkr);32 bis unter 33;1510;757;753
09576;      Roth (Lkr);33 bis unter 34;1467;745;722
09576;      Roth (Lkr);34 bis unter 35;1446;745;701
09576;      Roth (Lkr);35 bis unter 36;1430;725;705
09576;      Roth (Lkr);36 bis unter 37;1566;770;796
09576;      Roth (Lkr);37 bis unter 38;1608;780;828
09576;      Roth (Lkr);38 bis unter 39;1539;794;745
09576;      Roth (Lkr);39 bis unter 40;1517;801;716
09576;      Roth (Lkr);40 bis unter 41;1535;787;748
09576;      Roth (Lkr);41 bis unter 42;1533;737;796
09576;      Roth (Lkr);42 bis unter 43;1478;750;728
09576;      Roth (Lkr);43 bis unter 44;1432;697;735
09576;      Roth (Lkr);44 bis unter 45;1436;737;699
09576;      Roth (Lkr);45 bis unter 46;1548;762;786
09576;      Roth (Lkr);46 bis unter 47;1638;779;859
09576;      Roth (Lkr);47 bis unter 48;1837;915;922
09576;      Roth (Lkr);48 bis unter 49;1920;952;968
09576;      Roth (Lkr);49 bis unter 50;2123;1088;1035
09576;      Roth (Lkr);50 bis unter 51;2241;1141;1100
09576;      Roth (Lkr);51 bis unter 52;2316;1150;1166
09576;      Roth (Lkr);52 bis unter 53;2301;1163;1138
09576;      Roth (Lkr);53 bis unter 54;2357;1216;1141
09576;      Roth (Lkr);54 bis unter 55;2298;1150;1148
09576;      Roth (Lkr);55 bis unter 56;2274;1137;1137
09576;      Roth (Lkr);56 bis unter 57;2251;1077;1174
09576;      Roth (Lkr);57 bis unter 58;2163;1133;1030
09576;      Roth (Lkr);58 bis unter 59;2121;1125;996
09576;      Roth (Lkr);59 bis unter 60;1971;1003;968
09576;      Roth (Lkr);60 bis unter 61;1889;949;940
09576;      Roth (Lkr);61 bis unter 62;1846;915;931
09576;      Roth (Lkr);62 bis unter 63;1780;875;905
09576;      Roth (Lkr);63 bis unter 64;1719;871;848
09576;      Roth (Lkr);64 bis unter 65;1555;772;783
09576;      Roth (Lkr);65 bis unter 66;1510;745;765
09576;      Roth (Lkr);66 bis unter 67;1505;742;763
09576;      Roth (Lkr);67 bis unter 68;1396;657;739
09576;      Roth (Lkr);68 bis unter 69;1410;682;728
09576;      Roth (Lkr);69 bis unter 70;1381;677;704
09576;      Roth (Lkr);70 bis unter 71;1336;648;688
09576;      Roth (Lkr);71 bis unter 72;1247;604;643
09576;      Roth (Lkr);72 bis unter 73;1079;518;561
09576;      Roth (Lkr);73 bis unter 74;820;413;407
09576;      Roth (Lkr);74 bis unter 75;1124;527;597
09576;      Roth (Lkr);75 bis unter 76;1098;517;581
09576;      Roth (Lkr);76 bis unter 77;1025;464;561
09576;      Roth (Lkr);77 bis unter 78;1296;583;713
09576;      Roth (Lkr);78 bis unter 79;1334;555;779
09576;      Roth (Lkr);79 bis unter 80;1264;597;667
09576;      Roth (Lkr);80 bis unter 81;1181;537;644
09576;      Roth (Lkr);81 bis unter 82;1041;428;613
09576;      Roth (Lkr);82 bis unter 83;863;410;453
09576;      Roth (Lkr);83 bis unter 84;756;330;426
09576;      Roth (Lkr);84 bis unter 85;676;260;416
09576;      Roth (Lkr);85 bis unter 90;2058;702;1356
09576;      Roth (Lkr);90 bis unter 95;833;243;590
09576;      Roth (Lkr);95 oder älter;155;23;132
09576;      Roth (Lkr);Insgesamt;126958;63206;63752
09577;      Weißenburg-Gunzenhausen (Lkr);unter 1;875;441;434
09577;      Weißenburg-Gunzenhausen (Lkr);1 bis unter 2;945;462;483
09577;      Weißenburg-Gunzenhausen (Lkr);2 bis unter 3;906;480;426
09577;      Weißenburg-Gunzenhausen (Lkr);3 bis unter 4;904;437;467
09577;      Weißenburg-Gunzenhausen (Lkr);4 bis unter 5;811;416;395
09577;      Weißenburg-Gunzenhausen (Lkr);5 bis unter 6;817;414;403
09577;      Weißenburg-Gunzenhausen (Lkr);6 bis unter 7;778;394;384
09577;      Weißenburg-Gunzenhausen (Lkr);7 bis unter 8;788;417;371
09577;      Weißenburg-Gunzenhausen (Lkr);8 bis unter 9;841;456;385
09577;      Weißenburg-Gunzenhausen (Lkr);9 bis unter 10;824;450;374
09577;      Weißenburg-Gunzenhausen (Lkr);10 bis unter 11;839;432;407
09577;      Weißenburg-Gunzenhausen (Lkr);11 bis unter 12;824;405;419
09577;      Weißenburg-Gunzenhausen (Lkr);12 bis unter 13;866;454;412
09577;      Weißenburg-Gunzenhausen (Lkr);13 bis unter 14;905;480;425
09577;      Weißenburg-Gunzenhausen (Lkr);14 bis unter 15;914;473;441
09577;      Weißenburg-Gunzenhausen (Lkr);15 bis unter 16;944;479;465
09577;      Weißenburg-Gunzenhausen (Lkr);16 bis unter 17;998;492;506
09577;      Weißenburg-Gunzenhausen (Lkr);17 bis unter 18;1010;518;492
09577;      Weißenburg-Gunzenhausen (Lkr);18 bis unter 19;1015;552;463
09577;      Weißenburg-Gunzenhausen (Lkr);19 bis unter 20;1003;549;454
09577;      Weißenburg-Gunzenhausen (Lkr);20 bis unter 21;1032;559;473
09577;      Weißenburg-Gunzenhausen (Lkr);21 bis unter 22;1033;563;470
09577;      Weißenburg-Gunzenhausen (Lkr);22 bis unter 23;1053;584;469
09577;      Weißenburg-Gunzenhausen (Lkr);23 bis unter 24;977;503;474
09577;      Weißenburg-Gunzenhausen (Lkr);24 bis unter 25;998;522;476
09577;      Weißenburg-Gunzenhausen (Lkr);25 bis unter 26;1061;566;495
09577;      Weißenburg-Gunzenhausen (Lkr);26 bis unter 27;986;505;481
09577;      Weißenburg-Gunzenhausen (Lkr);27 bis unter 28;1129;603;526
09577;      Weißenburg-Gunzenhausen (Lkr);28 bis unter 29;1118;575;543
09577;      Weißenburg-Gunzenhausen (Lkr);29 bis unter 30;1112;601;511
09577;      Weißenburg-Gunzenhausen (Lkr);30 bis unter 31;1210;648;562
09577;      Weißenburg-Gunzenhausen (Lkr);31 bis unter 32;1204;637;567
09577;      Weißenburg-Gunzenhausen (Lkr);32 bis unter 33;1127;595;532
09577;      Weißenburg-Gunzenhausen (Lkr);33 bis unter 34;1109;571;538
09577;      Weißenburg-Gunzenhausen (Lkr);34 bis unter 35;1047;527;520
09577;      Weißenburg-Gunzenhausen (Lkr);35 bis unter 36;1049;540;509
09577;      Weißenburg-Gunzenhausen (Lkr);36 bis unter 37;1090;531;559
09577;      Weißenburg-Gunzenhausen (Lkr);37 bis unter 38;1162;570;592
09577;      Weißenburg-Gunzenhausen (Lkr);38 bis unter 39;1123;566;557
09577;      Weißenburg-Gunzenhausen (Lkr);39 bis unter 40;1045;536;509
09577;      Weißenburg-Gunzenhausen (Lkr);40 bis unter 41;1093;567;526
09577;      Weißenburg-Gunzenhausen (Lkr);41 bis unter 42;1023;532;491
09577;      Weißenburg-Gunzenhausen (Lkr);42 bis unter 43;1116;603;513
09577;      Weißenburg-Gunzenhausen (Lkr);43 bis unter 44;1103;541;562
09577;      Weißenburg-Gunzenhausen (Lkr);44 bis unter 45;1087;568;519
09577;      Weißenburg-Gunzenhausen (Lkr);45 bis unter 46;1031;522;509
09577;      Weißenburg-Gunzenhausen (Lkr);46 bis unter 47;1134;568;566
09577;      Weißenburg-Gunzenhausen (Lkr);47 bis unter 48;1231;672;559
09577;      Weißenburg-Gunzenhausen (Lkr);48 bis unter 49;1292;652;640
09577;      Weißenburg-Gunzenhausen (Lkr);49 bis unter 50;1479;731;748
09577;      Weißenburg-Gunzenhausen (Lkr);50 bis unter 51;1495;763;732
09577;      Weißenburg-Gunzenhausen (Lkr);51 bis unter 52;1497;753;744
09577;      Weißenburg-Gunzenhausen (Lkr);52 bis unter 53;1658;821;837
09577;      Weißenburg-Gunzenhausen (Lkr);53 bis unter 54;1569;789;780
09577;      Weißenburg-Gunzenhausen (Lkr);54 bis unter 55;1734;920;814
09577;      Weißenburg-Gunzenhausen (Lkr);55 bis unter 56;1707;897;810
09577;      Weißenburg-Gunzenhausen (Lkr);56 bis unter 57;1673;855;818
09577;      Weißenburg-Gunzenhausen (Lkr);57 bis unter 58;1631;823;808
09577;      Weißenburg-Gunzenhausen (Lkr);58 bis unter 59;1621;795;826
09577;      Weißenburg-Gunzenhausen (Lkr);59 bis unter 60;1529;795;734
09577;      Weißenburg-Gunzenhausen (Lkr);60 bis unter 61;1494;739;755
09577;      Weißenburg-Gunzenhausen (Lkr);61 bis unter 62;1378;676;702
09577;      Weißenburg-Gunzenhausen (Lkr);62 bis unter 63;1373;692;681
09577;      Weißenburg-Gunzenhausen (Lkr);63 bis unter 64;1227;630;597
09577;      Weißenburg-Gunzenhausen (Lkr);64 bis unter 65;1209;613;596
09577;      Weißenburg-Gunzenhausen (Lkr);65 bis unter 66;1153;569;584
09577;      Weißenburg-Gunzenhausen (Lkr);66 bis unter 67;1236;620;616
09577;      Weißenburg-Gunzenhausen (Lkr);67 bis unter 68;1141;540;601
09577;      Weißenburg-Gunzenhausen (Lkr);68 bis unter 69;1160;541;619
09577;      Weißenburg-Gunzenhausen (Lkr);69 bis unter 70;1081;532;549
09577;      Weißenburg-Gunzenhausen (Lkr);70 bis unter 71;1042;524;518
09577;      Weißenburg-Gunzenhausen (Lkr);71 bis unter 72;959;472;487
09577;      Weißenburg-Gunzenhausen (Lkr);72 bis unter 73;767;359;408
09577;      Weißenburg-Gunzenhausen (Lkr);73 bis unter 74;524;231;293
09577;      Weißenburg-Gunzenhausen (Lkr);74 bis unter 75;776;355;421
09577;      Weißenburg-Gunzenhausen (Lkr);75 bis unter 76;781;356;425
09577;      Weißenburg-Gunzenhausen (Lkr);76 bis unter 77;669;319;350
09577;      Weißenburg-Gunzenhausen (Lkr);77 bis unter 78;925;411;514
09577;      Weißenburg-Gunzenhausen (Lkr);78 bis unter 79;1045;437;608
09577;      Weißenburg-Gunzenhausen (Lkr);79 bis unter 80;1050;445;605
09577;      Weißenburg-Gunzenhausen (Lkr);80 bis unter 81;879;415;464
09577;      Weißenburg-Gunzenhausen (Lkr);81 bis unter 82;743;314;429
09577;      Weißenburg-Gunzenhausen (Lkr);82 bis unter 83;706;278;428
09577;      Weißenburg-Gunzenhausen (Lkr);83 bis unter 84;621;247;374
09577;      Weißenburg-Gunzenhausen (Lkr);84 bis unter 85;548;218;330
09577;      Weißenburg-Gunzenhausen (Lkr);85 bis unter 90;1775;632;1143
09577;      Weißenburg-Gunzenhausen (Lkr);90 bis unter 95;738;227;511
09577;      Weißenburg-Gunzenhausen (Lkr);95 oder älter;218;31;187
09577;      Weißenburg-Gunzenhausen (Lkr);Insgesamt;94393;47093;47300
LK095;    Landkreise Mittelfranken;unter 1;8618;4368;4250
LK095;    Landkreise Mittelfranken;1 bis unter 2;9153;4644;4509
LK095;    Landkreise Mittelfranken;2 bis unter 3;9164;4741;4423
LK095;    Landkreise Mittelfranken;3 bis unter 4;8977;4600;4377
LK095;    Landkreise Mittelfranken;4 bis unter 5;8591;4389;4202
LK095;    Landkreise Mittelfranken;5 bis unter 6;8612;4486;4126
LK095;    Landkreise Mittelfranken;6 bis unter 7;8402;4262;4140
LK095;    Landkreise Mittelfranken;7 bis unter 8;8099;4244;3855
LK095;    Landkreise Mittelfranken;8 bis unter 9;8386;4371;4015
LK095;    Landkreise Mittelfranken;9 bis unter 10;8217;4267;3950
LK095;    Landkreise Mittelfranken;10 bis unter 11;8558;4441;4117
LK095;    Landkreise Mittelfranken;11 bis unter 12;8580;4434;4146
LK095;    Landkreise Mittelfranken;12 bis unter 13;8154;4147;4007
LK095;    Landkreise Mittelfranken;13 bis unter 14;8489;4450;4039
LK095;    Landkreise Mittelfranken;14 bis unter 15;8647;4453;4194
LK095;    Landkreise Mittelfranken;15 bis unter 16;8929;4646;4283
LK095;    Landkreise Mittelfranken;16 bis unter 17;9180;4685;4495
LK095;    Landkreise Mittelfranken;17 bis unter 18;9468;4915;4553
LK095;    Landkreise Mittelfranken;18 bis unter 19;9740;5097;4643
LK095;    Landkreise Mittelfranken;19 bis unter 20;9977;5334;4643
LK095;    Landkreise Mittelfranken;20 bis unter 21;10054;5424;4630
LK095;    Landkreise Mittelfranken;21 bis unter 22;10254;5417;4837
LK095;    Landkreise Mittelfranken;22 bis unter 23;10074;5509;4565
LK095;    Landkreise Mittelfranken;23 bis unter 24;9463;5049;4414
LK095;    Landkreise Mittelfranken;24 bis unter 25;9562;5144;4418
LK095;    Landkreise Mittelfranken;25 bis unter 26;9819;5242;4577
LK095;    Landkreise Mittelfranken;26 bis unter 27;9764;5177;4587
LK095;    Landkreise Mittelfranken;27 bis unter 28;10184;5382;4802
LK095;    Landkreise Mittelfranken;28 bis unter 29;10470;5396;5074
LK095;    Landkreise Mittelfranken;29 bis unter 30;10562;5469;5093
LK095;    Landkreise Mittelfranken;30 bis unter 31;11028;5715;5313
LK095;    Landkreise Mittelfranken;31 bis unter 32;10888;5544;5344
LK095;    Landkreise Mittelfranken;32 bis unter 33;10795;5436;5359
LK095;    Landkreise Mittelfranken;33 bis unter 34;10753;5359;5394
LK095;    Landkreise Mittelfranken;34 bis unter 35;10975;5480;5495
LK095;    Landkreise Mittelfranken;35 bis unter 36;11088;5670;5418
LK095;    Landkreise Mittelfranken;36 bis unter 37;11532;5717;5815
LK095;    Landkreise Mittelfranken;37 bis unter 38;11972;5913;6059
LK095;    Landkreise Mittelfranken;38 bis unter 39;11683;5898;5785
LK095;    Landkreise Mittelfranken;39 bis unter 40;11087;5575;5512
LK095;    Landkreise Mittelfranken;40 bis unter 41;11191;5591;5600
LK095;    Landkreise Mittelfranken;41 bis unter 42;11048;5544;5504
LK095;    Landkreise Mittelfranken;42 bis unter 43;11014;5566;5448
LK095;    Landkreise Mittelfranken;43 bis unter 44;10645;5305;5340
LK095;    Landkreise Mittelfranken;44 bis unter 45;10819;5434;5385
LK095;    Landkreise Mittelfranken;45 bis unter 46;11058;5545;5513
LK095;    Landkreise Mittelfranken;46 bis unter 47;12061;5970;6091
LK095;    Landkreise Mittelfranken;47 bis unter 48;12993;6543;6450
LK095;    Landkreise Mittelfranken;48 bis unter 49;13812;6830;6982
LK095;    Landkreise Mittelfranken;49 bis unter 50;15103;7608;7495
LK095;    Landkreise Mittelfranken;50 bis unter 51;15708;7804;7904
LK095;    Landkreise Mittelfranken;51 bis unter 52;16452;8285;8167
LK095;    Landkreise Mittelfranken;52 bis unter 53;16236;8102;8134
LK095;    Landkreise Mittelfranken;53 bis unter 54;16299;8273;8026
LK095;    Landkreise Mittelfranken;54 bis unter 55;16651;8491;8160
LK095;    Landkreise Mittelfranken;55 bis unter 56;16676;8525;8151
LK095;    Landkreise Mittelfranken;56 bis unter 57;16266;8032;8234
LK095;    Landkreise Mittelfranken;57 bis unter 58;15785;7998;7787
LK095;    Landkreise Mittelfranken;58 bis unter 59;15179;7578;7601
LK095;    Landkreise Mittelfranken;59 bis unter 60;14731;7480;7251
LK095;    Landkreise Mittelfranken;60 bis unter 61;14042;7002;7040
LK095;    Landkreise Mittelfranken;61 bis unter 62;13638;6739;6899
LK095;    Landkreise Mittelfranken;62 bis unter 63;12968;6493;6475
LK095;    Landkreise Mittelfranken;63 bis unter 64;12281;6085;6196
LK095;    Landkreise Mittelfranken;64 bis unter 65;11911;5907;6004
LK095;    Landkreise Mittelfranken;65 bis unter 66;11439;5725;5714
LK095;    Landkreise Mittelfranken;66 bis unter 67;11424;5505;5919
LK095;    Landkreise Mittelfranken;67 bis unter 68;10889;5234;5655
LK095;    Landkreise Mittelfranken;68 bis unter 69;10664;5200;5464
LK095;    Landkreise Mittelfranken;69 bis unter 70;10482;5132;5350
LK095;    Landkreise Mittelfranken;70 bis unter 71;9805;4779;5026
LK095;    Landkreise Mittelfranken;71 bis unter 72;9280;4564;4716
LK095;    Landkreise Mittelfranken;72 bis unter 73;7777;3769;4008
LK095;    Landkreise Mittelfranken;73 bis unter 74;5926;2888;3038
LK095;    Landkreise Mittelfranken;74 bis unter 75;8086;3854;4232
LK095;    Landkreise Mittelfranken;75 bis unter 76;7809;3643;4166
LK095;    Landkreise Mittelfranken;76 bis unter 77;7497;3455;4042
LK095;    Landkreise Mittelfranken;77 bis unter 78;9300;4165;5135
LK095;    Landkreise Mittelfranken;78 bis unter 79;9755;4375;5380
LK095;    Landkreise Mittelfranken;79 bis unter 80;9733;4347;5386
LK095;    Landkreise Mittelfranken;80 bis unter 81;8412;3700;4712
LK095;    Landkreise Mittelfranken;81 bis unter 82;7263;3157;4106
LK095;    Landkreise Mittelfranken;82 bis unter 83;6506;2778;3728
LK095;    Landkreise Mittelfranken;83 bis unter 84;5817;2402;3415
LK095;    Landkreise Mittelfranken;84 bis unter 85;5071;1943;3128
LK095;    Landkreise Mittelfranken;85 bis unter 90;16139;5761;10378
LK095;    Landkreise Mittelfranken;90 bis unter 95;6548;1979;4569
LK095;    Landkreise Mittelfranken;95 oder älter;1550;278;1272
LK095;    Landkreise Mittelfranken;Insgesamt;929687;461853;467834
095;  Mittelfranken;unter 1;17500;8873;8627
095;  Mittelfranken;1 bis unter 2;17756;9063;8693
095;  Mittelfranken;2 bis unter 3;17733;9175;8558
095;  Mittelfranken;3 bis unter 4;17034;8790;8244
095;  Mittelfranken;4 bis unter 5;16521;8413;8108
095;  Mittelfranken;5 bis unter 6;16071;8293;7778
095;  Mittelfranken;6 bis unter 7;15660;8022;7638
095;  Mittelfranken;7 bis unter 8;15125;7833;7292
095;  Mittelfranken;8 bis unter 9;15478;8105;7373
095;  Mittelfranken;9 bis unter 10;15146;7864;7282
095;  Mittelfranken;10 bis unter 11;15628;8105;7523
095;  Mittelfranken;11 bis unter 12;15850;8159;7691
095;  Mittelfranken;12 bis unter 13;15181;7784;7397
095;  Mittelfranken;13 bis unter 14;15429;8031;7398
095;  Mittelfranken;14 bis unter 15;15746;8045;7701
095;  Mittelfranken;15 bis unter 16;15894;8260;7634
095;  Mittelfranken;16 bis unter 17;16263;8367;7896
095;  Mittelfranken;17 bis unter 18;16802;8798;8004
095;  Mittelfranken;18 bis unter 19;17607;9182;8425
095;  Mittelfranken;19 bis unter 20;18717;9871;8846
095;  Mittelfranken;20 bis unter 21;19686;10340;9346
095;  Mittelfranken;21 bis unter 22;20617;10647;9970
095;  Mittelfranken;22 bis unter 23;21072;11028;10044
095;  Mittelfranken;23 bis unter 24;20831;10810;10021
095;  Mittelfranken;24 bis unter 25;21692;11346;10346
095;  Mittelfranken;25 bis unter 26;22520;11748;10772
095;  Mittelfranken;26 bis unter 27;22836;11824;11012
095;  Mittelfranken;27 bis unter 28;23665;12313;11352
095;  Mittelfranken;28 bis unter 29;24695;12579;12116
095;  Mittelfranken;29 bis unter 30;24379;12632;11747
095;  Mittelfranken;30 bis unter 31;24780;12846;11934
095;  Mittelfranken;31 bis unter 32;24121;12480;11641
095;  Mittelfranken;32 bis unter 33;23552;11937;11615
095;  Mittelfranken;33 bis unter 34;22797;11498;11299
095;  Mittelfranken;34 bis unter 35;23049;11589;11460
095;  Mittelfranken;35 bis unter 36;23041;11919;11122
095;  Mittelfranken;36 bis unter 37;23678;11863;11815
095;  Mittelfranken;37 bis unter 38;23880;11909;11971
095;  Mittelfranken;38 bis unter 39;23432;11833;11599
095;  Mittelfranken;39 bis unter 40;22226;11086;11140
095;  Mittelfranken;40 bis unter 41;22090;11012;11078
095;  Mittelfranken;41 bis unter 42;21499;10786;10713
095;  Mittelfranken;42 bis unter 43;21689;10880;10809
095;  Mittelfranken;43 bis unter 44;20733;10282;10451
095;  Mittelfranken;44 bis unter 45;20952;10422;10530
095;  Mittelfranken;45 bis unter 46;20923;10399;10524
095;  Mittelfranken;46 bis unter 47;22625;11236;11389
095;  Mittelfranken;47 bis unter 48;24252;12090;12162
095;  Mittelfranken;48 bis unter 49;25465;12613;12852
095;  Mittelfranken;49 bis unter 50;27502;13852;13650
095;  Mittelfranken;50 bis unter 51;28680;14463;14217
095;  Mittelfranken;51 bis unter 52;29629;14914;14715
095;  Mittelfranken;52 bis unter 53;29250;14733;14517
095;  Mittelfranken;53 bis unter 54;29104;14736;14368
095;  Mittelfranken;54 bis unter 55;29531;15034;14497
095;  Mittelfranken;55 bis unter 56;29250;14766;14484
095;  Mittelfranken;56 bis unter 57;28318;14130;14188
095;  Mittelfranken;57 bis unter 58;27619;13781;13838
095;  Mittelfranken;58 bis unter 59;26600;13219;13381
095;  Mittelfranken;59 bis unter 60;25515;12777;12738
095;  Mittelfranken;60 bis unter 61;24473;12134;12339
095;  Mittelfranken;61 bis unter 62;23627;11603;12024
095;  Mittelfranken;62 bis unter 63;22782;11318;11464
095;  Mittelfranken;63 bis unter 64;21627;10532;11095
095;  Mittelfranken;64 bis unter 65;20797;10029;10768
095;  Mittelfranken;65 bis unter 66;19744;9557;10187
095;  Mittelfranken;66 bis unter 67;19986;9387;10599
095;  Mittelfranken;67 bis unter 68;19045;8895;10150
095;  Mittelfranken;68 bis unter 69;18767;8798;9969
095;  Mittelfranken;69 bis unter 70;18440;8705;9735
095;  Mittelfranken;70 bis unter 71;17647;8399;9248
095;  Mittelfranken;71 bis unter 72;17107;8165;8942
095;  Mittelfranken;72 bis unter 73;14648;6832;7816
095;  Mittelfranken;73 bis unter 74;11709;5515;6194
095;  Mittelfranken;74 bis unter 75;15332;7155;8177
095;  Mittelfranken;75 bis unter 76;15022;6912;8110
095;  Mittelfranken;76 bis unter 77;14054;6359;7695
095;  Mittelfranken;77 bis unter 78;17277;7586;9691
095;  Mittelfranken;78 bis unter 79;18052;7839;10213
095;  Mittelfranken;79 bis unter 80;17462;7612;9850
095;  Mittelfranken;80 bis unter 81;15383;6563;8820
095;  Mittelfranken;81 bis unter 82;13449;5623;7826
095;  Mittelfranken;82 bis unter 83;12319;5125;7194
095;  Mittelfranken;83 bis unter 84;10968;4341;6627
095;  Mittelfranken;84 bis unter 85;9470;3595;5875
095;  Mittelfranken;85 bis unter 90;30306;10758;19548
095;  Mittelfranken;90 bis unter 95;12862;3768;9094
095;  Mittelfranken;95 oder älter;3130;580;2550
095;  Mittelfranken;Insgesamt;1770401;873070;897331
09661;      Aschaffenburg (Krfr.St);unter 1;672;348;324
09661;      Aschaffenburg (Krfr.St);1 bis unter 2;703;367;336
09661;      Aschaffenburg (Krfr.St);2 bis unter 3;682;351;331
09661;      Aschaffenburg (Krfr.St);3 bis unter 4;634;334;300
09661;      Aschaffenburg (Krfr.St);4 bis unter 5;646;329;317
09661;      Aschaffenburg (Krfr.St);5 bis unter 6;568;275;293
09661;      Aschaffenburg (Krfr.St);6 bis unter 7;582;300;282
09661;      Aschaffenburg (Krfr.St);7 bis unter 8;593;318;275
09661;      Aschaffenburg (Krfr.St);8 bis unter 9;610;306;304
09661;      Aschaffenburg (Krfr.St);9 bis unter 10;600;320;280
09661;      Aschaffenburg (Krfr.St);10 bis unter 11;643;328;315
09661;      Aschaffenburg (Krfr.St);11 bis unter 12;584;286;298
09661;      Aschaffenburg (Krfr.St);12 bis unter 13;606;309;297
09661;      Aschaffenburg (Krfr.St);13 bis unter 14;583;288;295
09661;      Aschaffenburg (Krfr.St);14 bis unter 15;629;323;306
09661;      Aschaffenburg (Krfr.St);15 bis unter 16;612;306;306
09661;      Aschaffenburg (Krfr.St);16 bis unter 17;599;310;289
09661;      Aschaffenburg (Krfr.St);17 bis unter 18;640;329;311
09661;      Aschaffenburg (Krfr.St);18 bis unter 19;671;353;318
09661;      Aschaffenburg (Krfr.St);19 bis unter 20;739;418;321
09661;      Aschaffenburg (Krfr.St);20 bis unter 21;713;383;330
09661;      Aschaffenburg (Krfr.St);21 bis unter 22;755;370;385
09661;      Aschaffenburg (Krfr.St);22 bis unter 23;780;419;361
09661;      Aschaffenburg (Krfr.St);23 bis unter 24;783;401;382
09661;      Aschaffenburg (Krfr.St);24 bis unter 25;906;470;436
09661;      Aschaffenburg (Krfr.St);25 bis unter 26;909;467;442
09661;      Aschaffenburg (Krfr.St);26 bis unter 27;882;446;436
09661;      Aschaffenburg (Krfr.St);27 bis unter 28;993;504;489
09661;      Aschaffenburg (Krfr.St);28 bis unter 29;1106;588;518
09661;      Aschaffenburg (Krfr.St);29 bis unter 30;1049;551;498
09661;      Aschaffenburg (Krfr.St);30 bis unter 31;1107;547;560
09661;      Aschaffenburg (Krfr.St);31 bis unter 32;1050;540;510
09661;      Aschaffenburg (Krfr.St);32 bis unter 33;1032;547;485
09661;      Aschaffenburg (Krfr.St);33 bis unter 34;935;467;468
09661;      Aschaffenburg (Krfr.St);34 bis unter 35;930;483;447
09661;      Aschaffenburg (Krfr.St);35 bis unter 36;995;469;526
09661;      Aschaffenburg (Krfr.St);36 bis unter 37;973;465;508
09661;      Aschaffenburg (Krfr.St);37 bis unter 38;948;465;483
09661;      Aschaffenburg (Krfr.St);38 bis unter 39;923;461;462
09661;      Aschaffenburg (Krfr.St);39 bis unter 40;874;460;414
09661;      Aschaffenburg (Krfr.St);40 bis unter 41;830;411;419
09661;      Aschaffenburg (Krfr.St);41 bis unter 42;853;433;420
09661;      Aschaffenburg (Krfr.St);42 bis unter 43;829;413;416
09661;      Aschaffenburg (Krfr.St);43 bis unter 44;896;431;465
09661;      Aschaffenburg (Krfr.St);44 bis unter 45;827;426;401
09661;      Aschaffenburg (Krfr.St);45 bis unter 46;861;427;434
09661;      Aschaffenburg (Krfr.St);46 bis unter 47;940;444;496
09661;      Aschaffenburg (Krfr.St);47 bis unter 48;930;496;434
09661;      Aschaffenburg (Krfr.St);48 bis unter 49;972;486;486
09661;      Aschaffenburg (Krfr.St);49 bis unter 50;994;477;517
09661;      Aschaffenburg (Krfr.St);50 bis unter 51;1072;549;523
09661;      Aschaffenburg (Krfr.St);51 bis unter 52;1152;565;587
09661;      Aschaffenburg (Krfr.St);52 bis unter 53;1115;542;573
09661;      Aschaffenburg (Krfr.St);53 bis unter 54;1185;600;585
09661;      Aschaffenburg (Krfr.St);54 bis unter 55;1192;593;599
09661;      Aschaffenburg (Krfr.St);55 bis unter 56;1187;576;611
09661;      Aschaffenburg (Krfr.St);56 bis unter 57;1105;569;536
09661;      Aschaffenburg (Krfr.St);57 bis unter 58;1033;519;514
09661;      Aschaffenburg (Krfr.St);58 bis unter 59;1021;511;510
09661;      Aschaffenburg (Krfr.St);59 bis unter 60;1070;499;571
09661;      Aschaffenburg (Krfr.St);60 bis unter 61;987;487;500
09661;      Aschaffenburg (Krfr.St);61 bis unter 62;936;459;477
09661;      Aschaffenburg (Krfr.St);62 bis unter 63;914;414;500
09661;      Aschaffenburg (Krfr.St);63 bis unter 64;875;399;476
09661;      Aschaffenburg (Krfr.St);64 bis unter 65;840;401;439
09661;      Aschaffenburg (Krfr.St);65 bis unter 66;854;364;490
09661;      Aschaffenburg (Krfr.St);66 bis unter 67;820;393;427
09661;      Aschaffenburg (Krfr.St);67 bis unter 68;802;362;440
09661;      Aschaffenburg (Krfr.St);68 bis unter 69;856;406;450
09661;      Aschaffenburg (Krfr.St);69 bis unter 70;775;368;407
09661;      Aschaffenburg (Krfr.St);70 bis unter 71;667;291;376
09661;      Aschaffenburg (Krfr.St);71 bis unter 72;652;294;358
09661;      Aschaffenburg (Krfr.St);72 bis unter 73;524;235;289
09661;      Aschaffenburg (Krfr.St);73 bis unter 74;479;210;269
09661;      Aschaffenburg (Krfr.St);74 bis unter 75;588;255;333
09661;      Aschaffenburg (Krfr.St);75 bis unter 76;636;289;347
09661;      Aschaffenburg (Krfr.St);76 bis unter 77;560;258;302
09661;      Aschaffenburg (Krfr.St);77 bis unter 78;692;321;371
09661;      Aschaffenburg (Krfr.St);78 bis unter 79;699;285;414
09661;      Aschaffenburg (Krfr.St);79 bis unter 80;677;277;400
09661;      Aschaffenburg (Krfr.St);80 bis unter 81;595;237;358
09661;      Aschaffenburg (Krfr.St);81 bis unter 82;520;221;299
09661;      Aschaffenburg (Krfr.St);82 bis unter 83;503;202;301
09661;      Aschaffenburg (Krfr.St);83 bis unter 84;457;169;288
09661;      Aschaffenburg (Krfr.St);84 bis unter 85;379;151;228
09661;      Aschaffenburg (Krfr.St);85 bis unter 90;1197;426;771
09661;      Aschaffenburg (Krfr.St);90 bis unter 95;592;155;437
09661;      Aschaffenburg (Krfr.St);95 oder älter;148;19;129
09661;      Aschaffenburg (Krfr.St);Insgesamt;70527;34316;36211
09662;      Schweinfurt (Krfr.St);unter 1;593;304;289
09662;      Schweinfurt (Krfr.St);1 bis unter 2;562;313;249
09662;      Schweinfurt (Krfr.St);2 bis unter 3;520;262;258
09662;      Schweinfurt (Krfr.St);3 bis unter 4;533;283;250
09662;      Schweinfurt (Krfr.St);4 bis unter 5;470;235;235
09662;      Schweinfurt (Krfr.St);5 bis unter 6;485;240;245
09662;      Schweinfurt (Krfr.St);6 bis unter 7;477;248;229
09662;      Schweinfurt (Krfr.St);7 bis unter 8;452;216;236
09662;      Schweinfurt (Krfr.St);8 bis unter 9;433;214;219
09662;      Schweinfurt (Krfr.St);9 bis unter 10;512;261;251
09662;      Schweinfurt (Krfr.St);10 bis unter 11;457;252;205
09662;      Schweinfurt (Krfr.St);11 bis unter 12;484;253;231
09662;      Schweinfurt (Krfr.St);12 bis unter 13;465;228;237
09662;      Schweinfurt (Krfr.St);13 bis unter 14;465;238;227
09662;      Schweinfurt (Krfr.St);14 bis unter 15;463;250;213
09662;      Schweinfurt (Krfr.St);15 bis unter 16;436;221;215
09662;      Schweinfurt (Krfr.St);16 bis unter 17;448;232;216
09662;      Schweinfurt (Krfr.St);17 bis unter 18;493;272;221
09662;      Schweinfurt (Krfr.St);18 bis unter 19;558;303;255
09662;      Schweinfurt (Krfr.St);19 bis unter 20;682;384;298
09662;      Schweinfurt (Krfr.St);20 bis unter 21;698;405;293
09662;      Schweinfurt (Krfr.St);21 bis unter 22;709;391;318
09662;      Schweinfurt (Krfr.St);22 bis unter 23;726;400;326
09662;      Schweinfurt (Krfr.St);23 bis unter 24;690;373;317
09662;      Schweinfurt (Krfr.St);24 bis unter 25;688;352;336
09662;      Schweinfurt (Krfr.St);25 bis unter 26;710;384;326
09662;      Schweinfurt (Krfr.St);26 bis unter 27;811;449;362
09662;      Schweinfurt (Krfr.St);27 bis unter 28;768;419;349
09662;      Schweinfurt (Krfr.St);28 bis unter 29;750;405;345
09662;      Schweinfurt (Krfr.St);29 bis unter 30;750;416;334
09662;      Schweinfurt (Krfr.St);30 bis unter 31;765;422;343
09662;      Schweinfurt (Krfr.St);31 bis unter 32;738;401;337
09662;      Schweinfurt (Krfr.St);32 bis unter 33;701;394;307
09662;      Schweinfurt (Krfr.St);33 bis unter 34;703;388;315
09662;      Schweinfurt (Krfr.St);34 bis unter 35;696;367;329
09662;      Schweinfurt (Krfr.St);35 bis unter 36;672;340;332
09662;      Schweinfurt (Krfr.St);36 bis unter 37;696;377;319
09662;      Schweinfurt (Krfr.St);37 bis unter 38;708;354;354
09662;      Schweinfurt (Krfr.St);38 bis unter 39;585;310;275
09662;      Schweinfurt (Krfr.St);39 bis unter 40;593;317;276
09662;      Schweinfurt (Krfr.St);40 bis unter 41;601;281;320
09662;      Schweinfurt (Krfr.St);41 bis unter 42;621;305;316
09662;      Schweinfurt (Krfr.St);42 bis unter 43;554;276;278
09662;      Schweinfurt (Krfr.St);43 bis unter 44;536;259;277
09662;      Schweinfurt (Krfr.St);44 bis unter 45;594;279;315
09662;      Schweinfurt (Krfr.St);45 bis unter 46;593;295;298
09662;      Schweinfurt (Krfr.St);46 bis unter 47;598;295;303
09662;      Schweinfurt (Krfr.St);47 bis unter 48;637;311;326
09662;      Schweinfurt (Krfr.St);48 bis unter 49;568;284;284
09662;      Schweinfurt (Krfr.St);49 bis unter 50;689;351;338
09662;      Schweinfurt (Krfr.St);50 bis unter 51;690;354;336
09662;      Schweinfurt (Krfr.St);51 bis unter 52;738;368;370
09662;      Schweinfurt (Krfr.St);52 bis unter 53;811;413;398
09662;      Schweinfurt (Krfr.St);53 bis unter 54;759;396;363
09662;      Schweinfurt (Krfr.St);54 bis unter 55;780;402;378
09662;      Schweinfurt (Krfr.St);55 bis unter 56;767;383;384
09662;      Schweinfurt (Krfr.St);56 bis unter 57;822;411;411
09662;      Schweinfurt (Krfr.St);57 bis unter 58;813;399;414
09662;      Schweinfurt (Krfr.St);58 bis unter 59;755;358;397
09662;      Schweinfurt (Krfr.St);59 bis unter 60;766;371;395
09662;      Schweinfurt (Krfr.St);60 bis unter 61;750;346;404
09662;      Schweinfurt (Krfr.St);61 bis unter 62;683;320;363
09662;      Schweinfurt (Krfr.St);62 bis unter 63;740;361;379
09662;      Schweinfurt (Krfr.St);63 bis unter 64;668;323;345
09662;      Schweinfurt (Krfr.St);64 bis unter 65;677;294;383
09662;      Schweinfurt (Krfr.St);65 bis unter 66;650;300;350
09662;      Schweinfurt (Krfr.St);66 bis unter 67;643;277;366
09662;      Schweinfurt (Krfr.St);67 bis unter 68;603;274;329
09662;      Schweinfurt (Krfr.St);68 bis unter 69;639;279;360
09662;      Schweinfurt (Krfr.St);69 bis unter 70;585;271;314
09662;      Schweinfurt (Krfr.St);70 bis unter 71;570;279;291
09662;      Schweinfurt (Krfr.St);71 bis unter 72;494;222;272
09662;      Schweinfurt (Krfr.St);72 bis unter 73;454;199;255
09662;      Schweinfurt (Krfr.St);73 bis unter 74;386;158;228
09662;      Schweinfurt (Krfr.St);74 bis unter 75;524;229;295
09662;      Schweinfurt (Krfr.St);75 bis unter 76;508;227;281
09662;      Schweinfurt (Krfr.St);76 bis unter 77;491;226;265
09662;      Schweinfurt (Krfr.St);77 bis unter 78;637;257;380
09662;      Schweinfurt (Krfr.St);78 bis unter 79;664;277;387
09662;      Schweinfurt (Krfr.St);79 bis unter 80;552;234;318
09662;      Schweinfurt (Krfr.St);80 bis unter 81;548;207;341
09662;      Schweinfurt (Krfr.St);81 bis unter 82;501;218;283
09662;      Schweinfurt (Krfr.St);82 bis unter 83;470;200;270
09662;      Schweinfurt (Krfr.St);83 bis unter 84;385;157;228
09662;      Schweinfurt (Krfr.St);84 bis unter 85;366;133;233
09662;      Schweinfurt (Krfr.St);85 bis unter 90;1184;411;773
09662;      Schweinfurt (Krfr.St);90 bis unter 95;637;186;451
09662;      Schweinfurt (Krfr.St);95 oder älter;186;24;162
09662;      Schweinfurt (Krfr.St);Insgesamt;54032;26553;27479
09663;      Würzburg (Krfr.St);unter 1;1224;620;604
09663;      Würzburg (Krfr.St);1 bis unter 2;1122;561;561
09663;      Würzburg (Krfr.St);2 bis unter 3;1048;515;533
09663;      Würzburg (Krfr.St);3 bis unter 4;1037;513;524
09663;      Würzburg (Krfr.St);4 bis unter 5;983;510;473
09663;      Würzburg (Krfr.St);5 bis unter 6;906;454;452
09663;      Würzburg (Krfr.St);6 bis unter 7;864;456;408
09663;      Würzburg (Krfr.St);7 bis unter 8;766;376;390
09663;      Würzburg (Krfr.St);8 bis unter 9;818;407;411
09663;      Würzburg (Krfr.St);9 bis unter 10;778;415;363
09663;      Würzburg (Krfr.St);10 bis unter 11;828;404;424
09663;      Würzburg (Krfr.St);11 bis unter 12;792;408;384
09663;      Würzburg (Krfr.St);12 bis unter 13;803;434;369
09663;      Würzburg (Krfr.St);13 bis unter 14;773;404;369
09663;      Würzburg (Krfr.St);14 bis unter 15;810;394;416
09663;      Würzburg (Krfr.St);15 bis unter 16;787;404;383
09663;      Würzburg (Krfr.St);16 bis unter 17;800;400;400
09663;      Würzburg (Krfr.St);17 bis unter 18;866;458;408
09663;      Würzburg (Krfr.St);18 bis unter 19;1108;537;571
09663;      Würzburg (Krfr.St);19 bis unter 20;1643;729;914
09663;      Würzburg (Krfr.St);20 bis unter 21;2304;989;1315
09663;      Würzburg (Krfr.St);21 bis unter 22;2641;1120;1521
09663;      Würzburg (Krfr.St);22 bis unter 23;2821;1179;1642
09663;      Würzburg (Krfr.St);23 bis unter 24;2826;1235;1591
09663;      Würzburg (Krfr.St);24 bis unter 25;2894;1280;1614
09663;      Würzburg (Krfr.St);25 bis unter 26;2999;1435;1564
09663;      Würzburg (Krfr.St);26 bis unter 27;2914;1418;1496
09663;      Würzburg (Krfr.St);27 bis unter 28;2818;1429;1389
09663;      Würzburg (Krfr.St);28 bis unter 29;2825;1464;1361
09663;      Würzburg (Krfr.St);29 bis unter 30;2716;1397;1319
09663;      Würzburg (Krfr.St);30 bis unter 31;2659;1481;1178
09663;      Würzburg (Krfr.St);31 bis unter 32;2352;1305;1047
09663;      Würzburg (Krfr.St);32 bis unter 33;2250;1269;981
09663;      Würzburg (Krfr.St);33 bis unter 34;1925;1075;850
09663;      Würzburg (Krfr.St);34 bis unter 35;1855;1019;836
09663;      Würzburg (Krfr.St);35 bis unter 36;1825;1016;809
09663;      Würzburg (Krfr.St);36 bis unter 37;1764;944;820
09663;      Würzburg (Krfr.St);37 bis unter 38;1639;817;822
09663;      Würzburg (Krfr.St);38 bis unter 39;1472;790;682
09663;      Würzburg (Krfr.St);39 bis unter 40;1392;724;668
09663;      Würzburg (Krfr.St);40 bis unter 41;1415;745;670
09663;      Würzburg (Krfr.St);41 bis unter 42;1314;688;626
09663;      Würzburg (Krfr.St);42 bis unter 43;1301;628;673
09663;      Würzburg (Krfr.St);43 bis unter 44;1232;627;605
09663;      Würzburg (Krfr.St);44 bis unter 45;1264;670;594
09663;      Würzburg (Krfr.St);45 bis unter 46;1137;544;593
09663;      Würzburg (Krfr.St);46 bis unter 47;1293;673;620
09663;      Würzburg (Krfr.St);47 bis unter 48;1345;683;662
09663;      Würzburg (Krfr.St);48 bis unter 49;1403;725;678
09663;      Würzburg (Krfr.St);49 bis unter 50;1477;748;729
09663;      Würzburg (Krfr.St);50 bis unter 51;1621;809;812
09663;      Würzburg (Krfr.St);51 bis unter 52;1726;858;868
09663;      Würzburg (Krfr.St);52 bis unter 53;1682;826;856
09663;      Würzburg (Krfr.St);53 bis unter 54;1685;838;847
09663;      Würzburg (Krfr.St);54 bis unter 55;1682;819;863
09663;      Würzburg (Krfr.St);55 bis unter 56;1717;820;897
09663;      Würzburg (Krfr.St);56 bis unter 57;1627;797;830
09663;      Würzburg (Krfr.St);57 bis unter 58;1700;812;888
09663;      Würzburg (Krfr.St);58 bis unter 59;1584;786;798
09663;      Würzburg (Krfr.St);59 bis unter 60;1467;708;759
09663;      Würzburg (Krfr.St);60 bis unter 61;1422;671;751
09663;      Würzburg (Krfr.St);61 bis unter 62;1462;649;813
09663;      Würzburg (Krfr.St);62 bis unter 63;1447;652;795
09663;      Würzburg (Krfr.St);63 bis unter 64;1344;631;713
09663;      Würzburg (Krfr.St);64 bis unter 65;1373;616;757
09663;      Würzburg (Krfr.St);65 bis unter 66;1265;597;668
09663;      Würzburg (Krfr.St);66 bis unter 67;1303;598;705
09663;      Würzburg (Krfr.St);67 bis unter 68;1172;507;665
09663;      Würzburg (Krfr.St);68 bis unter 69;1209;512;697
09663;      Würzburg (Krfr.St);69 bis unter 70;1197;544;653
09663;      Würzburg (Krfr.St);70 bis unter 71;1079;466;613
09663;      Würzburg (Krfr.St);71 bis unter 72;1122;489;633
09663;      Würzburg (Krfr.St);72 bis unter 73;936;442;494
09663;      Würzburg (Krfr.St);73 bis unter 74;733;313;420
09663;      Würzburg (Krfr.St);74 bis unter 75;1057;470;587
09663;      Würzburg (Krfr.St);75 bis unter 76;1004;436;568
09663;      Würzburg (Krfr.St);76 bis unter 77;1002;413;589
09663;      Würzburg (Krfr.St);77 bis unter 78;1238;517;721
09663;      Würzburg (Krfr.St);78 bis unter 79;1275;538;737
09663;      Würzburg (Krfr.St);79 bis unter 80;1202;499;703
09663;      Würzburg (Krfr.St);80 bis unter 81;1137;462;675
09663;      Würzburg (Krfr.St);81 bis unter 82;1003;403;600
09663;      Würzburg (Krfr.St);82 bis unter 83;962;369;593
09663;      Würzburg (Krfr.St);83 bis unter 84;868;313;555
09663;      Würzburg (Krfr.St);84 bis unter 85;771;303;468
09663;      Würzburg (Krfr.St);85 bis unter 90;2413;808;1605
09663;      Würzburg (Krfr.St);90 bis unter 95;1198;280;918
09663;      Würzburg (Krfr.St);95 oder älter;367;64;303
09663;      Würzburg (Krfr.St);Insgesamt;127880;61151;66729
KS096;    Kreisfreie Städte Unterfranken;unter 1;2489;1272;1217
KS096;    Kreisfreie Städte Unterfranken;1 bis unter 2;2387;1241;1146
KS096;    Kreisfreie Städte Unterfranken;2 bis unter 3;2250;1128;1122
KS096;    Kreisfreie Städte Unterfranken;3 bis unter 4;2204;1130;1074
KS096;    Kreisfreie Städte Unterfranken;4 bis unter 5;2099;1074;1025
KS096;    Kreisfreie Städte Unterfranken;5 bis unter 6;1959;969;990
KS096;    Kreisfreie Städte Unterfranken;6 bis unter 7;1923;1004;919
KS096;    Kreisfreie Städte Unterfranken;7 bis unter 8;1811;910;901
KS096;    Kreisfreie Städte Unterfranken;8 bis unter 9;1861;927;934
KS096;    Kreisfreie Städte Unterfranken;9 bis unter 10;1890;996;894
KS096;    Kreisfreie Städte Unterfranken;10 bis unter 11;1928;984;944
KS096;    Kreisfreie Städte Unterfranken;11 bis unter 12;1860;947;913
KS096;    Kreisfreie Städte Unterfranken;12 bis unter 13;1874;971;903
KS096;    Kreisfreie Städte Unterfranken;13 bis unter 14;1821;930;891
KS096;    Kreisfreie Städte Unterfranken;14 bis unter 15;1902;967;935
KS096;    Kreisfreie Städte Unterfranken;15 bis unter 16;1835;931;904
KS096;    Kreisfreie Städte Unterfranken;16 bis unter 17;1847;942;905
KS096;    Kreisfreie Städte Unterfranken;17 bis unter 18;1999;1059;940
KS096;    Kreisfreie Städte Unterfranken;18 bis unter 19;2337;1193;1144
KS096;    Kreisfreie Städte Unterfranken;19 bis unter 20;3064;1531;1533
KS096;    Kreisfreie Städte Unterfranken;20 bis unter 21;3715;1777;1938
KS096;    Kreisfreie Städte Unterfranken;21 bis unter 22;4105;1881;2224
KS096;    Kreisfreie Städte Unterfranken;22 bis unter 23;4327;1998;2329
KS096;    Kreisfreie Städte Unterfranken;23 bis unter 24;4299;2009;2290
KS096;    Kreisfreie Städte Unterfranken;24 bis unter 25;4488;2102;2386
KS096;    Kreisfreie Städte Unterfranken;25 bis unter 26;4618;2286;2332
KS096;    Kreisfreie Städte Unterfranken;26 bis unter 27;4607;2313;2294
KS096;    Kreisfreie Städte Unterfranken;27 bis unter 28;4579;2352;2227
KS096;    Kreisfreie Städte Unterfranken;28 bis unter 29;4681;2457;2224
KS096;    Kreisfreie Städte Unterfranken;29 bis unter 30;4515;2364;2151
KS096;    Kreisfreie Städte Unterfranken;30 bis unter 31;4531;2450;2081
KS096;    Kreisfreie Städte Unterfranken;31 bis unter 32;4140;2246;1894
KS096;    Kreisfreie Städte Unterfranken;32 bis unter 33;3983;2210;1773
KS096;    Kreisfreie Städte Unterfranken;33 bis unter 34;3563;1930;1633
KS096;    Kreisfreie Städte Unterfranken;34 bis unter 35;3481;1869;1612
KS096;    Kreisfreie Städte Unterfranken;35 bis unter 36;3492;1825;1667
KS096;    Kreisfreie Städte Unterfranken;36 bis unter 37;3433;1786;1647
KS096;    Kreisfreie Städte Unterfranken;37 bis unter 38;3295;1636;1659
KS096;    Kreisfreie Städte Unterfranken;38 bis unter 39;2980;1561;1419
KS096;    Kreisfreie Städte Unterfranken;39 bis unter 40;2859;1501;1358
KS096;    Kreisfreie Städte Unterfranken;40 bis unter 41;2846;1437;1409
KS096;    Kreisfreie Städte Unterfranken;41 bis unter 42;2788;1426;1362
KS096;    Kreisfreie Städte Unterfranken;42 bis unter 43;2684;1317;1367
KS096;    Kreisfreie Städte Unterfranken;43 bis unter 44;2664;1317;1347
KS096;    Kreisfreie Städte Unterfranken;44 bis unter 45;2685;1375;1310
KS096;    Kreisfreie Städte Unterfranken;45 bis unter 46;2591;1266;1325
KS096;    Kreisfreie Städte Unterfranken;46 bis unter 47;2831;1412;1419
KS096;    Kreisfreie Städte Unterfranken;47 bis unter 48;2912;1490;1422
KS096;    Kreisfreie Städte Unterfranken;48 bis unter 49;2943;1495;1448
KS096;    Kreisfreie Städte Unterfranken;49 bis unter 50;3160;1576;1584
KS096;    Kreisfreie Städte Unterfranken;50 bis unter 51;3383;1712;1671
KS096;    Kreisfreie Städte Unterfranken;51 bis unter 52;3616;1791;1825
KS096;    Kreisfreie Städte Unterfranken;52 bis unter 53;3608;1781;1827
KS096;    Kreisfreie Städte Unterfranken;53 bis unter 54;3629;1834;1795
KS096;    Kreisfreie Städte Unterfranken;54 bis unter 55;3654;1814;1840
KS096;    Kreisfreie Städte Unterfranken;55 bis unter 56;3671;1779;1892
KS096;    Kreisfreie Städte Unterfranken;56 bis unter 57;3554;1777;1777
KS096;    Kreisfreie Städte Unterfranken;57 bis unter 58;3546;1730;1816
KS096;    Kreisfreie Städte Unterfranken;58 bis unter 59;3360;1655;1705
KS096;    Kreisfreie Städte Unterfranken;59 bis unter 60;3303;1578;1725
KS096;    Kreisfreie Städte Unterfranken;60 bis unter 61;3159;1504;1655
KS096;    Kreisfreie Städte Unterfranken;61 bis unter 62;3081;1428;1653
KS096;    Kreisfreie Städte Unterfranken;62 bis unter 63;3101;1427;1674
KS096;    Kreisfreie Städte Unterfranken;63 bis unter 64;2887;1353;1534
KS096;    Kreisfreie Städte Unterfranken;64 bis unter 65;2890;1311;1579
KS096;    Kreisfreie Städte Unterfranken;65 bis unter 66;2769;1261;1508
KS096;    Kreisfreie Städte Unterfranken;66 bis unter 67;2766;1268;1498
KS096;    Kreisfreie Städte Unterfranken;67 bis unter 68;2577;1143;1434
KS096;    Kreisfreie Städte Unterfranken;68 bis unter 69;2704;1197;1507
KS096;    Kreisfreie Städte Unterfranken;69 bis unter 70;2557;1183;1374
KS096;    Kreisfreie Städte Unterfranken;70 bis unter 71;2316;1036;1280
KS096;    Kreisfreie Städte Unterfranken;71 bis unter 72;2268;1005;1263
KS096;    Kreisfreie Städte Unterfranken;72 bis unter 73;1914;876;1038
KS096;    Kreisfreie Städte Unterfranken;73 bis unter 74;1598;681;917
KS096;    Kreisfreie Städte Unterfranken;74 bis unter 75;2169;954;1215
KS096;    Kreisfreie Städte Unterfranken;75 bis unter 76;2148;952;1196
KS096;    Kreisfreie Städte Unterfranken;76 bis unter 77;2053;897;1156
KS096;    Kreisfreie Städte Unterfranken;77 bis unter 78;2567;1095;1472
KS096;    Kreisfreie Städte Unterfranken;78 bis unter 79;2638;1100;1538
KS096;    Kreisfreie Städte Unterfranken;79 bis unter 80;2431;1010;1421
KS096;    Kreisfreie Städte Unterfranken;80 bis unter 81;2280;906;1374
KS096;    Kreisfreie Städte Unterfranken;81 bis unter 82;2024;842;1182
KS096;    Kreisfreie Städte Unterfranken;82 bis unter 83;1935;771;1164
KS096;    Kreisfreie Städte Unterfranken;83 bis unter 84;1710;639;1071
KS096;    Kreisfreie Städte Unterfranken;84 bis unter 85;1516;587;929
KS096;    Kreisfreie Städte Unterfranken;85 bis unter 90;4794;1645;3149
KS096;    Kreisfreie Städte Unterfranken;90 bis unter 95;2427;621;1806
KS096;    Kreisfreie Städte Unterfranken;95 oder älter;701;107;594
KS096;    Kreisfreie Städte Unterfranken;Insgesamt;252439;122020;130419
09671;      Aschaffenburg (Lkr);unter 1;1552;802;750
09671;      Aschaffenburg (Lkr);1 bis unter 2;1645;842;803
09671;      Aschaffenburg (Lkr);2 bis unter 3;1576;827;749
09671;      Aschaffenburg (Lkr);3 bis unter 4;1538;799;739
09671;      Aschaffenburg (Lkr);4 bis unter 5;1557;788;769
09671;      Aschaffenburg (Lkr);5 bis unter 6;1494;790;704
09671;      Aschaffenburg (Lkr);6 bis unter 7;1491;791;700
09671;      Aschaffenburg (Lkr);7 bis unter 8;1483;749;734
09671;      Aschaffenburg (Lkr);8 bis unter 9;1440;742;698
09671;      Aschaffenburg (Lkr);9 bis unter 10;1483;760;723
09671;      Aschaffenburg (Lkr);10 bis unter 11;1618;825;793
09671;      Aschaffenburg (Lkr);11 bis unter 12;1530;752;778
09671;      Aschaffenburg (Lkr);12 bis unter 13;1522;770;752
09671;      Aschaffenburg (Lkr);13 bis unter 14;1544;796;748
09671;      Aschaffenburg (Lkr);14 bis unter 15;1690;874;816
09671;      Aschaffenburg (Lkr);15 bis unter 16;1642;845;797
09671;      Aschaffenburg (Lkr);16 bis unter 17;1679;843;836
09671;      Aschaffenburg (Lkr);17 bis unter 18;1734;866;868
09671;      Aschaffenburg (Lkr);18 bis unter 19;1812;949;863
09671;      Aschaffenburg (Lkr);19 bis unter 20;1773;912;861
09671;      Aschaffenburg (Lkr);20 bis unter 21;1799;987;812
09671;      Aschaffenburg (Lkr);21 bis unter 22;1817;1009;808
09671;      Aschaffenburg (Lkr);22 bis unter 23;1803;1016;787
09671;      Aschaffenburg (Lkr);23 bis unter 24;1751;943;808
09671;      Aschaffenburg (Lkr);24 bis unter 25;1795;956;839
09671;      Aschaffenburg (Lkr);25 bis unter 26;1856;989;867
09671;      Aschaffenburg (Lkr);26 bis unter 27;1938;1012;926
09671;      Aschaffenburg (Lkr);27 bis unter 28;1833;949;884
09671;      Aschaffenburg (Lkr);28 bis unter 29;2053;1051;1002
09671;      Aschaffenburg (Lkr);29 bis unter 30;1943;1012;931
09671;      Aschaffenburg (Lkr);30 bis unter 31;2067;1022;1045
09671;      Aschaffenburg (Lkr);31 bis unter 32;1968;1049;919
09671;      Aschaffenburg (Lkr);32 bis unter 33;2014;1046;968
09671;      Aschaffenburg (Lkr);33 bis unter 34;1996;1001;995
09671;      Aschaffenburg (Lkr);34 bis unter 35;1997;1037;960
09671;      Aschaffenburg (Lkr);35 bis unter 36;2141;1098;1043
09671;      Aschaffenburg (Lkr);36 bis unter 37;2133;1078;1055
09671;      Aschaffenburg (Lkr);37 bis unter 38;2106;1033;1073
09671;      Aschaffenburg (Lkr);38 bis unter 39;2062;1021;1041
09671;      Aschaffenburg (Lkr);39 bis unter 40;1999;1018;981
09671;      Aschaffenburg (Lkr);40 bis unter 41;2025;999;1026
09671;      Aschaffenburg (Lkr);41 bis unter 42;2028;1021;1007
09671;      Aschaffenburg (Lkr);42 bis unter 43;1997;992;1005
09671;      Aschaffenburg (Lkr);43 bis unter 44;1886;894;992
09671;      Aschaffenburg (Lkr);44 bis unter 45;1975;957;1018
09671;      Aschaffenburg (Lkr);45 bis unter 46;1997;951;1046
09671;      Aschaffenburg (Lkr);46 bis unter 47;2213;1062;1151
09671;      Aschaffenburg (Lkr);47 bis unter 48;2499;1227;1272
09671;      Aschaffenburg (Lkr);48 bis unter 49;2617;1299;1318
09671;      Aschaffenburg (Lkr);49 bis unter 50;2892;1433;1459
09671;      Aschaffenburg (Lkr);50 bis unter 51;2985;1463;1522
09671;      Aschaffenburg (Lkr);51 bis unter 52;3154;1593;1561
09671;      Aschaffenburg (Lkr);52 bis unter 53;3255;1612;1643
09671;      Aschaffenburg (Lkr);53 bis unter 54;3267;1682;1585
09671;      Aschaffenburg (Lkr);54 bis unter 55;3229;1615;1614
09671;      Aschaffenburg (Lkr);55 bis unter 56;3335;1675;1660
09671;      Aschaffenburg (Lkr);56 bis unter 57;3210;1553;1657
09671;      Aschaffenburg (Lkr);57 bis unter 58;3091;1542;1549
09671;      Aschaffenburg (Lkr);58 bis unter 59;2966;1464;1502
09671;      Aschaffenburg (Lkr);59 bis unter 60;2901;1472;1429
09671;      Aschaffenburg (Lkr);60 bis unter 61;2739;1432;1307
09671;      Aschaffenburg (Lkr);61 bis unter 62;2506;1268;1238
09671;      Aschaffenburg (Lkr);62 bis unter 63;2511;1241;1270
09671;      Aschaffenburg (Lkr);63 bis unter 64;2350;1193;1157
09671;      Aschaffenburg (Lkr);64 bis unter 65;2325;1162;1163
09671;      Aschaffenburg (Lkr);65 bis unter 66;2240;1104;1136
09671;      Aschaffenburg (Lkr);66 bis unter 67;2151;1043;1108
09671;      Aschaffenburg (Lkr);67 bis unter 68;2049;994;1055
09671;      Aschaffenburg (Lkr);68 bis unter 69;2053;1029;1024
09671;      Aschaffenburg (Lkr);69 bis unter 70;2023;959;1064
09671;      Aschaffenburg (Lkr);70 bis unter 71;1871;957;914
09671;      Aschaffenburg (Lkr);71 bis unter 72;1692;837;855
09671;      Aschaffenburg (Lkr);72 bis unter 73;1472;730;742
09671;      Aschaffenburg (Lkr);73 bis unter 74;1115;511;604
09671;      Aschaffenburg (Lkr);74 bis unter 75;1545;732;813
09671;      Aschaffenburg (Lkr);75 bis unter 76;1481;711;770
09671;      Aschaffenburg (Lkr);76 bis unter 77;1373;688;685
09671;      Aschaffenburg (Lkr);77 bis unter 78;1597;734;863
09671;      Aschaffenburg (Lkr);78 bis unter 79;1786;814;972
09671;      Aschaffenburg (Lkr);79 bis unter 80;1778;807;971
09671;      Aschaffenburg (Lkr);80 bis unter 81;1533;693;840
09671;      Aschaffenburg (Lkr);81 bis unter 82;1480;650;830
09671;      Aschaffenburg (Lkr);82 bis unter 83;1285;559;726
09671;      Aschaffenburg (Lkr);83 bis unter 84;1247;547;700
09671;      Aschaffenburg (Lkr);84 bis unter 85;1035;420;615
09671;      Aschaffenburg (Lkr);85 bis unter 90;3048;1137;1911
09671;      Aschaffenburg (Lkr);90 bis unter 95;1247;391;856
09671;      Aschaffenburg (Lkr);95 oder älter;280;72;208
09671;      Aschaffenburg (Lkr);Insgesamt;174208;86570;87638
09672;      Bad Kissingen (Lkr);unter 1;839;427;412
09672;      Bad Kissingen (Lkr);1 bis unter 2;918;482;436
09672;      Bad Kissingen (Lkr);2 bis unter 3;857;426;431
09672;      Bad Kissingen (Lkr);3 bis unter 4;874;449;425
09672;      Bad Kissingen (Lkr);4 bis unter 5;835;429;406
09672;      Bad Kissingen (Lkr);5 bis unter 6;864;452;412
09672;      Bad Kissingen (Lkr);6 bis unter 7;802;379;423
09672;      Bad Kissingen (Lkr);7 bis unter 8;829;411;418
09672;      Bad Kissingen (Lkr);8 bis unter 9;862;426;436
09672;      Bad Kissingen (Lkr);9 bis unter 10;823;413;410
09672;      Bad Kissingen (Lkr);10 bis unter 11;807;421;386
09672;      Bad Kissingen (Lkr);11 bis unter 12;863;427;436
09672;      Bad Kissingen (Lkr);12 bis unter 13;857;443;414
09672;      Bad Kissingen (Lkr);13 bis unter 14;913;430;483
09672;      Bad Kissingen (Lkr);14 bis unter 15;908;479;429
09672;      Bad Kissingen (Lkr);15 bis unter 16;973;481;492
09672;      Bad Kissingen (Lkr);16 bis unter 17;1000;491;509
09672;      Bad Kissingen (Lkr);17 bis unter 18;1000;532;468
09672;      Bad Kissingen (Lkr);18 bis unter 19;1033;531;502
09672;      Bad Kissingen (Lkr);19 bis unter 20;1066;563;503
09672;      Bad Kissingen (Lkr);20 bis unter 21;1059;549;510
09672;      Bad Kissingen (Lkr);21 bis unter 22;1037;521;516
09672;      Bad Kissingen (Lkr);22 bis unter 23;1066;573;493
09672;      Bad Kissingen (Lkr);23 bis unter 24;1005;538;467
09672;      Bad Kissingen (Lkr);24 bis unter 25;1015;541;474
09672;      Bad Kissingen (Lkr);25 bis unter 26;1062;563;499
09672;      Bad Kissingen (Lkr);26 bis unter 27;1065;565;500
09672;      Bad Kissingen (Lkr);27 bis unter 28;1042;551;491
09672;      Bad Kissingen (Lkr);28 bis unter 29;1136;622;514
09672;      Bad Kissingen (Lkr);29 bis unter 30;1141;555;586
09672;      Bad Kissingen (Lkr);30 bis unter 31;1200;648;552
09672;      Bad Kissingen (Lkr);31 bis unter 32;1153;599;554
09672;      Bad Kissingen (Lkr);32 bis unter 33;1126;606;520
09672;      Bad Kissingen (Lkr);33 bis unter 34;1036;519;517
09672;      Bad Kissingen (Lkr);34 bis unter 35;1068;552;516
09672;      Bad Kissingen (Lkr);35 bis unter 36;1183;600;583
09672;      Bad Kissingen (Lkr);36 bis unter 37;1157;594;563
09672;      Bad Kissingen (Lkr);37 bis unter 38;1150;636;514
09672;      Bad Kissingen (Lkr);38 bis unter 39;1169;584;585
09672;      Bad Kissingen (Lkr);39 bis unter 40;1064;526;538
09672;      Bad Kissingen (Lkr);40 bis unter 41;1098;509;589
09672;      Bad Kissingen (Lkr);41 bis unter 42;1097;580;517
09672;      Bad Kissingen (Lkr);42 bis unter 43;1130;548;582
09672;      Bad Kissingen (Lkr);43 bis unter 44;1080;559;521
09672;      Bad Kissingen (Lkr);44 bis unter 45;1116;544;572
09672;      Bad Kissingen (Lkr);45 bis unter 46;1158;562;596
09672;      Bad Kissingen (Lkr);46 bis unter 47;1293;653;640
09672;      Bad Kissingen (Lkr);47 bis unter 48;1384;682;702
09672;      Bad Kissingen (Lkr);48 bis unter 49;1417;766;651
09672;      Bad Kissingen (Lkr);49 bis unter 50;1580;758;822
09672;      Bad Kissingen (Lkr);50 bis unter 51;1647;814;833
09672;      Bad Kissingen (Lkr);51 bis unter 52;1732;856;876
09672;      Bad Kissingen (Lkr);52 bis unter 53;1779;913;866
09672;      Bad Kissingen (Lkr);53 bis unter 54;1829;935;894
09672;      Bad Kissingen (Lkr);54 bis unter 55;1876;973;903
09672;      Bad Kissingen (Lkr);55 bis unter 56;1844;915;929
09672;      Bad Kissingen (Lkr);56 bis unter 57;1799;907;892
09672;      Bad Kissingen (Lkr);57 bis unter 58;1875;929;946
09672;      Bad Kissingen (Lkr);58 bis unter 59;1874;919;955
09672;      Bad Kissingen (Lkr);59 bis unter 60;1697;849;848
09672;      Bad Kissingen (Lkr);60 bis unter 61;1672;832;840
09672;      Bad Kissingen (Lkr);61 bis unter 62;1591;787;804
09672;      Bad Kissingen (Lkr);62 bis unter 63;1586;792;794
09672;      Bad Kissingen (Lkr);63 bis unter 64;1522;752;770
09672;      Bad Kissingen (Lkr);64 bis unter 65;1493;758;735
09672;      Bad Kissingen (Lkr);65 bis unter 66;1462;721;741
09672;      Bad Kissingen (Lkr);66 bis unter 67;1420;696;724
09672;      Bad Kissingen (Lkr);67 bis unter 68;1386;667;719
09672;      Bad Kissingen (Lkr);68 bis unter 69;1377;682;695
09672;      Bad Kissingen (Lkr);69 bis unter 70;1305;636;669
09672;      Bad Kissingen (Lkr);70 bis unter 71;1260;625;635
09672;      Bad Kissingen (Lkr);71 bis unter 72;1075;539;536
09672;      Bad Kissingen (Lkr);72 bis unter 73;930;444;486
09672;      Bad Kissingen (Lkr);73 bis unter 74;662;302;360
09672;      Bad Kissingen (Lkr);74 bis unter 75;921;460;461
09672;      Bad Kissingen (Lkr);75 bis unter 76;918;444;474
09672;      Bad Kissingen (Lkr);76 bis unter 77;860;383;477
09672;      Bad Kissingen (Lkr);77 bis unter 78;1136;491;645
09672;      Bad Kissingen (Lkr);78 bis unter 79;1295;577;718
09672;      Bad Kissingen (Lkr);79 bis unter 80;1237;537;700
09672;      Bad Kissingen (Lkr);80 bis unter 81;1141;518;623
09672;      Bad Kissingen (Lkr);81 bis unter 82;1005;431;574
09672;      Bad Kissingen (Lkr);82 bis unter 83;914;351;563
09672;      Bad Kissingen (Lkr);83 bis unter 84;773;316;457
09672;      Bad Kissingen (Lkr);84 bis unter 85;703;294;409
09672;      Bad Kissingen (Lkr);85 bis unter 90;2145;752;1393
09672;      Bad Kissingen (Lkr);90 bis unter 95;989;317;672
09672;      Bad Kissingen (Lkr);95 oder älter;278;56;222
09672;      Bad Kissingen (Lkr);Insgesamt;103218;50865;52353
09673;      Rhön-Grabfeld (Lkr);unter 1;631;314;317
09673;      Rhön-Grabfeld (Lkr);1 bis unter 2;756;388;368
09673;      Rhön-Grabfeld (Lkr);2 bis unter 3;754;388;366
09673;      Rhön-Grabfeld (Lkr);3 bis unter 4;735;364;371
09673;      Rhön-Grabfeld (Lkr);4 bis unter 5;677;370;307
09673;      Rhön-Grabfeld (Lkr);5 bis unter 6;684;340;344
09673;      Rhön-Grabfeld (Lkr);6 bis unter 7;686;329;357
09673;      Rhön-Grabfeld (Lkr);7 bis unter 8;657;338;319
09673;      Rhön-Grabfeld (Lkr);8 bis unter 9;703;366;337
09673;      Rhön-Grabfeld (Lkr);9 bis unter 10;664;361;303
09673;      Rhön-Grabfeld (Lkr);10 bis unter 11;687;349;338
09673;      Rhön-Grabfeld (Lkr);11 bis unter 12;729;365;364
09673;      Rhön-Grabfeld (Lkr);12 bis unter 13;738;358;380
09673;      Rhön-Grabfeld (Lkr);13 bis unter 14;733;397;336
09673;      Rhön-Grabfeld (Lkr);14 bis unter 15;765;384;381
09673;      Rhön-Grabfeld (Lkr);15 bis unter 16;839;398;441
09673;      Rhön-Grabfeld (Lkr);16 bis unter 17;782;399;383
09673;      Rhön-Grabfeld (Lkr);17 bis unter 18;860;456;404
09673;      Rhön-Grabfeld (Lkr);18 bis unter 19;844;460;384
09673;      Rhön-Grabfeld (Lkr);19 bis unter 20;820;448;372
09673;      Rhön-Grabfeld (Lkr);20 bis unter 21;852;467;385
09673;      Rhön-Grabfeld (Lkr);21 bis unter 22;872;472;400
09673;      Rhön-Grabfeld (Lkr);22 bis unter 23;868;492;376
09673;      Rhön-Grabfeld (Lkr);23 bis unter 24;812;430;382
09673;      Rhön-Grabfeld (Lkr);24 bis unter 25;859;447;412
09673;      Rhön-Grabfeld (Lkr);25 bis unter 26;887;473;414
09673;      Rhön-Grabfeld (Lkr);26 bis unter 27;852;425;427
09673;      Rhön-Grabfeld (Lkr);27 bis unter 28;910;478;432
09673;      Rhön-Grabfeld (Lkr);28 bis unter 29;888;474;414
09673;      Rhön-Grabfeld (Lkr);29 bis unter 30;898;458;440
09673;      Rhön-Grabfeld (Lkr);30 bis unter 31;923;480;443
09673;      Rhön-Grabfeld (Lkr);31 bis unter 32;894;465;429
09673;      Rhön-Grabfeld (Lkr);32 bis unter 33;878;450;428
09673;      Rhön-Grabfeld (Lkr);33 bis unter 34;862;459;403
09673;      Rhön-Grabfeld (Lkr);34 bis unter 35;969;486;483
09673;      Rhön-Grabfeld (Lkr);35 bis unter 36;944;481;463
09673;      Rhön-Grabfeld (Lkr);36 bis unter 37;899;427;472
09673;      Rhön-Grabfeld (Lkr);37 bis unter 38;880;438;442
09673;      Rhön-Grabfeld (Lkr);38 bis unter 39;907;459;448
09673;      Rhön-Grabfeld (Lkr);39 bis unter 40;895;460;435
09673;      Rhön-Grabfeld (Lkr);40 bis unter 41;846;418;428
09673;      Rhön-Grabfeld (Lkr);41 bis unter 42;840;422;418
09673;      Rhön-Grabfeld (Lkr);42 bis unter 43;865;427;438
09673;      Rhön-Grabfeld (Lkr);43 bis unter 44;791;393;398
09673;      Rhön-Grabfeld (Lkr);44 bis unter 45;905;441;464
09673;      Rhön-Grabfeld (Lkr);45 bis unter 46;885;449;436
09673;      Rhön-Grabfeld (Lkr);46 bis unter 47;982;489;493
09673;      Rhön-Grabfeld (Lkr);47 bis unter 48;1134;534;600
09673;      Rhön-Grabfeld (Lkr);48 bis unter 49;1144;578;566
09673;      Rhön-Grabfeld (Lkr);49 bis unter 50;1233;608;625
09673;      Rhön-Grabfeld (Lkr);50 bis unter 51;1271;645;626
09673;      Rhön-Grabfeld (Lkr);51 bis unter 52;1308;631;677
09673;      Rhön-Grabfeld (Lkr);52 bis unter 53;1408;684;724
09673;      Rhön-Grabfeld (Lkr);53 bis unter 54;1398;733;665
09673;      Rhön-Grabfeld (Lkr);54 bis unter 55;1482;735;747
09673;      Rhön-Grabfeld (Lkr);55 bis unter 56;1417;704;713
09673;      Rhön-Grabfeld (Lkr);56 bis unter 57;1475;778;697
09673;      Rhön-Grabfeld (Lkr);57 bis unter 58;1425;727;698
09673;      Rhön-Grabfeld (Lkr);58 bis unter 59;1379;693;686
09673;      Rhön-Grabfeld (Lkr);59 bis unter 60;1343;659;684
09673;      Rhön-Grabfeld (Lkr);60 bis unter 61;1294;684;610
09673;      Rhön-Grabfeld (Lkr);61 bis unter 62;1215;615;600
09673;      Rhön-Grabfeld (Lkr);62 bis unter 63;1267;640;627
09673;      Rhön-Grabfeld (Lkr);63 bis unter 64;1111;582;529
09673;      Rhön-Grabfeld (Lkr);64 bis unter 65;1146;577;569
09673;      Rhön-Grabfeld (Lkr);65 bis unter 66;1126;574;552
09673;      Rhön-Grabfeld (Lkr);66 bis unter 67;1049;506;543
09673;      Rhön-Grabfeld (Lkr);67 bis unter 68;1002;495;507
09673;      Rhön-Grabfeld (Lkr);68 bis unter 69;1037;520;517
09673;      Rhön-Grabfeld (Lkr);69 bis unter 70;1021;531;490
09673;      Rhön-Grabfeld (Lkr);70 bis unter 71;817;411;406
09673;      Rhön-Grabfeld (Lkr);71 bis unter 72;784;412;372
09673;      Rhön-Grabfeld (Lkr);72 bis unter 73;658;321;337
09673;      Rhön-Grabfeld (Lkr);73 bis unter 74;448;218;230
09673;      Rhön-Grabfeld (Lkr);74 bis unter 75;537;246;291
09673;      Rhön-Grabfeld (Lkr);75 bis unter 76;605;300;305
09673;      Rhön-Grabfeld (Lkr);76 bis unter 77;578;254;324
09673;      Rhön-Grabfeld (Lkr);77 bis unter 78;759;353;406
09673;      Rhön-Grabfeld (Lkr);78 bis unter 79;832;387;445
09673;      Rhön-Grabfeld (Lkr);79 bis unter 80;890;385;505
09673;      Rhön-Grabfeld (Lkr);80 bis unter 81;810;348;462
09673;      Rhön-Grabfeld (Lkr);81 bis unter 82;701;314;387
09673;      Rhön-Grabfeld (Lkr);82 bis unter 83;650;293;357
09673;      Rhön-Grabfeld (Lkr);83 bis unter 84;545;216;329
09673;      Rhön-Grabfeld (Lkr);84 bis unter 85;444;177;267
09673;      Rhön-Grabfeld (Lkr);85 bis unter 90;1539;574;965
09673;      Rhön-Grabfeld (Lkr);90 bis unter 95;636;167;469
09673;      Rhön-Grabfeld (Lkr);95 oder älter;165;36;129
09673;      Rhön-Grabfeld (Lkr);Insgesamt;79690;39677;40013
09674;      Haßberge (Lkr);unter 1;768;378;390
09674;      Haßberge (Lkr);1 bis unter 2;806;431;375
09674;      Haßberge (Lkr);2 bis unter 3;793;407;386
09674;      Haßberge (Lkr);3 bis unter 4;773;393;380
09674;      Haßberge (Lkr);4 bis unter 5;793;412;381
09674;      Haßberge (Lkr);5 bis unter 6;728;376;352
09674;      Haßberge (Lkr);6 bis unter 7;745;383;362
09674;      Haßberge (Lkr);7 bis unter 8;702;350;352
09674;      Haßberge (Lkr);8 bis unter 9;771;375;396
09674;      Haßberge (Lkr);9 bis unter 10;698;345;353
09674;      Haßberge (Lkr);10 bis unter 11;717;373;344
09674;      Haßberge (Lkr);11 bis unter 12;724;396;328
09674;      Haßberge (Lkr);12 bis unter 13;762;402;360
09674;      Haßberge (Lkr);13 bis unter 14;766;408;358
09674;      Haßberge (Lkr);14 bis unter 15;781;428;353
09674;      Haßberge (Lkr);15 bis unter 16;827;431;396
09674;      Haßberge (Lkr);16 bis unter 17;856;433;423
09674;      Haßberge (Lkr);17 bis unter 18;870;447;423
09674;      Haßberge (Lkr);18 bis unter 19;938;468;470
09674;      Haßberge (Lkr);19 bis unter 20;937;495;442
09674;      Haßberge (Lkr);20 bis unter 21;955;532;423
09674;      Haßberge (Lkr);21 bis unter 22;911;480;431
09674;      Haßberge (Lkr);22 bis unter 23;898;498;400
09674;      Haßberge (Lkr);23 bis unter 24;876;445;431
09674;      Haßberge (Lkr);24 bis unter 25;878;478;400
09674;      Haßberge (Lkr);25 bis unter 26;908;512;396
09674;      Haßberge (Lkr);26 bis unter 27;949;513;436
09674;      Haßberge (Lkr);27 bis unter 28;959;526;433
09674;      Haßberge (Lkr);28 bis unter 29;985;512;473
09674;      Haßberge (Lkr);29 bis unter 30;978;497;481
09674;      Haßberge (Lkr);30 bis unter 31;980;525;455
09674;      Haßberge (Lkr);31 bis unter 32;1003;500;503
09674;      Haßberge (Lkr);32 bis unter 33;995;500;495
09674;      Haßberge (Lkr);33 bis unter 34;972;499;473
09674;      Haßberge (Lkr);34 bis unter 35;979;517;462
09674;      Haßberge (Lkr);35 bis unter 36;1028;514;514
09674;      Haßberge (Lkr);36 bis unter 37;1094;551;543
09674;      Haßberge (Lkr);37 bis unter 38;1037;521;516
09674;      Haßberge (Lkr);38 bis unter 39;1033;544;489
09674;      Haßberge (Lkr);39 bis unter 40;898;477;421
09674;      Haßberge (Lkr);40 bis unter 41;932;477;455
09674;      Haßberge (Lkr);41 bis unter 42;948;465;483
09674;      Haßberge (Lkr);42 bis unter 43;891;451;440
09674;      Haßberge (Lkr);43 bis unter 44;951;490;461
09674;      Haßberge (Lkr);44 bis unter 45;935;477;458
09674;      Haßberge (Lkr);45 bis unter 46;1014;498;516
09674;      Haßberge (Lkr);46 bis unter 47;1071;547;524
09674;      Haßberge (Lkr);47 bis unter 48;1149;558;591
09674;      Haßberge (Lkr);48 bis unter 49;1195;623;572
09674;      Haßberge (Lkr);49 bis unter 50;1350;658;692
09674;      Haßberge (Lkr);50 bis unter 51;1350;698;652
09674;      Haßberge (Lkr);51 bis unter 52;1472;753;719
09674;      Haßberge (Lkr);52 bis unter 53;1506;765;741
09674;      Haßberge (Lkr);53 bis unter 54;1492;751;741
09674;      Haßberge (Lkr);54 bis unter 55;1588;789;799
09674;      Haßberge (Lkr);55 bis unter 56;1540;764;776
09674;      Haßberge (Lkr);56 bis unter 57;1529;792;737
09674;      Haßberge (Lkr);57 bis unter 58;1638;810;828
09674;      Haßberge (Lkr);58 bis unter 59;1596;822;774
09674;      Haßberge (Lkr);59 bis unter 60;1398;692;706
09674;      Haßberge (Lkr);60 bis unter 61;1341;671;670
09674;      Haßberge (Lkr);61 bis unter 62;1383;682;701
09674;      Haßberge (Lkr);62 bis unter 63;1313;688;625
09674;      Haßberge (Lkr);63 bis unter 64;1199;628;571
09674;      Haßberge (Lkr);64 bis unter 65;1197;595;602
09674;      Haßberge (Lkr);65 bis unter 66;1121;563;558
09674;      Haßberge (Lkr);66 bis unter 67;1095;542;553
09674;      Haßberge (Lkr);67 bis unter 68;1068;536;532
09674;      Haßberge (Lkr);68 bis unter 69;1040;528;512
09674;      Haßberge (Lkr);69 bis unter 70;1011;514;497
09674;      Haßberge (Lkr);70 bis unter 71;874;462;412
09674;      Haßberge (Lkr);71 bis unter 72;818;430;388
09674;      Haßberge (Lkr);72 bis unter 73;667;333;334
09674;      Haßberge (Lkr);73 bis unter 74;486;239;247
09674;      Haßberge (Lkr);74 bis unter 75;628;316;312
09674;      Haßberge (Lkr);75 bis unter 76;583;277;306
09674;      Haßberge (Lkr);76 bis unter 77;582;293;289
09674;      Haßberge (Lkr);77 bis unter 78;777;348;429
09674;      Haßberge (Lkr);78 bis unter 79;881;374;507
09674;      Haßberge (Lkr);79 bis unter 80;840;378;462
09674;      Haßberge (Lkr);80 bis unter 81;754;304;450
09674;      Haßberge (Lkr);81 bis unter 82;655;274;381
09674;      Haßberge (Lkr);82 bis unter 83;593;286;307
09674;      Haßberge (Lkr);83 bis unter 84;521;212;309
09674;      Haßberge (Lkr);84 bis unter 85;466;184;282
09674;      Haßberge (Lkr);85 bis unter 90;1427;492;935
09674;      Haßberge (Lkr);90 bis unter 95;531;144;387
09674;      Haßberge (Lkr);95 oder älter;132;23;109
09674;      Haßberge (Lkr);Insgesamt;84599;42468;42131
09675;      Kitzingen (Lkr);unter 1;850;446;404
09675;      Kitzingen (Lkr);1 bis unter 2;854;459;395
09675;      Kitzingen (Lkr);2 bis unter 3;879;456;423
09675;      Kitzingen (Lkr);3 bis unter 4;867;446;421
09675;      Kitzingen (Lkr);4 bis unter 5;781;424;357
09675;      Kitzingen (Lkr);5 bis unter 6;819;424;395
09675;      Kitzingen (Lkr);6 bis unter 7;811;430;381
09675;      Kitzingen (Lkr);7 bis unter 8;756;372;384
09675;      Kitzingen (Lkr);8 bis unter 9;733;386;347
09675;      Kitzingen (Lkr);9 bis unter 10;770;400;370
09675;      Kitzingen (Lkr);10 bis unter 11;796;398;398
09675;      Kitzingen (Lkr);11 bis unter 12;784;377;407
09675;      Kitzingen (Lkr);12 bis unter 13;780;393;387
09675;      Kitzingen (Lkr);13 bis unter 14;795;406;389
09675;      Kitzingen (Lkr);14 bis unter 15;830;410;420
09675;      Kitzingen (Lkr);15 bis unter 16;911;462;449
09675;      Kitzingen (Lkr);16 bis unter 17;882;447;435
09675;      Kitzingen (Lkr);17 bis unter 18;930;492;438
09675;      Kitzingen (Lkr);18 bis unter 19;970;518;452
09675;      Kitzingen (Lkr);19 bis unter 20;960;506;454
09675;      Kitzingen (Lkr);20 bis unter 21;973;532;441
09675;      Kitzingen (Lkr);21 bis unter 22;1053;592;461
09675;      Kitzingen (Lkr);22 bis unter 23;990;539;451
09675;      Kitzingen (Lkr);23 bis unter 24;1032;570;462
09675;      Kitzingen (Lkr);24 bis unter 25;1032;561;471
09675;      Kitzingen (Lkr);25 bis unter 26;1106;606;500
09675;      Kitzingen (Lkr);26 bis unter 27;1020;563;457
09675;      Kitzingen (Lkr);27 bis unter 28;1140;599;541
09675;      Kitzingen (Lkr);28 bis unter 29;1181;601;580
09675;      Kitzingen (Lkr);29 bis unter 30;1098;594;504
09675;      Kitzingen (Lkr);30 bis unter 31;1135;613;522
09675;      Kitzingen (Lkr);31 bis unter 32;1147;593;554
09675;      Kitzingen (Lkr);32 bis unter 33;1170;602;568
09675;      Kitzingen (Lkr);33 bis unter 34;1063;558;505
09675;      Kitzingen (Lkr);34 bis unter 35;1077;554;523
09675;      Kitzingen (Lkr);35 bis unter 36;1094;574;520
09675;      Kitzingen (Lkr);36 bis unter 37;1153;614;539
09675;      Kitzingen (Lkr);37 bis unter 38;1178;585;593
09675;      Kitzingen (Lkr);38 bis unter 39;1114;579;535
09675;      Kitzingen (Lkr);39 bis unter 40;1110;554;556
09675;      Kitzingen (Lkr);40 bis unter 41;1066;531;535
09675;      Kitzingen (Lkr);41 bis unter 42;1088;561;527
09675;      Kitzingen (Lkr);42 bis unter 43;1040;512;528
09675;      Kitzingen (Lkr);43 bis unter 44;1052;497;555
09675;      Kitzingen (Lkr);44 bis unter 45;1007;484;523
09675;      Kitzingen (Lkr);45 bis unter 46;1047;521;526
09675;      Kitzingen (Lkr);46 bis unter 47;1198;615;583
09675;      Kitzingen (Lkr);47 bis unter 48;1259;645;614
09675;      Kitzingen (Lkr);48 bis unter 49;1320;662;658
09675;      Kitzingen (Lkr);49 bis unter 50;1432;758;674
09675;      Kitzingen (Lkr);50 bis unter 51;1480;771;709
09675;      Kitzingen (Lkr);51 bis unter 52;1641;794;847
09675;      Kitzingen (Lkr);52 bis unter 53;1555;792;763
09675;      Kitzingen (Lkr);53 bis unter 54;1623;850;773
09675;      Kitzingen (Lkr);54 bis unter 55;1619;833;786
09675;      Kitzingen (Lkr);55 bis unter 56;1583;798;785
09675;      Kitzingen (Lkr);56 bis unter 57;1684;857;827
09675;      Kitzingen (Lkr);57 bis unter 58;1584;795;789
09675;      Kitzingen (Lkr);58 bis unter 59;1461;714;747
09675;      Kitzingen (Lkr);59 bis unter 60;1452;736;716
09675;      Kitzingen (Lkr);60 bis unter 61;1407;701;706
09675;      Kitzingen (Lkr);61 bis unter 62;1325;673;652
09675;      Kitzingen (Lkr);62 bis unter 63;1212;596;616
09675;      Kitzingen (Lkr);63 bis unter 64;1212;599;613
09675;      Kitzingen (Lkr);64 bis unter 65;1179;611;568
09675;      Kitzingen (Lkr);65 bis unter 66;1133;575;558
09675;      Kitzingen (Lkr);66 bis unter 67;1122;604;518
09675;      Kitzingen (Lkr);67 bis unter 68;1077;545;532
09675;      Kitzingen (Lkr);68 bis unter 69;1044;539;505
09675;      Kitzingen (Lkr);69 bis unter 70;1044;518;526
09675;      Kitzingen (Lkr);70 bis unter 71;978;502;476
09675;      Kitzingen (Lkr);71 bis unter 72;916;470;446
09675;      Kitzingen (Lkr);72 bis unter 73;763;384;379
09675;      Kitzingen (Lkr);73 bis unter 74;478;231;247
09675;      Kitzingen (Lkr);74 bis unter 75;659;320;339
09675;      Kitzingen (Lkr);75 bis unter 76;642;323;319
09675;      Kitzingen (Lkr);76 bis unter 77;622;292;330
09675;      Kitzingen (Lkr);77 bis unter 78;766;367;399
09675;      Kitzingen (Lkr);78 bis unter 79;904;387;517
09675;      Kitzingen (Lkr);79 bis unter 80;912;404;508
09675;      Kitzingen (Lkr);80 bis unter 81;853;367;486
09675;      Kitzingen (Lkr);81 bis unter 82;703;306;397
09675;      Kitzingen (Lkr);82 bis unter 83;592;234;358
09675;      Kitzingen (Lkr);83 bis unter 84;578;235;343
09675;      Kitzingen (Lkr);84 bis unter 85;511;213;298
09675;      Kitzingen (Lkr);85 bis unter 90;1656;611;1045
09675;      Kitzingen (Lkr);90 bis unter 95;652;191;461
09675;      Kitzingen (Lkr);95 oder älter;154;32;122
09675;      Kitzingen (Lkr);Insgesamt;90909;45791;45118
09676;      Miltenberg (Lkr);unter 1;1148;618;530
09676;      Miltenberg (Lkr);1 bis unter 2;1175;585;590
09676;      Miltenberg (Lkr);2 bis unter 3;1179;612;567
09676;      Miltenberg (Lkr);3 bis unter 4;1171;606;565
09676;      Miltenberg (Lkr);4 bis unter 5;1127;588;539
09676;      Miltenberg (Lkr);5 bis unter 6;1151;573;578
09676;      Miltenberg (Lkr);6 bis unter 7;1150;588;562
09676;      Miltenberg (Lkr);7 bis unter 8;1134;585;549
09676;      Miltenberg (Lkr);8 bis unter 9;1067;519;548
09676;      Miltenberg (Lkr);9 bis unter 10;1124;570;554
09676;      Miltenberg (Lkr);10 bis unter 11;1108;585;523
09676;      Miltenberg (Lkr);11 bis unter 12;1155;593;562
09676;      Miltenberg (Lkr);12 bis unter 13;1154;622;532
09676;      Miltenberg (Lkr);13 bis unter 14;1162;590;572
09676;      Miltenberg (Lkr);14 bis unter 15;1207;622;585
09676;      Miltenberg (Lkr);15 bis unter 16;1277;650;627
09676;      Miltenberg (Lkr);16 bis unter 17;1288;668;620
09676;      Miltenberg (Lkr);17 bis unter 18;1349;693;656
09676;      Miltenberg (Lkr);18 bis unter 19;1450;774;676
09676;      Miltenberg (Lkr);19 bis unter 20;1392;747;645
09676;      Miltenberg (Lkr);20 bis unter 21;1377;746;631
09676;      Miltenberg (Lkr);21 bis unter 22;1449;787;662
09676;      Miltenberg (Lkr);22 bis unter 23;1371;727;644
09676;      Miltenberg (Lkr);23 bis unter 24;1431;785;646
09676;      Miltenberg (Lkr);24 bis unter 25;1369;732;637
09676;      Miltenberg (Lkr);25 bis unter 26;1449;814;635
09676;      Miltenberg (Lkr);26 bis unter 27;1398;705;693
09676;      Miltenberg (Lkr);27 bis unter 28;1390;722;668
09676;      Miltenberg (Lkr);28 bis unter 29;1511;802;709
09676;      Miltenberg (Lkr);29 bis unter 30;1408;722;686
09676;      Miltenberg (Lkr);30 bis unter 31;1553;842;711
09676;      Miltenberg (Lkr);31 bis unter 32;1452;752;700
09676;      Miltenberg (Lkr);32 bis unter 33;1423;728;695
09676;      Miltenberg (Lkr);33 bis unter 34;1408;685;723
09676;      Miltenberg (Lkr);34 bis unter 35;1409;734;675
09676;      Miltenberg (Lkr);35 bis unter 36;1443;713;730
09676;      Miltenberg (Lkr);36 bis unter 37;1564;798;766
09676;      Miltenberg (Lkr);37 bis unter 38;1620;809;811
09676;      Miltenberg (Lkr);38 bis unter 39;1592;795;797
09676;      Miltenberg (Lkr);39 bis unter 40;1432;712;720
09676;      Miltenberg (Lkr);40 bis unter 41;1489;721;768
09676;      Miltenberg (Lkr);41 bis unter 42;1516;736;780
09676;      Miltenberg (Lkr);42 bis unter 43;1525;754;771
09676;      Miltenberg (Lkr);43 bis unter 44;1451;733;718
09676;      Miltenberg (Lkr);44 bis unter 45;1598;780;818
09676;      Miltenberg (Lkr);45 bis unter 46;1552;754;798
09676;      Miltenberg (Lkr);46 bis unter 47;1704;829;875
09676;      Miltenberg (Lkr);47 bis unter 48;1895;930;965
09676;      Miltenberg (Lkr);48 bis unter 49;1961;1007;954
09676;      Miltenberg (Lkr);49 bis unter 50;2178;1086;1092
09676;      Miltenberg (Lkr);50 bis unter 51;2179;1070;1109
09676;      Miltenberg (Lkr);51 bis unter 52;2316;1157;1159
09676;      Miltenberg (Lkr);52 bis unter 53;2436;1280;1156
09676;      Miltenberg (Lkr);53 bis unter 54;2193;1126;1067
09676;      Miltenberg (Lkr);54 bis unter 55;2307;1218;1089
09676;      Miltenberg (Lkr);55 bis unter 56;2331;1140;1191
09676;      Miltenberg (Lkr);56 bis unter 57;2326;1219;1107
09676;      Miltenberg (Lkr);57 bis unter 58;2171;1023;1148
09676;      Miltenberg (Lkr);58 bis unter 59;2159;1107;1052
09676;      Miltenberg (Lkr);59 bis unter 60;2063;1043;1020
09676;      Miltenberg (Lkr);60 bis unter 61;1927;981;946
09676;      Miltenberg (Lkr);61 bis unter 62;1855;920;935
09676;      Miltenberg (Lkr);62 bis unter 63;1825;902;923
09676;      Miltenberg (Lkr);63 bis unter 64;1716;871;845
09676;      Miltenberg (Lkr);64 bis unter 65;1668;823;845
09676;      Miltenberg (Lkr);65 bis unter 66;1643;826;817
09676;      Miltenberg (Lkr);66 bis unter 67;1648;796;852
09676;      Miltenberg (Lkr);67 bis unter 68;1512;759;753
09676;      Miltenberg (Lkr);68 bis unter 69;1568;775;793
09676;      Miltenberg (Lkr);69 bis unter 70;1443;701;742
09676;      Miltenberg (Lkr);70 bis unter 71;1397;662;735
09676;      Miltenberg (Lkr);71 bis unter 72;1156;578;578
09676;      Miltenberg (Lkr);72 bis unter 73;982;477;505
09676;      Miltenberg (Lkr);73 bis unter 74;812;361;451
09676;      Miltenberg (Lkr);74 bis unter 75;1104;533;571
09676;      Miltenberg (Lkr);75 bis unter 76;1022;527;495
09676;      Miltenberg (Lkr);76 bis unter 77;997;484;513
09676;      Miltenberg (Lkr);77 bis unter 78;1238;557;681
09676;      Miltenberg (Lkr);78 bis unter 79;1374;623;751
09676;      Miltenberg (Lkr);79 bis unter 80;1379;592;787
09676;      Miltenberg (Lkr);80 bis unter 81;1141;518;623
09676;      Miltenberg (Lkr);81 bis unter 82;1045;483;562
09676;      Miltenberg (Lkr);82 bis unter 83;1022;438;584
09676;      Miltenberg (Lkr);83 bis unter 84;867;358;509
09676;      Miltenberg (Lkr);84 bis unter 85;703;269;434
09676;      Miltenberg (Lkr);85 bis unter 90;2246;856;1390
09676;      Miltenberg (Lkr);90 bis unter 95;894;256;638
09676;      Miltenberg (Lkr);95 oder älter;205;53;152
09676;      Miltenberg (Lkr);Insgesamt;128756;64190;64566
09677;      Main-Spessart (Lkr);unter 1;1061;543;518
09677;      Main-Spessart (Lkr);1 bis unter 2;1128;578;550
09677;      Main-Spessart (Lkr);2 bis unter 3;1161;588;573
09677;      Main-Spessart (Lkr);3 bis unter 4;1052;527;525
09677;      Main-Spessart (Lkr);4 bis unter 5;1047;528;519
09677;      Main-Spessart (Lkr);5 bis unter 6;1023;535;488
09677;      Main-Spessart (Lkr);6 bis unter 7;1045;523;522
09677;      Main-Spessart (Lkr);7 bis unter 8;1006;508;498
09677;      Main-Spessart (Lkr);8 bis unter 9;980;498;482
09677;      Main-Spessart (Lkr);9 bis unter 10;1003;486;517
09677;      Main-Spessart (Lkr);10 bis unter 11;1044;544;500
09677;      Main-Spessart (Lkr);11 bis unter 12;1024;530;494
09677;      Main-Spessart (Lkr);12 bis unter 13;1068;557;511
09677;      Main-Spessart (Lkr);13 bis unter 14;1102;550;552
09677;      Main-Spessart (Lkr);14 bis unter 15;1142;563;579
09677;      Main-Spessart (Lkr);15 bis unter 16;1146;589;557
09677;      Main-Spessart (Lkr);16 bis unter 17;1272;659;613
09677;      Main-Spessart (Lkr);17 bis unter 18;1239;632;607
09677;      Main-Spessart (Lkr);18 bis unter 19;1259;631;628
09677;      Main-Spessart (Lkr);19 bis unter 20;1262;683;579
09677;      Main-Spessart (Lkr);20 bis unter 21;1325;734;591
09677;      Main-Spessart (Lkr);21 bis unter 22;1338;721;617
09677;      Main-Spessart (Lkr);22 bis unter 23;1297;719;578
09677;      Main-Spessart (Lkr);23 bis unter 24;1281;697;584
09677;      Main-Spessart (Lkr);24 bis unter 25;1295;699;596
09677;      Main-Spessart (Lkr);25 bis unter 26;1341;738;603
09677;      Main-Spessart (Lkr);26 bis unter 27;1351;702;649
09677;      Main-Spessart (Lkr);27 bis unter 28;1377;760;617
09677;      Main-Spessart (Lkr);28 bis unter 29;1434;762;672
09677;      Main-Spessart (Lkr);29 bis unter 30;1400;749;651
09677;      Main-Spessart (Lkr);30 bis unter 31;1458;764;694
09677;      Main-Spessart (Lkr);31 bis unter 32;1369;697;672
09677;      Main-Spessart (Lkr);32 bis unter 33;1424;772;652
09677;      Main-Spessart (Lkr);33 bis unter 34;1382;710;672
09677;      Main-Spessart (Lkr);34 bis unter 35;1433;727;706
09677;      Main-Spessart (Lkr);35 bis unter 36;1402;751;651
09677;      Main-Spessart (Lkr);36 bis unter 37;1421;741;680
09677;      Main-Spessart (Lkr);37 bis unter 38;1443;744;699
09677;      Main-Spessart (Lkr);38 bis unter 39;1414;718;696
09677;      Main-Spessart (Lkr);39 bis unter 40;1431;737;694
09677;      Main-Spessart (Lkr);40 bis unter 41;1441;735;706
09677;      Main-Spessart (Lkr);41 bis unter 42;1318;620;698
09677;      Main-Spessart (Lkr);42 bis unter 43;1375;715;660
09677;      Main-Spessart (Lkr);43 bis unter 44;1406;662;744
09677;      Main-Spessart (Lkr);44 bis unter 45;1401;722;679
09677;      Main-Spessart (Lkr);45 bis unter 46;1431;705;726
09677;      Main-Spessart (Lkr);46 bis unter 47;1604;781;823
09677;      Main-Spessart (Lkr);47 bis unter 48;1720;844;876
09677;      Main-Spessart (Lkr);48 bis unter 49;1825;905;920
09677;      Main-Spessart (Lkr);49 bis unter 50;2066;1014;1052
09677;      Main-Spessart (Lkr);50 bis unter 51;2183;1111;1072
09677;      Main-Spessart (Lkr);51 bis unter 52;2166;1055;1111
09677;      Main-Spessart (Lkr);52 bis unter 53;2300;1108;1192
09677;      Main-Spessart (Lkr);53 bis unter 54;2260;1151;1109
09677;      Main-Spessart (Lkr);54 bis unter 55;2246;1170;1076
09677;      Main-Spessart (Lkr);55 bis unter 56;2413;1204;1209
09677;      Main-Spessart (Lkr);56 bis unter 57;2284;1153;1131
09677;      Main-Spessart (Lkr);57 bis unter 58;2338;1219;1119
09677;      Main-Spessart (Lkr);58 bis unter 59;2289;1181;1108
09677;      Main-Spessart (Lkr);59 bis unter 60;2186;1067;1119
09677;      Main-Spessart (Lkr);60 bis unter 61;2019;1037;982
09677;      Main-Spessart (Lkr);61 bis unter 62;1967;1013;954
09677;      Main-Spessart (Lkr);62 bis unter 63;1884;963;921
09677;      Main-Spessart (Lkr);63 bis unter 64;1875;920;955
09677;      Main-Spessart (Lkr);64 bis unter 65;1784;912;872
09677;      Main-Spessart (Lkr);65 bis unter 66;1744;815;929
09677;      Main-Spessart (Lkr);66 bis unter 67;1689;848;841
09677;      Main-Spessart (Lkr);67 bis unter 68;1663;882;781
09677;      Main-Spessart (Lkr);68 bis unter 69;1677;846;831
09677;      Main-Spessart (Lkr);69 bis unter 70;1566;786;780
09677;      Main-Spessart (Lkr);70 bis unter 71;1435;735;700
09677;      Main-Spessart (Lkr);71 bis unter 72;1267;607;660
09677;      Main-Spessart (Lkr);72 bis unter 73;1102;541;561
09677;      Main-Spessart (Lkr);73 bis unter 74;807;364;443
09677;      Main-Spessart (Lkr);74 bis unter 75;1098;522;576
09677;      Main-Spessart (Lkr);75 bis unter 76;1004;478;526
09677;      Main-Spessart (Lkr);76 bis unter 77;963;443;520
09677;      Main-Spessart (Lkr);77 bis unter 78;1248;595;653
09677;      Main-Spessart (Lkr);78 bis unter 79;1406;633;773
09677;      Main-Spessart (Lkr);79 bis unter 80;1409;654;755
09677;      Main-Spessart (Lkr);80 bis unter 81;1285;506;779
09677;      Main-Spessart (Lkr);81 bis unter 82;1092;471;621
09677;      Main-Spessart (Lkr);82 bis unter 83;1071;447;624
09677;      Main-Spessart (Lkr);83 bis unter 84;932;364;568
09677;      Main-Spessart (Lkr);84 bis unter 85;817;336;481
09677;      Main-Spessart (Lkr);85 bis unter 90;2412;897;1515
09677;      Main-Spessart (Lkr);90 bis unter 95;1015;286;729
09677;      Main-Spessart (Lkr);95 oder älter;202;36;166
09677;      Main-Spessart (Lkr);Insgesamt;126365;62953;63412
09678;      Schweinfurt (Lkr);unter 1;1037;559;478
09678;      Schweinfurt (Lkr);1 bis unter 2;1087;562;525
09678;      Schweinfurt (Lkr);2 bis unter 3;1106;578;528
09678;      Schweinfurt (Lkr);3 bis unter 4;1096;553;543
09678;      Schweinfurt (Lkr);4 bis unter 5;1055;570;485
09678;      Schweinfurt (Lkr);5 bis unter 6;992;513;479
09678;      Schweinfurt (Lkr);6 bis unter 7;973;494;479
09678;      Schweinfurt (Lkr);7 bis unter 8;1004;521;483
09678;      Schweinfurt (Lkr);8 bis unter 9;995;510;485
09678;      Schweinfurt (Lkr);9 bis unter 10;954;514;440
09678;      Schweinfurt (Lkr);10 bis unter 11;1016;551;465
09678;      Schweinfurt (Lkr);11 bis unter 12;989;501;488
09678;      Schweinfurt (Lkr);12 bis unter 13;956;494;462
09678;      Schweinfurt (Lkr);13 bis unter 14;1026;559;467
09678;      Schweinfurt (Lkr);14 bis unter 15;1111;586;525
09678;      Schweinfurt (Lkr);15 bis unter 16;1046;546;500
09678;      Schweinfurt (Lkr);16 bis unter 17;1158;569;589
09678;      Schweinfurt (Lkr);17 bis unter 18;1130;543;587
09678;      Schweinfurt (Lkr);18 bis unter 19;1203;620;583
09678;      Schweinfurt (Lkr);19 bis unter 20;1203;640;563
09678;      Schweinfurt (Lkr);20 bis unter 21;1223;658;565
09678;      Schweinfurt (Lkr);21 bis unter 22;1182;621;561
09678;      Schweinfurt (Lkr);22 bis unter 23;1247;697;550
09678;      Schweinfurt (Lkr);23 bis unter 24;1156;625;531
09678;      Schweinfurt (Lkr);24 bis unter 25;1180;644;536
09678;      Schweinfurt (Lkr);25 bis unter 26;1321;697;624
09678;      Schweinfurt (Lkr);26 bis unter 27;1289;662;627
09678;      Schweinfurt (Lkr);27 bis unter 28;1332;705;627
09678;      Schweinfurt (Lkr);28 bis unter 29;1334;679;655
09678;      Schweinfurt (Lkr);29 bis unter 30;1334;700;634
09678;      Schweinfurt (Lkr);30 bis unter 31;1405;732;673
09678;      Schweinfurt (Lkr);31 bis unter 32;1498;801;697
09678;      Schweinfurt (Lkr);32 bis unter 33;1319;677;642
09678;      Schweinfurt (Lkr);33 bis unter 34;1364;667;697
09678;      Schweinfurt (Lkr);34 bis unter 35;1327;695;632
09678;      Schweinfurt (Lkr);35 bis unter 36;1374;741;633
09678;      Schweinfurt (Lkr);36 bis unter 37;1413;735;678
09678;      Schweinfurt (Lkr);37 bis unter 38;1406;722;684
09678;      Schweinfurt (Lkr);38 bis unter 39;1368;696;672
09678;      Schweinfurt (Lkr);39 bis unter 40;1335;693;642
09678;      Schweinfurt (Lkr);40 bis unter 41;1282;642;640
09678;      Schweinfurt (Lkr);41 bis unter 42;1288;642;646
09678;      Schweinfurt (Lkr);42 bis unter 43;1213;579;634
09678;      Schweinfurt (Lkr);43 bis unter 44;1202;595;607
09678;      Schweinfurt (Lkr);44 bis unter 45;1263;653;610
09678;      Schweinfurt (Lkr);45 bis unter 46;1268;660;608
09678;      Schweinfurt (Lkr);46 bis unter 47;1403;719;684
09678;      Schweinfurt (Lkr);47 bis unter 48;1562;775;787
09678;      Schweinfurt (Lkr);48 bis unter 49;1619;816;803
09678;      Schweinfurt (Lkr);49 bis unter 50;1743;866;877
09678;      Schweinfurt (Lkr);50 bis unter 51;1884;938;946
09678;      Schweinfurt (Lkr);51 bis unter 52;1939;949;990
09678;      Schweinfurt (Lkr);52 bis unter 53;2045;1015;1030
09678;      Schweinfurt (Lkr);53 bis unter 54;2053;1039;1014
09678;      Schweinfurt (Lkr);54 bis unter 55;2149;1098;1051
09678;      Schweinfurt (Lkr);55 bis unter 56;2159;1101;1058
09678;      Schweinfurt (Lkr);56 bis unter 57;2057;1083;974
09678;      Schweinfurt (Lkr);57 bis unter 58;2080;1047;1033
09678;      Schweinfurt (Lkr);58 bis unter 59;1960;1002;958
09678;      Schweinfurt (Lkr);59 bis unter 60;1950;986;964
09678;      Schweinfurt (Lkr);60 bis unter 61;1802;890;912
09678;      Schweinfurt (Lkr);61 bis unter 62;1706;877;829
09678;      Schweinfurt (Lkr);62 bis unter 63;1776;870;906
09678;      Schweinfurt (Lkr);63 bis unter 64;1550;783;767
09678;      Schweinfurt (Lkr);64 bis unter 65;1633;833;800
09678;      Schweinfurt (Lkr);65 bis unter 66;1510;739;771
09678;      Schweinfurt (Lkr);66 bis unter 67;1533;784;749
09678;      Schweinfurt (Lkr);67 bis unter 68;1434;700;734
09678;      Schweinfurt (Lkr);68 bis unter 69;1317;672;645
09678;      Schweinfurt (Lkr);69 bis unter 70;1319;648;671
09678;      Schweinfurt (Lkr);70 bis unter 71;1213;617;596
09678;      Schweinfurt (Lkr);71 bis unter 72;1130;524;606
09678;      Schweinfurt (Lkr);72 bis unter 73;900;454;446
09678;      Schweinfurt (Lkr);73 bis unter 74;675;327;348
09678;      Schweinfurt (Lkr);74 bis unter 75;1018;486;532
09678;      Schweinfurt (Lkr);75 bis unter 76;912;459;453
09678;      Schweinfurt (Lkr);76 bis unter 77;900;411;489
09678;      Schweinfurt (Lkr);77 bis unter 78;1131;497;634
09678;      Schweinfurt (Lkr);78 bis unter 79;1204;513;691
09678;      Schweinfurt (Lkr);79 bis unter 80;1255;589;666
09678;      Schweinfurt (Lkr);80 bis unter 81;1057;486;571
09678;      Schweinfurt (Lkr);81 bis unter 82;987;464;523
09678;      Schweinfurt (Lkr);82 bis unter 83;887;373;514
09678;      Schweinfurt (Lkr);83 bis unter 84;805;346;459
09678;      Schweinfurt (Lkr);84 bis unter 85;664;278;386
09678;      Schweinfurt (Lkr);85 bis unter 90;2098;776;1322
09678;      Schweinfurt (Lkr);90 bis unter 95;852;289;563
09678;      Schweinfurt (Lkr);95 oder älter;175;48;127
09678;      Schweinfurt (Lkr);Insgesamt;115106;57768;57338
09679;      Würzburg (Lkr);unter 1;1545;797;748
09679;      Würzburg (Lkr);1 bis unter 2;1552;786;766
09679;      Würzburg (Lkr);2 bis unter 3;1581;826;755
09679;      Würzburg (Lkr);3 bis unter 4;1585;811;774
09679;      Würzburg (Lkr);4 bis unter 5;1517;772;745
09679;      Würzburg (Lkr);5 bis unter 6;1495;778;717
09679;      Würzburg (Lkr);6 bis unter 7;1400;740;660
09679;      Würzburg (Lkr);7 bis unter 8;1463;781;682
09679;      Würzburg (Lkr);8 bis unter 9;1410;719;691
09679;      Würzburg (Lkr);9 bis unter 10;1420;718;702
09679;      Würzburg (Lkr);10 bis unter 11;1433;722;711
09679;      Würzburg (Lkr);11 bis unter 12;1402;690;712
09679;      Würzburg (Lkr);12 bis unter 13;1408;746;662
09679;      Würzburg (Lkr);13 bis unter 14;1510;775;735
09679;      Würzburg (Lkr);14 bis unter 15;1481;760;721
09679;      Würzburg (Lkr);15 bis unter 16;1578;809;769
09679;      Würzburg (Lkr);16 bis unter 17;1512;792;720
09679;      Würzburg (Lkr);17 bis unter 18;1650;861;789
09679;      Würzburg (Lkr);18 bis unter 19;1633;864;769
09679;      Würzburg (Lkr);19 bis unter 20;1726;913;813
09679;      Würzburg (Lkr);20 bis unter 21;1765;971;794
09679;      Würzburg (Lkr);21 bis unter 22;1751;954;797
09679;      Würzburg (Lkr);22 bis unter 23;1762;893;869
09679;      Würzburg (Lkr);23 bis unter 24;1704;926;778
09679;      Würzburg (Lkr);24 bis unter 25;1707;885;822
09679;      Würzburg (Lkr);25 bis unter 26;1732;937;795
09679;      Würzburg (Lkr);26 bis unter 27;1733;939;794
09679;      Würzburg (Lkr);27 bis unter 28;1792;879;913
09679;      Würzburg (Lkr);28 bis unter 29;1894;969;925
09679;      Würzburg (Lkr);29 bis unter 30;1789;972;817
09679;      Würzburg (Lkr);30 bis unter 31;1888;985;903
09679;      Würzburg (Lkr);31 bis unter 32;1912;976;936
09679;      Würzburg (Lkr);32 bis unter 33;2026;1032;994
09679;      Würzburg (Lkr);33 bis unter 34;1840;910;930
09679;      Würzburg (Lkr);34 bis unter 35;1917;984;933
09679;      Würzburg (Lkr);35 bis unter 36;1949;976;973
09679;      Würzburg (Lkr);36 bis unter 37;2047;1045;1002
09679;      Würzburg (Lkr);37 bis unter 38;2009;1020;989
09679;      Würzburg (Lkr);38 bis unter 39;2040;1028;1012
09679;      Würzburg (Lkr);39 bis unter 40;1959;964;995
09679;      Würzburg (Lkr);40 bis unter 41;1984;974;1010
09679;      Würzburg (Lkr);41 bis unter 42;1913;956;957
09679;      Würzburg (Lkr);42 bis unter 43;1944;943;1001
09679;      Würzburg (Lkr);43 bis unter 44;1951;1010;941
09679;      Würzburg (Lkr);44 bis unter 45;1869;946;923
09679;      Würzburg (Lkr);45 bis unter 46;1843;955;888
09679;      Würzburg (Lkr);46 bis unter 47;2050;1021;1029
09679;      Würzburg (Lkr);47 bis unter 48;2222;1037;1185
09679;      Würzburg (Lkr);48 bis unter 49;2246;1136;1110
09679;      Würzburg (Lkr);49 bis unter 50;2512;1241;1271
09679;      Würzburg (Lkr);50 bis unter 51;2593;1303;1290
09679;      Würzburg (Lkr);51 bis unter 52;2697;1376;1321
09679;      Würzburg (Lkr);52 bis unter 53;2734;1393;1341
09679;      Würzburg (Lkr);53 bis unter 54;2750;1397;1353
09679;      Würzburg (Lkr);54 bis unter 55;2945;1420;1525
09679;      Würzburg (Lkr);55 bis unter 56;2824;1416;1408
09679;      Würzburg (Lkr);56 bis unter 57;2805;1350;1455
09679;      Würzburg (Lkr);57 bis unter 58;2852;1424;1428
09679;      Würzburg (Lkr);58 bis unter 59;2783;1389;1394
09679;      Würzburg (Lkr);59 bis unter 60;2643;1292;1351
09679;      Würzburg (Lkr);60 bis unter 61;2535;1269;1266
09679;      Würzburg (Lkr);61 bis unter 62;2423;1175;1248
09679;      Würzburg (Lkr);62 bis unter 63;2381;1181;1200
09679;      Würzburg (Lkr);63 bis unter 64;2163;1090;1073
09679;      Würzburg (Lkr);64 bis unter 65;2244;1088;1156
09679;      Würzburg (Lkr);65 bis unter 66;2062;984;1078
09679;      Würzburg (Lkr);66 bis unter 67;2110;1061;1049
09679;      Würzburg (Lkr);67 bis unter 68;2068;1012;1056
09679;      Würzburg (Lkr);68 bis unter 69;2155;1024;1131
09679;      Würzburg (Lkr);69 bis unter 70;1881;927;954
09679;      Würzburg (Lkr);70 bis unter 71;1737;872;865
09679;      Würzburg (Lkr);71 bis unter 72;1669;799;870
09679;      Würzburg (Lkr);72 bis unter 73;1416;684;732
09679;      Würzburg (Lkr);73 bis unter 74;944;460;484
09679;      Würzburg (Lkr);74 bis unter 75;1293;654;639
09679;      Würzburg (Lkr);75 bis unter 76;1288;649;639
09679;      Würzburg (Lkr);76 bis unter 77;1198;544;654
09679;      Würzburg (Lkr);77 bis unter 78;1544;725;819
09679;      Würzburg (Lkr);78 bis unter 79;1678;753;925
09679;      Würzburg (Lkr);79 bis unter 80;1575;743;832
09679;      Würzburg (Lkr);80 bis unter 81;1399;677;722
09679;      Würzburg (Lkr);81 bis unter 82;1284;564;720
09679;      Würzburg (Lkr);82 bis unter 83;1109;491;618
09679;      Würzburg (Lkr);83 bis unter 84;1013;431;582
09679;      Würzburg (Lkr);84 bis unter 85;918;390;528
09679;      Würzburg (Lkr);85 bis unter 90;2708;1067;1641
09679;      Würzburg (Lkr);90 bis unter 95;1097;341;756
09679;      Würzburg (Lkr);95 oder älter;265;55;210
09679;      Würzburg (Lkr);Insgesamt;161834;80594;81240
LK096;    Landkreise Unterfranken;unter 1;9431;4884;4547
LK096;    Landkreise Unterfranken;1 bis unter 2;9921;5113;4808
LK096;    Landkreise Unterfranken;2 bis unter 3;9886;5108;4778
LK096;    Landkreise Unterfranken;3 bis unter 4;9691;4948;4743
LK096;    Landkreise Unterfranken;4 bis unter 5;9389;4881;4508
LK096;    Landkreise Unterfranken;5 bis unter 6;9250;4781;4469
LK096;    Landkreise Unterfranken;6 bis unter 7;9103;4657;4446
LK096;    Landkreise Unterfranken;7 bis unter 8;9034;4615;4419
LK096;    Landkreise Unterfranken;8 bis unter 9;8961;4541;4420
LK096;    Landkreise Unterfranken;9 bis unter 10;8939;4567;4372
LK096;    Landkreise Unterfranken;10 bis unter 11;9226;4768;4458
LK096;    Landkreise Unterfranken;11 bis unter 12;9200;4631;4569
LK096;    Landkreise Unterfranken;12 bis unter 13;9245;4785;4460
LK096;    Landkreise Unterfranken;13 bis unter 14;9551;4911;4640
LK096;    Landkreise Unterfranken;14 bis unter 15;9915;5106;4809
LK096;    Landkreise Unterfranken;15 bis unter 16;10239;5211;5028
LK096;    Landkreise Unterfranken;16 bis unter 17;10429;5301;5128
LK096;    Landkreise Unterfranken;17 bis unter 18;10762;5522;5240
LK096;    Landkreise Unterfranken;18 bis unter 19;11142;5815;5327
LK096;    Landkreise Unterfranken;19 bis unter 20;11139;5907;5232
LK096;    Landkreise Unterfranken;20 bis unter 21;11328;6176;5152
LK096;    Landkreise Unterfranken;21 bis unter 22;11410;6157;5253
LK096;    Landkreise Unterfranken;22 bis unter 23;11302;6154;5148
LK096;    Landkreise Unterfranken;23 bis unter 24;11048;5959;5089
LK096;    Landkreise Unterfranken;24 bis unter 25;11130;5943;5187
LK096;    Landkreise Unterfranken;25 bis unter 26;11662;6329;5333
LK096;    Landkreise Unterfranken;26 bis unter 27;11595;6086;5509
LK096;    Landkreise Unterfranken;27 bis unter 28;11775;6169;5606
LK096;    Landkreise Unterfranken;28 bis unter 29;12416;6472;5944
LK096;    Landkreise Unterfranken;29 bis unter 30;11989;6259;5730
LK096;    Landkreise Unterfranken;30 bis unter 31;12609;6611;5998
LK096;    Landkreise Unterfranken;31 bis unter 32;12396;6432;5964
LK096;    Landkreise Unterfranken;32 bis unter 33;12375;6413;5962
LK096;    Landkreise Unterfranken;33 bis unter 34;11923;6008;5915
LK096;    Landkreise Unterfranken;34 bis unter 35;12176;6286;5890
LK096;    Landkreise Unterfranken;35 bis unter 36;12558;6448;6110
LK096;    Landkreise Unterfranken;36 bis unter 37;12881;6583;6298
LK096;    Landkreise Unterfranken;37 bis unter 38;12829;6508;6321
LK096;    Landkreise Unterfranken;38 bis unter 39;12699;6424;6275
LK096;    Landkreise Unterfranken;39 bis unter 40;12123;6141;5982
LK096;    Landkreise Unterfranken;40 bis unter 41;12163;6006;6157
LK096;    Landkreise Unterfranken;41 bis unter 42;12036;6003;6033
LK096;    Landkreise Unterfranken;42 bis unter 43;11980;5921;6059
LK096;    Landkreise Unterfranken;43 bis unter 44;11770;5833;5937
LK096;    Landkreise Unterfranken;44 bis unter 45;12069;6004;6065
LK096;    Landkreise Unterfranken;45 bis unter 46;12195;6055;6140
LK096;    Landkreise Unterfranken;46 bis unter 47;13518;6716;6802
LK096;    Landkreise Unterfranken;47 bis unter 48;14824;7232;7592
LK096;    Landkreise Unterfranken;48 bis unter 49;15344;7792;7552
LK096;    Landkreise Unterfranken;49 bis unter 50;16986;8422;8564
LK096;    Landkreise Unterfranken;50 bis unter 51;17572;8813;8759
LK096;    Landkreise Unterfranken;51 bis unter 52;18425;9164;9261
LK096;    Landkreise Unterfranken;52 bis unter 53;19018;9562;9456
LK096;    Landkreise Unterfranken;53 bis unter 54;18865;9664;9201
LK096;    Landkreise Unterfranken;54 bis unter 55;19441;9851;9590
LK096;    Landkreise Unterfranken;55 bis unter 56;19446;9717;9729
LK096;    Landkreise Unterfranken;56 bis unter 57;19169;9692;9477
LK096;    Landkreise Unterfranken;57 bis unter 58;19054;9516;9538
LK096;    Landkreise Unterfranken;58 bis unter 59;18467;9291;9176
LK096;    Landkreise Unterfranken;59 bis unter 60;17633;8796;8837
LK096;    Landkreise Unterfranken;60 bis unter 61;16736;8497;8239
LK096;    Landkreise Unterfranken;61 bis unter 62;15971;8010;7961
LK096;    Landkreise Unterfranken;62 bis unter 63;15755;7873;7882
LK096;    Landkreise Unterfranken;63 bis unter 64;14698;7418;7280
LK096;    Landkreise Unterfranken;64 bis unter 65;14669;7359;7310
LK096;    Landkreise Unterfranken;65 bis unter 66;14041;6901;7140
LK096;    Landkreise Unterfranken;66 bis unter 67;13817;6880;6937
LK096;    Landkreise Unterfranken;67 bis unter 68;13259;6590;6669
LK096;    Landkreise Unterfranken;68 bis unter 69;13268;6615;6653
LK096;    Landkreise Unterfranken;69 bis unter 70;12613;6220;6393
LK096;    Landkreise Unterfranken;70 bis unter 71;11582;5843;5739
LK096;    Landkreise Unterfranken;71 bis unter 72;10507;5196;5311
LK096;    Landkreise Unterfranken;72 bis unter 73;8890;4368;4522
LK096;    Landkreise Unterfranken;73 bis unter 74;6427;3013;3414
LK096;    Landkreise Unterfranken;74 bis unter 75;8803;4269;4534
LK096;    Landkreise Unterfranken;75 bis unter 76;8455;4168;4287
LK096;    Landkreise Unterfranken;76 bis unter 77;8073;3792;4281
LK096;    Landkreise Unterfranken;77 bis unter 78;10196;4667;5529
LK096;    Landkreise Unterfranken;78 bis unter 79;11360;5061;6299
LK096;    Landkreise Unterfranken;79 bis unter 80;11275;5089;6186
LK096;    Landkreise Unterfranken;80 bis unter 81;9973;4417;5556
LK096;    Landkreise Unterfranken;81 bis unter 82;8952;3957;4995
LK096;    Landkreise Unterfranken;82 bis unter 83;8123;3472;4651
LK096;    Landkreise Unterfranken;83 bis unter 84;7281;3025;4256
LK096;    Landkreise Unterfranken;84 bis unter 85;6261;2561;3700
LK096;    Landkreise Unterfranken;85 bis unter 90;19279;7162;12117
LK096;    Landkreise Unterfranken;90 bis unter 95;7913;2382;5531
LK096;    Landkreise Unterfranken;95 oder älter;1856;411;1445
LK096;    Landkreise Unterfranken;Insgesamt;1064685;530876;533809
096;  Unterfranken;unter 1;11920;6156;5764
096;  Unterfranken;1 bis unter 2;12308;6354;5954
096;  Unterfranken;2 bis unter 3;12136;6236;5900
096;  Unterfranken;3 bis unter 4;11895;6078;5817
096;  Unterfranken;4 bis unter 5;11488;5955;5533
096;  Unterfranken;5 bis unter 6;11209;5750;5459
096;  Unterfranken;6 bis unter 7;11026;5661;5365
096;  Unterfranken;7 bis unter 8;10845;5525;5320
096;  Unterfranken;8 bis unter 9;10822;5468;5354
096;  Unterfranken;9 bis unter 10;10829;5563;5266
096;  Unterfranken;10 bis unter 11;11154;5752;5402
096;  Unterfranken;11 bis unter 12;11060;5578;5482
096;  Unterfranken;12 bis unter 13;11119;5756;5363
096;  Unterfranken;13 bis unter 14;11372;5841;5531
096;  Unterfranken;14 bis unter 15;11817;6073;5744
096;  Unterfranken;15 bis unter 16;12074;6142;5932
096;  Unterfranken;16 bis unter 17;12276;6243;6033
096;  Unterfranken;17 bis unter 18;12761;6581;6180
096;  Unterfranken;18 bis unter 19;13479;7008;6471
096;  Unterfranken;19 bis unter 20;14203;7438;6765
096;  Unterfranken;20 bis unter 21;15043;7953;7090
096;  Unterfranken;21 bis unter 22;15515;8038;7477
096;  Unterfranken;22 bis unter 23;15629;8152;7477
096;  Unterfranken;23 bis unter 24;15347;7968;7379
096;  Unterfranken;24 bis unter 25;15618;8045;7573
096;  Unterfranken;25 bis unter 26;16280;8615;7665
096;  Unterfranken;26 bis unter 27;16202;8399;7803
096;  Unterfranken;27 bis unter 28;16354;8521;7833
096;  Unterfranken;28 bis unter 29;17097;8929;8168
096;  Unterfranken;29 bis unter 30;16504;8623;7881
096;  Unterfranken;30 bis unter 31;17140;9061;8079
096;  Unterfranken;31 bis unter 32;16536;8678;7858
096;  Unterfranken;32 bis unter 33;16358;8623;7735
096;  Unterfranken;33 bis unter 34;15486;7938;7548
096;  Unterfranken;34 bis unter 35;15657;8155;7502
096;  Unterfranken;35 bis unter 36;16050;8273;7777
096;  Unterfranken;36 bis unter 37;16314;8369;7945
096;  Unterfranken;37 bis unter 38;16124;8144;7980
096;  Unterfranken;38 bis unter 39;15679;7985;7694
096;  Unterfranken;39 bis unter 40;14982;7642;7340
096;  Unterfranken;40 bis unter 41;15009;7443;7566
096;  Unterfranken;41 bis unter 42;14824;7429;7395
096;  Unterfranken;42 bis unter 43;14664;7238;7426
096;  Unterfranken;43 bis unter 44;14434;7150;7284
096;  Unterfranken;44 bis unter 45;14754;7379;7375
096;  Unterfranken;45 bis unter 46;14786;7321;7465
096;  Unterfranken;46 bis unter 47;16349;8128;8221
096;  Unterfranken;47 bis unter 48;17736;8722;9014
096;  Unterfranken;48 bis unter 49;18287;9287;9000
096;  Unterfranken;49 bis unter 50;20146;9998;10148
096;  Unterfranken;50 bis unter 51;20955;10525;10430
096;  Unterfranken;51 bis unter 52;22041;10955;11086
096;  Unterfranken;52 bis unter 53;22626;11343;11283
096;  Unterfranken;53 bis unter 54;22494;11498;10996
096;  Unterfranken;54 bis unter 55;23095;11665;11430
096;  Unterfranken;55 bis unter 56;23117;11496;11621
096;  Unterfranken;56 bis unter 57;22723;11469;11254
096;  Unterfranken;57 bis unter 58;22600;11246;11354
096;  Unterfranken;58 bis unter 59;21827;10946;10881
096;  Unterfranken;59 bis unter 60;20936;10374;10562
096;  Unterfranken;60 bis unter 61;19895;10001;9894
096;  Unterfranken;61 bis unter 62;19052;9438;9614
096;  Unterfranken;62 bis unter 63;18856;9300;9556
096;  Unterfranken;63 bis unter 64;17585;8771;8814
096;  Unterfranken;64 bis unter 65;17559;8670;8889
096;  Unterfranken;65 bis unter 66;16810;8162;8648
096;  Unterfranken;66 bis unter 67;16583;8148;8435
096;  Unterfranken;67 bis unter 68;15836;7733;8103
096;  Unterfranken;68 bis unter 69;15972;7812;8160
096;  Unterfranken;69 bis unter 70;15170;7403;7767
096;  Unterfranken;70 bis unter 71;13898;6879;7019
096;  Unterfranken;71 bis unter 72;12775;6201;6574
096;  Unterfranken;72 bis unter 73;10804;5244;5560
096;  Unterfranken;73 bis unter 74;8025;3694;4331
096;  Unterfranken;74 bis unter 75;10972;5223;5749
096;  Unterfranken;75 bis unter 76;10603;5120;5483
096;  Unterfranken;76 bis unter 77;10126;4689;5437
096;  Unterfranken;77 bis unter 78;12763;5762;7001
096;  Unterfranken;78 bis unter 79;13998;6161;7837
096;  Unterfranken;79 bis unter 80;13706;6099;7607
096;  Unterfranken;80 bis unter 81;12253;5323;6930
096;  Unterfranken;81 bis unter 82;10976;4799;6177
096;  Unterfranken;82 bis unter 83;10058;4243;5815
096;  Unterfranken;83 bis unter 84;8991;3664;5327
096;  Unterfranken;84 bis unter 85;7777;3148;4629
096;  Unterfranken;85 bis unter 90;24073;8807;15266
096;  Unterfranken;90 bis unter 95;10340;3003;7337
096;  Unterfranken;95 oder älter;2557;518;2039
096;  Unterfranken;Insgesamt;1317124;652896;664228
09761;      Augsburg (Krfr.St);unter 1;2982;1489;1493
09761;      Augsburg (Krfr.St);1 bis unter 2;2996;1539;1457
09761;      Augsburg (Krfr.St);2 bis unter 3;2885;1503;1382
09761;      Augsburg (Krfr.St);3 bis unter 4;2688;1376;1312
09761;      Augsburg (Krfr.St);4 bis unter 5;2695;1320;1375
09761;      Augsburg (Krfr.St);5 bis unter 6;2452;1259;1193
09761;      Augsburg (Krfr.St);6 bis unter 7;2491;1317;1174
09761;      Augsburg (Krfr.St);7 bis unter 8;2274;1164;1110
09761;      Augsburg (Krfr.St);8 bis unter 9;2283;1156;1127
09761;      Augsburg (Krfr.St);9 bis unter 10;2246;1148;1098
09761;      Augsburg (Krfr.St);10 bis unter 11;2391;1219;1172
09761;      Augsburg (Krfr.St);11 bis unter 12;2422;1277;1145
09761;      Augsburg (Krfr.St);12 bis unter 13;2360;1257;1103
09761;      Augsburg (Krfr.St);13 bis unter 14;2382;1224;1158
09761;      Augsburg (Krfr.St);14 bis unter 15;2350;1172;1178
09761;      Augsburg (Krfr.St);15 bis unter 16;2473;1272;1201
09761;      Augsburg (Krfr.St);16 bis unter 17;2373;1195;1178
09761;      Augsburg (Krfr.St);17 bis unter 18;2445;1246;1199
09761;      Augsburg (Krfr.St);18 bis unter 19;2728;1379;1349
09761;      Augsburg (Krfr.St);19 bis unter 20;3327;1665;1662
09761;      Augsburg (Krfr.St);20 bis unter 21;3903;1931;1972
09761;      Augsburg (Krfr.St);21 bis unter 22;4011;1987;2024
09761;      Augsburg (Krfr.St);22 bis unter 23;4410;2164;2246
09761;      Augsburg (Krfr.St);23 bis unter 24;4404;2143;2261
09761;      Augsburg (Krfr.St);24 bis unter 25;4486;2283;2203
09761;      Augsburg (Krfr.St);25 bis unter 26;4980;2496;2484
09761;      Augsburg (Krfr.St);26 bis unter 27;5062;2603;2459
09761;      Augsburg (Krfr.St);27 bis unter 28;5287;2652;2635
09761;      Augsburg (Krfr.St);28 bis unter 29;5257;2758;2499
09761;      Augsburg (Krfr.St);29 bis unter 30;5318;2802;2516
09761;      Augsburg (Krfr.St);30 bis unter 31;5329;2810;2519
09761;      Augsburg (Krfr.St);31 bis unter 32;5037;2707;2330
09761;      Augsburg (Krfr.St);32 bis unter 33;4897;2638;2259
09761;      Augsburg (Krfr.St);33 bis unter 34;4444;2364;2080
09761;      Augsburg (Krfr.St);34 bis unter 35;4265;2233;2032
09761;      Augsburg (Krfr.St);35 bis unter 36;4366;2303;2063
09761;      Augsburg (Krfr.St);36 bis unter 37;4396;2343;2053
09761;      Augsburg (Krfr.St);37 bis unter 38;4286;2237;2049
09761;      Augsburg (Krfr.St);38 bis unter 39;4171;2198;1973
09761;      Augsburg (Krfr.St);39 bis unter 40;3912;2009;1903
09761;      Augsburg (Krfr.St);40 bis unter 41;3790;1934;1856
09761;      Augsburg (Krfr.St);41 bis unter 42;3718;1874;1844
09761;      Augsburg (Krfr.St);42 bis unter 43;3653;1864;1789
09761;      Augsburg (Krfr.St);43 bis unter 44;3593;1842;1751
09761;      Augsburg (Krfr.St);44 bis unter 45;3664;1889;1775
09761;      Augsburg (Krfr.St);45 bis unter 46;3331;1672;1659
09761;      Augsburg (Krfr.St);46 bis unter 47;3649;1867;1782
09761;      Augsburg (Krfr.St);47 bis unter 48;3877;1914;1963
09761;      Augsburg (Krfr.St);48 bis unter 49;3884;1979;1905
09761;      Augsburg (Krfr.St);49 bis unter 50;4057;2128;1929
09761;      Augsburg (Krfr.St);50 bis unter 51;4234;2154;2080
09761;      Augsburg (Krfr.St);51 bis unter 52;4146;2131;2015
09761;      Augsburg (Krfr.St);52 bis unter 53;4126;2107;2019
09761;      Augsburg (Krfr.St);53 bis unter 54;4340;2239;2101
09761;      Augsburg (Krfr.St);54 bis unter 55;4254;2219;2035
09761;      Augsburg (Krfr.St);55 bis unter 56;4119;2111;2008
09761;      Augsburg (Krfr.St);56 bis unter 57;3992;1972;2020
09761;      Augsburg (Krfr.St);57 bis unter 58;3908;1967;1941
09761;      Augsburg (Krfr.St);58 bis unter 59;3866;1892;1974
09761;      Augsburg (Krfr.St);59 bis unter 60;3555;1709;1846
09761;      Augsburg (Krfr.St);60 bis unter 61;3578;1759;1819
09761;      Augsburg (Krfr.St);61 bis unter 62;3439;1697;1742
09761;      Augsburg (Krfr.St);62 bis unter 63;3348;1634;1714
09761;      Augsburg (Krfr.St);63 bis unter 64;3151;1473;1678
09761;      Augsburg (Krfr.St);64 bis unter 65;3073;1399;1674
09761;      Augsburg (Krfr.St);65 bis unter 66;2877;1343;1534
09761;      Augsburg (Krfr.St);66 bis unter 67;2757;1231;1526
09761;      Augsburg (Krfr.St);67 bis unter 68;2780;1230;1550
09761;      Augsburg (Krfr.St);68 bis unter 69;2890;1260;1630
09761;      Augsburg (Krfr.St);69 bis unter 70;2782;1238;1544
09761;      Augsburg (Krfr.St);70 bis unter 71;2552;1147;1405
09761;      Augsburg (Krfr.St);71 bis unter 72;2737;1214;1523
09761;      Augsburg (Krfr.St);72 bis unter 73;2349;1031;1318
09761;      Augsburg (Krfr.St);73 bis unter 74;2048;890;1158
09761;      Augsburg (Krfr.St);74 bis unter 75;2555;1149;1406
09761;      Augsburg (Krfr.St);75 bis unter 76;2439;1121;1318
09761;      Augsburg (Krfr.St);76 bis unter 77;2454;1140;1314
09761;      Augsburg (Krfr.St);77 bis unter 78;2722;1149;1573
09761;      Augsburg (Krfr.St);78 bis unter 79;2715;1157;1558
09761;      Augsburg (Krfr.St);79 bis unter 80;2695;1168;1527
09761;      Augsburg (Krfr.St);80 bis unter 81;2377;972;1405
09761;      Augsburg (Krfr.St);81 bis unter 82;2209;893;1316
09761;      Augsburg (Krfr.St);82 bis unter 83;2013;798;1215
09761;      Augsburg (Krfr.St);83 bis unter 84;1712;651;1061
09761;      Augsburg (Krfr.St);84 bis unter 85;1529;552;977
09761;      Augsburg (Krfr.St);85 bis unter 90;5197;1789;3408
09761;      Augsburg (Krfr.St);90 bis unter 95;2288;634;1654
09761;      Augsburg (Krfr.St);95 oder älter;649;137;512
09761;      Augsburg (Krfr.St);Insgesamt;295135;145158;149977
09762;      Kaufbeuren (Krfr.St);unter 1;407;218;189
09762;      Kaufbeuren (Krfr.St);1 bis unter 2;433;231;202
09762;      Kaufbeuren (Krfr.St);2 bis unter 3;446;230;216
09762;      Kaufbeuren (Krfr.St);3 bis unter 4;408;220;188
09762;      Kaufbeuren (Krfr.St);4 bis unter 5;379;172;207
09762;      Kaufbeuren (Krfr.St);5 bis unter 6;415;215;200
09762;      Kaufbeuren (Krfr.St);6 bis unter 7;370;187;183
09762;      Kaufbeuren (Krfr.St);7 bis unter 8;352;182;170
09762;      Kaufbeuren (Krfr.St);8 bis unter 9;360;172;188
09762;      Kaufbeuren (Krfr.St);9 bis unter 10;382;184;198
09762;      Kaufbeuren (Krfr.St);10 bis unter 11;393;199;194
09762;      Kaufbeuren (Krfr.St);11 bis unter 12;407;211;196
09762;      Kaufbeuren (Krfr.St);12 bis unter 13;367;183;184
09762;      Kaufbeuren (Krfr.St);13 bis unter 14;408;200;208
09762;      Kaufbeuren (Krfr.St);14 bis unter 15;416;233;183
09762;      Kaufbeuren (Krfr.St);15 bis unter 16;395;187;208
09762;      Kaufbeuren (Krfr.St);16 bis unter 17;413;222;191
09762;      Kaufbeuren (Krfr.St);17 bis unter 18;452;241;211
09762;      Kaufbeuren (Krfr.St);18 bis unter 19;456;222;234
09762;      Kaufbeuren (Krfr.St);19 bis unter 20;468;251;217
09762;      Kaufbeuren (Krfr.St);20 bis unter 21;483;258;225
09762;      Kaufbeuren (Krfr.St);21 bis unter 22;481;268;213
09762;      Kaufbeuren (Krfr.St);22 bis unter 23;448;242;206
09762;      Kaufbeuren (Krfr.St);23 bis unter 24;487;272;215
09762;      Kaufbeuren (Krfr.St);24 bis unter 25;491;240;251
09762;      Kaufbeuren (Krfr.St);25 bis unter 26;557;283;274
09762;      Kaufbeuren (Krfr.St);26 bis unter 27;529;276;253
09762;      Kaufbeuren (Krfr.St);27 bis unter 28;530;286;244
09762;      Kaufbeuren (Krfr.St);28 bis unter 29;628;319;309
09762;      Kaufbeuren (Krfr.St);29 bis unter 30;535;269;266
09762;      Kaufbeuren (Krfr.St);30 bis unter 31;560;294;266
09762;      Kaufbeuren (Krfr.St);31 bis unter 32;618;332;286
09762;      Kaufbeuren (Krfr.St);32 bis unter 33;557;304;253
09762;      Kaufbeuren (Krfr.St);33 bis unter 34;591;327;264
09762;      Kaufbeuren (Krfr.St);34 bis unter 35;520;269;251
09762;      Kaufbeuren (Krfr.St);35 bis unter 36;542;292;250
09762;      Kaufbeuren (Krfr.St);36 bis unter 37;541;297;244
09762;      Kaufbeuren (Krfr.St);37 bis unter 38;522;272;250
09762;      Kaufbeuren (Krfr.St);38 bis unter 39;547;287;260
09762;      Kaufbeuren (Krfr.St);39 bis unter 40;515;259;256
09762;      Kaufbeuren (Krfr.St);40 bis unter 41;526;266;260
09762;      Kaufbeuren (Krfr.St);41 bis unter 42;495;264;231
09762;      Kaufbeuren (Krfr.St);42 bis unter 43;487;262;225
09762;      Kaufbeuren (Krfr.St);43 bis unter 44;496;256;240
09762;      Kaufbeuren (Krfr.St);44 bis unter 45;499;249;250
09762;      Kaufbeuren (Krfr.St);45 bis unter 46;487;255;232
09762;      Kaufbeuren (Krfr.St);46 bis unter 47;498;261;237
09762;      Kaufbeuren (Krfr.St);47 bis unter 48;524;224;300
09762;      Kaufbeuren (Krfr.St);48 bis unter 49;560;278;282
09762;      Kaufbeuren (Krfr.St);49 bis unter 50;632;330;302
09762;      Kaufbeuren (Krfr.St);50 bis unter 51;699;348;351
09762;      Kaufbeuren (Krfr.St);51 bis unter 52;627;307;320
09762;      Kaufbeuren (Krfr.St);52 bis unter 53;710;355;355
09762;      Kaufbeuren (Krfr.St);53 bis unter 54;688;341;347
09762;      Kaufbeuren (Krfr.St);54 bis unter 55;729;371;358
09762;      Kaufbeuren (Krfr.St);55 bis unter 56;741;343;398
09762;      Kaufbeuren (Krfr.St);56 bis unter 57;714;357;357
09762;      Kaufbeuren (Krfr.St);57 bis unter 58;720;360;360
09762;      Kaufbeuren (Krfr.St);58 bis unter 59;659;324;335
09762;      Kaufbeuren (Krfr.St);59 bis unter 60;656;323;333
09762;      Kaufbeuren (Krfr.St);60 bis unter 61;615;308;307
09762;      Kaufbeuren (Krfr.St);61 bis unter 62;649;321;328
09762;      Kaufbeuren (Krfr.St);62 bis unter 63;559;261;298
09762;      Kaufbeuren (Krfr.St);63 bis unter 64;546;241;305
09762;      Kaufbeuren (Krfr.St);64 bis unter 65;526;244;282
09762;      Kaufbeuren (Krfr.St);65 bis unter 66;498;254;244
09762;      Kaufbeuren (Krfr.St);66 bis unter 67;520;256;264
09762;      Kaufbeuren (Krfr.St);67 bis unter 68;502;251;251
09762;      Kaufbeuren (Krfr.St);68 bis unter 69;519;238;281
09762;      Kaufbeuren (Krfr.St);69 bis unter 70;492;220;272
09762;      Kaufbeuren (Krfr.St);70 bis unter 71;485;223;262
09762;      Kaufbeuren (Krfr.St);71 bis unter 72;448;189;259
09762;      Kaufbeuren (Krfr.St);72 bis unter 73;351;161;190
09762;      Kaufbeuren (Krfr.St);73 bis unter 74;327;155;172
09762;      Kaufbeuren (Krfr.St);74 bis unter 75;388;186;202
09762;      Kaufbeuren (Krfr.St);75 bis unter 76;422;204;218
09762;      Kaufbeuren (Krfr.St);76 bis unter 77;407;196;211
09762;      Kaufbeuren (Krfr.St);77 bis unter 78;505;219;286
09762;      Kaufbeuren (Krfr.St);78 bis unter 79;519;205;314
09762;      Kaufbeuren (Krfr.St);79 bis unter 80;468;194;274
09762;      Kaufbeuren (Krfr.St);80 bis unter 81;401;193;208
09762;      Kaufbeuren (Krfr.St);81 bis unter 82;375;163;212
09762;      Kaufbeuren (Krfr.St);82 bis unter 83;307;119;188
09762;      Kaufbeuren (Krfr.St);83 bis unter 84;312;121;191
09762;      Kaufbeuren (Krfr.St);84 bis unter 85;250;99;151
09762;      Kaufbeuren (Krfr.St);85 bis unter 90;940;340;600
09762;      Kaufbeuren (Krfr.St);90 bis unter 95;451;135;316
09762;      Kaufbeuren (Krfr.St);95 oder älter;155;34;121
09762;      Kaufbeuren (Krfr.St);Insgesamt;43893;21610;22283
09763;      Kempten (Allgäu) (Krfr.St);unter 1;679;352;327
09763;      Kempten (Allgäu) (Krfr.St);1 bis unter 2;688;350;338
09763;      Kempten (Allgäu) (Krfr.St);2 bis unter 3;724;365;359
09763;      Kempten (Allgäu) (Krfr.St);3 bis unter 4;609;321;288
09763;      Kempten (Allgäu) (Krfr.St);4 bis unter 5;573;292;281
09763;      Kempten (Allgäu) (Krfr.St);5 bis unter 6;581;300;281
09763;      Kempten (Allgäu) (Krfr.St);6 bis unter 7;548;270;278
09763;      Kempten (Allgäu) (Krfr.St);7 bis unter 8;504;272;232
09763;      Kempten (Allgäu) (Krfr.St);8 bis unter 9;557;296;261
09763;      Kempten (Allgäu) (Krfr.St);9 bis unter 10;540;277;263
09763;      Kempten (Allgäu) (Krfr.St);10 bis unter 11;586;319;267
09763;      Kempten (Allgäu) (Krfr.St);11 bis unter 12;572;308;264
09763;      Kempten (Allgäu) (Krfr.St);12 bis unter 13;580;311;269
09763;      Kempten (Allgäu) (Krfr.St);13 bis unter 14;579;298;281
09763;      Kempten (Allgäu) (Krfr.St);14 bis unter 15;567;281;286
09763;      Kempten (Allgäu) (Krfr.St);15 bis unter 16;600;310;290
09763;      Kempten (Allgäu) (Krfr.St);16 bis unter 17;610;323;287
09763;      Kempten (Allgäu) (Krfr.St);17 bis unter 18;613;325;288
09763;      Kempten (Allgäu) (Krfr.St);18 bis unter 19;692;349;343
09763;      Kempten (Allgäu) (Krfr.St);19 bis unter 20;752;368;384
09763;      Kempten (Allgäu) (Krfr.St);20 bis unter 21;868;455;413
09763;      Kempten (Allgäu) (Krfr.St);21 bis unter 22;921;473;448
09763;      Kempten (Allgäu) (Krfr.St);22 bis unter 23;937;479;458
09763;      Kempten (Allgäu) (Krfr.St);23 bis unter 24;1036;539;497
09763;      Kempten (Allgäu) (Krfr.St);24 bis unter 25;1011;540;471
09763;      Kempten (Allgäu) (Krfr.St);25 bis unter 26;1057;557;500
09763;      Kempten (Allgäu) (Krfr.St);26 bis unter 27;1067;539;528
09763;      Kempten (Allgäu) (Krfr.St);27 bis unter 28;1118;622;496
09763;      Kempten (Allgäu) (Krfr.St);28 bis unter 29;1109;615;494
09763;      Kempten (Allgäu) (Krfr.St);29 bis unter 30;1048;596;452
09763;      Kempten (Allgäu) (Krfr.St);30 bis unter 31;1028;544;484
09763;      Kempten (Allgäu) (Krfr.St);31 bis unter 32;989;550;439
09763;      Kempten (Allgäu) (Krfr.St);32 bis unter 33;955;508;447
09763;      Kempten (Allgäu) (Krfr.St);33 bis unter 34;878;457;421
09763;      Kempten (Allgäu) (Krfr.St);34 bis unter 35;879;467;412
09763;      Kempten (Allgäu) (Krfr.St);35 bis unter 36;909;495;414
09763;      Kempten (Allgäu) (Krfr.St);36 bis unter 37;895;472;423
09763;      Kempten (Allgäu) (Krfr.St);37 bis unter 38;943;493;450
09763;      Kempten (Allgäu) (Krfr.St);38 bis unter 39;856;449;407
09763;      Kempten (Allgäu) (Krfr.St);39 bis unter 40;829;409;420
09763;      Kempten (Allgäu) (Krfr.St);40 bis unter 41;819;402;417
09763;      Kempten (Allgäu) (Krfr.St);41 bis unter 42;792;408;384
09763;      Kempten (Allgäu) (Krfr.St);42 bis unter 43;820;423;397
09763;      Kempten (Allgäu) (Krfr.St);43 bis unter 44;778;403;375
09763;      Kempten (Allgäu) (Krfr.St);44 bis unter 45;740;380;360
09763;      Kempten (Allgäu) (Krfr.St);45 bis unter 46;760;417;343
09763;      Kempten (Allgäu) (Krfr.St);46 bis unter 47;855;418;437
09763;      Kempten (Allgäu) (Krfr.St);47 bis unter 48;896;444;452
09763;      Kempten (Allgäu) (Krfr.St);48 bis unter 49;876;431;445
09763;      Kempten (Allgäu) (Krfr.St);49 bis unter 50;956;497;459
09763;      Kempten (Allgäu) (Krfr.St);50 bis unter 51;997;542;455
09763;      Kempten (Allgäu) (Krfr.St);51 bis unter 52;1058;514;544
09763;      Kempten (Allgäu) (Krfr.St);52 bis unter 53;1015;505;510
09763;      Kempten (Allgäu) (Krfr.St);53 bis unter 54;943;466;477
09763;      Kempten (Allgäu) (Krfr.St);54 bis unter 55;989;513;476
09763;      Kempten (Allgäu) (Krfr.St);55 bis unter 56;1012;500;512
09763;      Kempten (Allgäu) (Krfr.St);56 bis unter 57;863;389;474
09763;      Kempten (Allgäu) (Krfr.St);57 bis unter 58;971;477;494
09763;      Kempten (Allgäu) (Krfr.St);58 bis unter 59;925;459;466
09763;      Kempten (Allgäu) (Krfr.St);59 bis unter 60;957;465;492
09763;      Kempten (Allgäu) (Krfr.St);60 bis unter 61;827;400;427
09763;      Kempten (Allgäu) (Krfr.St);61 bis unter 62;906;452;454
09763;      Kempten (Allgäu) (Krfr.St);62 bis unter 63;869;400;469
09763;      Kempten (Allgäu) (Krfr.St);63 bis unter 64;813;369;444
09763;      Kempten (Allgäu) (Krfr.St);64 bis unter 65;717;338;379
09763;      Kempten (Allgäu) (Krfr.St);65 bis unter 66;720;341;379
09763;      Kempten (Allgäu) (Krfr.St);66 bis unter 67;734;347;387
09763;      Kempten (Allgäu) (Krfr.St);67 bis unter 68;739;317;422
09763;      Kempten (Allgäu) (Krfr.St);68 bis unter 69;731;321;410
09763;      Kempten (Allgäu) (Krfr.St);69 bis unter 70;743;346;397
09763;      Kempten (Allgäu) (Krfr.St);70 bis unter 71;743;330;413
09763;      Kempten (Allgäu) (Krfr.St);71 bis unter 72;707;326;381
09763;      Kempten (Allgäu) (Krfr.St);72 bis unter 73;644;303;341
09763;      Kempten (Allgäu) (Krfr.St);73 bis unter 74;571;235;336
09763;      Kempten (Allgäu) (Krfr.St);74 bis unter 75;672;288;384
09763;      Kempten (Allgäu) (Krfr.St);75 bis unter 76;681;303;378
09763;      Kempten (Allgäu) (Krfr.St);76 bis unter 77;632;284;348
09763;      Kempten (Allgäu) (Krfr.St);77 bis unter 78;793;361;432
09763;      Kempten (Allgäu) (Krfr.St);78 bis unter 79;824;380;444
09763;      Kempten (Allgäu) (Krfr.St);79 bis unter 80;744;314;430
09763;      Kempten (Allgäu) (Krfr.St);80 bis unter 81;620;252;368
09763;      Kempten (Allgäu) (Krfr.St);81 bis unter 82;514;231;283
09763;      Kempten (Allgäu) (Krfr.St);82 bis unter 83;482;199;283
09763;      Kempten (Allgäu) (Krfr.St);83 bis unter 84;473;181;292
09763;      Kempten (Allgäu) (Krfr.St);84 bis unter 85;394;175;219
09763;      Kempten (Allgäu) (Krfr.St);85 bis unter 90;1329;515;814
09763;      Kempten (Allgäu) (Krfr.St);90 bis unter 95;607;198;409
09763;      Kempten (Allgäu) (Krfr.St);95 oder älter;169;36;133
09763;      Kempten (Allgäu) (Krfr.St);Insgesamt;68907;34141;34766
09764;      Memmingen (Krfr.St);unter 1;451;222;229
09764;      Memmingen (Krfr.St);1 bis unter 2;418;211;207
09764;      Memmingen (Krfr.St);2 bis unter 3;457;233;224
09764;      Memmingen (Krfr.St);3 bis unter 4;397;195;202
09764;      Memmingen (Krfr.St);4 bis unter 5;406;198;208
09764;      Memmingen (Krfr.St);5 bis unter 6;383;198;185
09764;      Memmingen (Krfr.St);6 bis unter 7;429;207;222
09764;      Memmingen (Krfr.St);7 bis unter 8;338;171;167
09764;      Memmingen (Krfr.St);8 bis unter 9;379;189;190
09764;      Memmingen (Krfr.St);9 bis unter 10;368;198;170
09764;      Memmingen (Krfr.St);10 bis unter 11;373;194;179
09764;      Memmingen (Krfr.St);11 bis unter 12;400;192;208
09764;      Memmingen (Krfr.St);12 bis unter 13;391;184;207
09764;      Memmingen (Krfr.St);13 bis unter 14;392;192;200
09764;      Memmingen (Krfr.St);14 bis unter 15;404;206;198
09764;      Memmingen (Krfr.St);15 bis unter 16;455;228;227
09764;      Memmingen (Krfr.St);16 bis unter 17;413;217;196
09764;      Memmingen (Krfr.St);17 bis unter 18;413;215;198
09764;      Memmingen (Krfr.St);18 bis unter 19;502;275;227
09764;      Memmingen (Krfr.St);19 bis unter 20;464;254;210
09764;      Memmingen (Krfr.St);20 bis unter 21;491;272;219
09764;      Memmingen (Krfr.St);21 bis unter 22;480;240;240
09764;      Memmingen (Krfr.St);22 bis unter 23;463;254;209
09764;      Memmingen (Krfr.St);23 bis unter 24;477;245;232
09764;      Memmingen (Krfr.St);24 bis unter 25;508;268;240
09764;      Memmingen (Krfr.St);25 bis unter 26;551;296;255
09764;      Memmingen (Krfr.St);26 bis unter 27;600;331;269
09764;      Memmingen (Krfr.St);27 bis unter 28;597;302;295
09764;      Memmingen (Krfr.St);28 bis unter 29;602;312;290
09764;      Memmingen (Krfr.St);29 bis unter 30;631;331;300
09764;      Memmingen (Krfr.St);30 bis unter 31;604;339;265
09764;      Memmingen (Krfr.St);31 bis unter 32;576;315;261
09764;      Memmingen (Krfr.St);32 bis unter 33;582;296;286
09764;      Memmingen (Krfr.St);33 bis unter 34;530;273;257
09764;      Memmingen (Krfr.St);34 bis unter 35;521;267;254
09764;      Memmingen (Krfr.St);35 bis unter 36;538;279;259
09764;      Memmingen (Krfr.St);36 bis unter 37;537;283;254
09764;      Memmingen (Krfr.St);37 bis unter 38;569;304;265
09764;      Memmingen (Krfr.St);38 bis unter 39;599;313;286
09764;      Memmingen (Krfr.St);39 bis unter 40;536;261;275
09764;      Memmingen (Krfr.St);40 bis unter 41;534;277;257
09764;      Memmingen (Krfr.St);41 bis unter 42;536;283;253
09764;      Memmingen (Krfr.St);42 bis unter 43;519;272;247
09764;      Memmingen (Krfr.St);43 bis unter 44;519;241;278
09764;      Memmingen (Krfr.St);44 bis unter 45;540;296;244
09764;      Memmingen (Krfr.St);45 bis unter 46;521;270;251
09764;      Memmingen (Krfr.St);46 bis unter 47;500;259;241
09764;      Memmingen (Krfr.St);47 bis unter 48;590;308;282
09764;      Memmingen (Krfr.St);48 bis unter 49;585;287;298
09764;      Memmingen (Krfr.St);49 bis unter 50;615;317;298
09764;      Memmingen (Krfr.St);50 bis unter 51;702;354;348
09764;      Memmingen (Krfr.St);51 bis unter 52;730;417;313
09764;      Memmingen (Krfr.St);52 bis unter 53;677;345;332
09764;      Memmingen (Krfr.St);53 bis unter 54;658;345;313
09764;      Memmingen (Krfr.St);54 bis unter 55;745;369;376
09764;      Memmingen (Krfr.St);55 bis unter 56;675;358;317
09764;      Memmingen (Krfr.St);56 bis unter 57;698;345;353
09764;      Memmingen (Krfr.St);57 bis unter 58;676;335;341
09764;      Memmingen (Krfr.St);58 bis unter 59;673;358;315
09764;      Memmingen (Krfr.St);59 bis unter 60;623;304;319
09764;      Memmingen (Krfr.St);60 bis unter 61;614;290;324
09764;      Memmingen (Krfr.St);61 bis unter 62;575;280;295
09764;      Memmingen (Krfr.St);62 bis unter 63;566;277;289
09764;      Memmingen (Krfr.St);63 bis unter 64;553;276;277
09764;      Memmingen (Krfr.St);64 bis unter 65;519;231;288
09764;      Memmingen (Krfr.St);65 bis unter 66;504;240;264
09764;      Memmingen (Krfr.St);66 bis unter 67;519;228;291
09764;      Memmingen (Krfr.St);67 bis unter 68;485;215;270
09764;      Memmingen (Krfr.St);68 bis unter 69;443;213;230
09764;      Memmingen (Krfr.St);69 bis unter 70;434;206;228
09764;      Memmingen (Krfr.St);70 bis unter 71;403;176;227
09764;      Memmingen (Krfr.St);71 bis unter 72;430;210;220
09764;      Memmingen (Krfr.St);72 bis unter 73;374;159;215
09764;      Memmingen (Krfr.St);73 bis unter 74;321;143;178
09764;      Memmingen (Krfr.St);74 bis unter 75;418;198;220
09764;      Memmingen (Krfr.St);75 bis unter 76;414;189;225
09764;      Memmingen (Krfr.St);76 bis unter 77;394;171;223
09764;      Memmingen (Krfr.St);77 bis unter 78;499;227;272
09764;      Memmingen (Krfr.St);78 bis unter 79;484;197;287
09764;      Memmingen (Krfr.St);79 bis unter 80;453;194;259
09764;      Memmingen (Krfr.St);80 bis unter 81;416;208;208
09764;      Memmingen (Krfr.St);81 bis unter 82;355;141;214
09764;      Memmingen (Krfr.St);82 bis unter 83;261;105;156
09764;      Memmingen (Krfr.St);83 bis unter 84;291;122;169
09764;      Memmingen (Krfr.St);84 bis unter 85;249;101;148
09764;      Memmingen (Krfr.St);85 bis unter 90;820;277;543
09764;      Memmingen (Krfr.St);90 bis unter 95;381;108;273
09764;      Memmingen (Krfr.St);95 oder älter;121;28;93
09764;      Memmingen (Krfr.St);Insgesamt;43837;21710;22127
KS097;    Kreisfreie Städte Schwaben;unter 1;4519;2281;2238
KS097;    Kreisfreie Städte Schwaben;1 bis unter 2;4535;2331;2204
KS097;    Kreisfreie Städte Schwaben;2 bis unter 3;4512;2331;2181
KS097;    Kreisfreie Städte Schwaben;3 bis unter 4;4102;2112;1990
KS097;    Kreisfreie Städte Schwaben;4 bis unter 5;4053;1982;2071
KS097;    Kreisfreie Städte Schwaben;5 bis unter 6;3831;1972;1859
KS097;    Kreisfreie Städte Schwaben;6 bis unter 7;3838;1981;1857
KS097;    Kreisfreie Städte Schwaben;7 bis unter 8;3468;1789;1679
KS097;    Kreisfreie Städte Schwaben;8 bis unter 9;3579;1813;1766
KS097;    Kreisfreie Städte Schwaben;9 bis unter 10;3536;1807;1729
KS097;    Kreisfreie Städte Schwaben;10 bis unter 11;3743;1931;1812
KS097;    Kreisfreie Städte Schwaben;11 bis unter 12;3801;1988;1813
KS097;    Kreisfreie Städte Schwaben;12 bis unter 13;3698;1935;1763
KS097;    Kreisfreie Städte Schwaben;13 bis unter 14;3761;1914;1847
KS097;    Kreisfreie Städte Schwaben;14 bis unter 15;3737;1892;1845
KS097;    Kreisfreie Städte Schwaben;15 bis unter 16;3923;1997;1926
KS097;    Kreisfreie Städte Schwaben;16 bis unter 17;3809;1957;1852
KS097;    Kreisfreie Städte Schwaben;17 bis unter 18;3923;2027;1896
KS097;    Kreisfreie Städte Schwaben;18 bis unter 19;4378;2225;2153
KS097;    Kreisfreie Städte Schwaben;19 bis unter 20;5011;2538;2473
KS097;    Kreisfreie Städte Schwaben;20 bis unter 21;5745;2916;2829
KS097;    Kreisfreie Städte Schwaben;21 bis unter 22;5893;2968;2925
KS097;    Kreisfreie Städte Schwaben;22 bis unter 23;6258;3139;3119
KS097;    Kreisfreie Städte Schwaben;23 bis unter 24;6404;3199;3205
KS097;    Kreisfreie Städte Schwaben;24 bis unter 25;6496;3331;3165
KS097;    Kreisfreie Städte Schwaben;25 bis unter 26;7145;3632;3513
KS097;    Kreisfreie Städte Schwaben;26 bis unter 27;7258;3749;3509
KS097;    Kreisfreie Städte Schwaben;27 bis unter 28;7532;3862;3670
KS097;    Kreisfreie Städte Schwaben;28 bis unter 29;7596;4004;3592
KS097;    Kreisfreie Städte Schwaben;29 bis unter 30;7532;3998;3534
KS097;    Kreisfreie Städte Schwaben;30 bis unter 31;7521;3987;3534
KS097;    Kreisfreie Städte Schwaben;31 bis unter 32;7220;3904;3316
KS097;    Kreisfreie Städte Schwaben;32 bis unter 33;6991;3746;3245
KS097;    Kreisfreie Städte Schwaben;33 bis unter 34;6443;3421;3022
KS097;    Kreisfreie Städte Schwaben;34 bis unter 35;6185;3236;2949
KS097;    Kreisfreie Städte Schwaben;35 bis unter 36;6355;3369;2986
KS097;    Kreisfreie Städte Schwaben;36 bis unter 37;6369;3395;2974
KS097;    Kreisfreie Städte Schwaben;37 bis unter 38;6320;3306;3014
KS097;    Kreisfreie Städte Schwaben;38 bis unter 39;6173;3247;2926
KS097;    Kreisfreie Städte Schwaben;39 bis unter 40;5792;2938;2854
KS097;    Kreisfreie Städte Schwaben;40 bis unter 41;5669;2879;2790
KS097;    Kreisfreie Städte Schwaben;41 bis unter 42;5541;2829;2712
KS097;    Kreisfreie Städte Schwaben;42 bis unter 43;5479;2821;2658
KS097;    Kreisfreie Städte Schwaben;43 bis unter 44;5386;2742;2644
KS097;    Kreisfreie Städte Schwaben;44 bis unter 45;5443;2814;2629
KS097;    Kreisfreie Städte Schwaben;45 bis unter 46;5099;2614;2485
KS097;    Kreisfreie Städte Schwaben;46 bis unter 47;5502;2805;2697
KS097;    Kreisfreie Städte Schwaben;47 bis unter 48;5887;2890;2997
KS097;    Kreisfreie Städte Schwaben;48 bis unter 49;5905;2975;2930
KS097;    Kreisfreie Städte Schwaben;49 bis unter 50;6260;3272;2988
KS097;    Kreisfreie Städte Schwaben;50 bis unter 51;6632;3398;3234
KS097;    Kreisfreie Städte Schwaben;51 bis unter 52;6561;3369;3192
KS097;    Kreisfreie Städte Schwaben;52 bis unter 53;6528;3312;3216
KS097;    Kreisfreie Städte Schwaben;53 bis unter 54;6629;3391;3238
KS097;    Kreisfreie Städte Schwaben;54 bis unter 55;6717;3472;3245
KS097;    Kreisfreie Städte Schwaben;55 bis unter 56;6547;3312;3235
KS097;    Kreisfreie Städte Schwaben;56 bis unter 57;6267;3063;3204
KS097;    Kreisfreie Städte Schwaben;57 bis unter 58;6275;3139;3136
KS097;    Kreisfreie Städte Schwaben;58 bis unter 59;6123;3033;3090
KS097;    Kreisfreie Städte Schwaben;59 bis unter 60;5791;2801;2990
KS097;    Kreisfreie Städte Schwaben;60 bis unter 61;5634;2757;2877
KS097;    Kreisfreie Städte Schwaben;61 bis unter 62;5569;2750;2819
KS097;    Kreisfreie Städte Schwaben;62 bis unter 63;5342;2572;2770
KS097;    Kreisfreie Städte Schwaben;63 bis unter 64;5063;2359;2704
KS097;    Kreisfreie Städte Schwaben;64 bis unter 65;4835;2212;2623
KS097;    Kreisfreie Städte Schwaben;65 bis unter 66;4599;2178;2421
KS097;    Kreisfreie Städte Schwaben;66 bis unter 67;4530;2062;2468
KS097;    Kreisfreie Städte Schwaben;67 bis unter 68;4506;2013;2493
KS097;    Kreisfreie Städte Schwaben;68 bis unter 69;4583;2032;2551
KS097;    Kreisfreie Städte Schwaben;69 bis unter 70;4451;2010;2441
KS097;    Kreisfreie Städte Schwaben;70 bis unter 71;4183;1876;2307
KS097;    Kreisfreie Städte Schwaben;71 bis unter 72;4322;1939;2383
KS097;    Kreisfreie Städte Schwaben;72 bis unter 73;3718;1654;2064
KS097;    Kreisfreie Städte Schwaben;73 bis unter 74;3267;1423;1844
KS097;    Kreisfreie Städte Schwaben;74 bis unter 75;4033;1821;2212
KS097;    Kreisfreie Städte Schwaben;75 bis unter 76;3956;1817;2139
KS097;    Kreisfreie Städte Schwaben;76 bis unter 77;3887;1791;2096
KS097;    Kreisfreie Städte Schwaben;77 bis unter 78;4519;1956;2563
KS097;    Kreisfreie Städte Schwaben;78 bis unter 79;4542;1939;2603
KS097;    Kreisfreie Städte Schwaben;79 bis unter 80;4360;1870;2490
KS097;    Kreisfreie Städte Schwaben;80 bis unter 81;3814;1625;2189
KS097;    Kreisfreie Städte Schwaben;81 bis unter 82;3453;1428;2025
KS097;    Kreisfreie Städte Schwaben;82 bis unter 83;3063;1221;1842
KS097;    Kreisfreie Städte Schwaben;83 bis unter 84;2788;1075;1713
KS097;    Kreisfreie Städte Schwaben;84 bis unter 85;2422;927;1495
KS097;    Kreisfreie Städte Schwaben;85 bis unter 90;8286;2921;5365
KS097;    Kreisfreie Städte Schwaben;90 bis unter 95;3727;1075;2652
KS097;    Kreisfreie Städte Schwaben;95 oder älter;1094;235;859
KS097;    Kreisfreie Städte Schwaben;Insgesamt;451772;222619;229153
09771;      Aichach-Friedberg (Lkr);unter 1;1360;721;639
09771;      Aichach-Friedberg (Lkr);1 bis unter 2;1454;738;716
09771;      Aichach-Friedberg (Lkr);2 bis unter 3;1439;721;718
09771;      Aichach-Friedberg (Lkr);3 bis unter 4;1374;707;667
09771;      Aichach-Friedberg (Lkr);4 bis unter 5;1373;699;674
09771;      Aichach-Friedberg (Lkr);5 bis unter 6;1293;642;651
09771;      Aichach-Friedberg (Lkr);6 bis unter 7;1344;695;649
09771;      Aichach-Friedberg (Lkr);7 bis unter 8;1270;630;640
09771;      Aichach-Friedberg (Lkr);8 bis unter 9;1255;621;634
09771;      Aichach-Friedberg (Lkr);9 bis unter 10;1229;644;585
09771;      Aichach-Friedberg (Lkr);10 bis unter 11;1320;677;643
09771;      Aichach-Friedberg (Lkr);11 bis unter 12;1274;624;650
09771;      Aichach-Friedberg (Lkr);12 bis unter 13;1177;607;570
09771;      Aichach-Friedberg (Lkr);13 bis unter 14;1255;675;580
09771;      Aichach-Friedberg (Lkr);14 bis unter 15;1310;657;653
09771;      Aichach-Friedberg (Lkr);15 bis unter 16;1402;709;693
09771;      Aichach-Friedberg (Lkr);16 bis unter 17;1347;698;649
09771;      Aichach-Friedberg (Lkr);17 bis unter 18;1431;725;706
09771;      Aichach-Friedberg (Lkr);18 bis unter 19;1505;806;699
09771;      Aichach-Friedberg (Lkr);19 bis unter 20;1525;777;748
09771;      Aichach-Friedberg (Lkr);20 bis unter 21;1492;778;714
09771;      Aichach-Friedberg (Lkr);21 bis unter 22;1533;826;707
09771;      Aichach-Friedberg (Lkr);22 bis unter 23;1480;780;700
09771;      Aichach-Friedberg (Lkr);23 bis unter 24;1355;723;632
09771;      Aichach-Friedberg (Lkr);24 bis unter 25;1369;724;645
09771;      Aichach-Friedberg (Lkr);25 bis unter 26;1398;771;627
09771;      Aichach-Friedberg (Lkr);26 bis unter 27;1404;715;689
09771;      Aichach-Friedberg (Lkr);27 bis unter 28;1446;773;673
09771;      Aichach-Friedberg (Lkr);28 bis unter 29;1541;830;711
09771;      Aichach-Friedberg (Lkr);29 bis unter 30;1534;821;713
09771;      Aichach-Friedberg (Lkr);30 bis unter 31;1540;772;768
09771;      Aichach-Friedberg (Lkr);31 bis unter 32;1581;807;774
09771;      Aichach-Friedberg (Lkr);32 bis unter 33;1604;822;782
09771;      Aichach-Friedberg (Lkr);33 bis unter 34;1639;791;848
09771;      Aichach-Friedberg (Lkr);34 bis unter 35;1576;817;759
09771;      Aichach-Friedberg (Lkr);35 bis unter 36;1634;815;819
09771;      Aichach-Friedberg (Lkr);36 bis unter 37;1685;831;854
09771;      Aichach-Friedberg (Lkr);37 bis unter 38;1795;891;904
09771;      Aichach-Friedberg (Lkr);38 bis unter 39;1762;883;879
09771;      Aichach-Friedberg (Lkr);39 bis unter 40;1633;809;824
09771;      Aichach-Friedberg (Lkr);40 bis unter 41;1649;833;816
09771;      Aichach-Friedberg (Lkr);41 bis unter 42;1647;858;789
09771;      Aichach-Friedberg (Lkr);42 bis unter 43;1647;818;829
09771;      Aichach-Friedberg (Lkr);43 bis unter 44;1599;822;777
09771;      Aichach-Friedberg (Lkr);44 bis unter 45;1609;836;773
09771;      Aichach-Friedberg (Lkr);45 bis unter 46;1577;790;787
09771;      Aichach-Friedberg (Lkr);46 bis unter 47;1790;896;894
09771;      Aichach-Friedberg (Lkr);47 bis unter 48;1885;931;954
09771;      Aichach-Friedberg (Lkr);48 bis unter 49;1999;1032;967
09771;      Aichach-Friedberg (Lkr);49 bis unter 50;2355;1181;1174
09771;      Aichach-Friedberg (Lkr);50 bis unter 51;2407;1228;1179
09771;      Aichach-Friedberg (Lkr);51 bis unter 52;2330;1155;1175
09771;      Aichach-Friedberg (Lkr);52 bis unter 53;2427;1234;1193
09771;      Aichach-Friedberg (Lkr);53 bis unter 54;2411;1258;1153
09771;      Aichach-Friedberg (Lkr);54 bis unter 55;2466;1266;1200
09771;      Aichach-Friedberg (Lkr);55 bis unter 56;2335;1175;1160
09771;      Aichach-Friedberg (Lkr);56 bis unter 57;2221;1091;1130
09771;      Aichach-Friedberg (Lkr);57 bis unter 58;2166;1128;1038
09771;      Aichach-Friedberg (Lkr);58 bis unter 59;2135;1086;1049
09771;      Aichach-Friedberg (Lkr);59 bis unter 60;2072;1076;996
09771;      Aichach-Friedberg (Lkr);60 bis unter 61;1859;918;941
09771;      Aichach-Friedberg (Lkr);61 bis unter 62;1870;880;990
09771;      Aichach-Friedberg (Lkr);62 bis unter 63;1721;868;853
09771;      Aichach-Friedberg (Lkr);63 bis unter 64;1476;761;715
09771;      Aichach-Friedberg (Lkr);64 bis unter 65;1521;734;787
09771;      Aichach-Friedberg (Lkr);65 bis unter 66;1487;753;734
09771;      Aichach-Friedberg (Lkr);66 bis unter 67;1500;714;786
09771;      Aichach-Friedberg (Lkr);67 bis unter 68;1434;699;735
09771;      Aichach-Friedberg (Lkr);68 bis unter 69;1385;682;703
09771;      Aichach-Friedberg (Lkr);69 bis unter 70;1387;683;704
09771;      Aichach-Friedberg (Lkr);70 bis unter 71;1281;621;660
09771;      Aichach-Friedberg (Lkr);71 bis unter 72;1237;592;645
09771;      Aichach-Friedberg (Lkr);72 bis unter 73;1101;515;586
09771;      Aichach-Friedberg (Lkr);73 bis unter 74;889;429;460
09771;      Aichach-Friedberg (Lkr);74 bis unter 75;1152;541;611
09771;      Aichach-Friedberg (Lkr);75 bis unter 76;1144;545;599
09771;      Aichach-Friedberg (Lkr);76 bis unter 77;1107;534;573
09771;      Aichach-Friedberg (Lkr);77 bis unter 78;1298;591;707
09771;      Aichach-Friedberg (Lkr);78 bis unter 79;1366;640;726
09771;      Aichach-Friedberg (Lkr);79 bis unter 80;1321;595;726
09771;      Aichach-Friedberg (Lkr);80 bis unter 81;1121;477;644
09771;      Aichach-Friedberg (Lkr);81 bis unter 82;972;439;533
09771;      Aichach-Friedberg (Lkr);82 bis unter 83;860;361;499
09771;      Aichach-Friedberg (Lkr);83 bis unter 84;740;322;418
09771;      Aichach-Friedberg (Lkr);84 bis unter 85;647;253;394
09771;      Aichach-Friedberg (Lkr);85 bis unter 90;2095;775;1320
09771;      Aichach-Friedberg (Lkr);90 bis unter 95;786;250;536
09771;      Aichach-Friedberg (Lkr);95 oder älter;174;33;141
09771;      Aichach-Friedberg (Lkr);Insgesamt;133596;66651;66945
09772;      Augsburg (Lkr);unter 1;2513;1275;1238
09772;      Augsburg (Lkr);1 bis unter 2;2642;1320;1322
09772;      Augsburg (Lkr);2 bis unter 3;2622;1359;1263
09772;      Augsburg (Lkr);3 bis unter 4;2546;1325;1221
09772;      Augsburg (Lkr);4 bis unter 5;2468;1255;1213
09772;      Augsburg (Lkr);5 bis unter 6;2454;1243;1211
09772;      Augsburg (Lkr);6 bis unter 7;2459;1310;1149
09772;      Augsburg (Lkr);7 bis unter 8;2302;1157;1145
09772;      Augsburg (Lkr);8 bis unter 9;2315;1164;1151
09772;      Augsburg (Lkr);9 bis unter 10;2285;1215;1070
09772;      Augsburg (Lkr);10 bis unter 11;2421;1216;1205
09772;      Augsburg (Lkr);11 bis unter 12;2325;1205;1120
09772;      Augsburg (Lkr);12 bis unter 13;2323;1220;1103
09772;      Augsburg (Lkr);13 bis unter 14;2312;1202;1110
09772;      Augsburg (Lkr);14 bis unter 15;2462;1244;1218
09772;      Augsburg (Lkr);15 bis unter 16;2494;1278;1216
09772;      Augsburg (Lkr);16 bis unter 17;2550;1291;1259
09772;      Augsburg (Lkr);17 bis unter 18;2680;1377;1303
09772;      Augsburg (Lkr);18 bis unter 19;2712;1441;1271
09772;      Augsburg (Lkr);19 bis unter 20;2782;1523;1259
09772;      Augsburg (Lkr);20 bis unter 21;2770;1471;1299
09772;      Augsburg (Lkr);21 bis unter 22;2805;1437;1368
09772;      Augsburg (Lkr);22 bis unter 23;2673;1412;1261
09772;      Augsburg (Lkr);23 bis unter 24;2620;1488;1132
09772;      Augsburg (Lkr);24 bis unter 25;2550;1348;1202
09772;      Augsburg (Lkr);25 bis unter 26;2724;1451;1273
09772;      Augsburg (Lkr);26 bis unter 27;2689;1383;1306
09772;      Augsburg (Lkr);27 bis unter 28;2744;1435;1309
09772;      Augsburg (Lkr);28 bis unter 29;2925;1509;1416
09772;      Augsburg (Lkr);29 bis unter 30;2894;1525;1369
09772;      Augsburg (Lkr);30 bis unter 31;3034;1577;1457
09772;      Augsburg (Lkr);31 bis unter 32;2848;1412;1436
09772;      Augsburg (Lkr);32 bis unter 33;3101;1540;1561
09772;      Augsburg (Lkr);33 bis unter 34;2928;1511;1417
09772;      Augsburg (Lkr);34 bis unter 35;2998;1487;1511
09772;      Augsburg (Lkr);35 bis unter 36;3012;1542;1470
09772;      Augsburg (Lkr);36 bis unter 37;3166;1590;1576
09772;      Augsburg (Lkr);37 bis unter 38;3232;1575;1657
09772;      Augsburg (Lkr);38 bis unter 39;3324;1757;1567
09772;      Augsburg (Lkr);39 bis unter 40;3024;1492;1532
09772;      Augsburg (Lkr);40 bis unter 41;2975;1503;1472
09772;      Augsburg (Lkr);41 bis unter 42;3128;1546;1582
09772;      Augsburg (Lkr);42 bis unter 43;3109;1573;1536
09772;      Augsburg (Lkr);43 bis unter 44;3036;1488;1548
09772;      Augsburg (Lkr);44 bis unter 45;3044;1491;1553
09772;      Augsburg (Lkr);45 bis unter 46;2977;1514;1463
09772;      Augsburg (Lkr);46 bis unter 47;3363;1721;1642
09772;      Augsburg (Lkr);47 bis unter 48;3544;1785;1759
09772;      Augsburg (Lkr);48 bis unter 49;3756;1898;1858
09772;      Augsburg (Lkr);49 bis unter 50;4078;2034;2044
09772;      Augsburg (Lkr);50 bis unter 51;4371;2131;2240
09772;      Augsburg (Lkr);51 bis unter 52;4473;2276;2197
09772;      Augsburg (Lkr);52 bis unter 53;4511;2238;2273
09772;      Augsburg (Lkr);53 bis unter 54;4461;2284;2177
09772;      Augsburg (Lkr);54 bis unter 55;4494;2239;2255
09772;      Augsburg (Lkr);55 bis unter 56;4450;2247;2203
09772;      Augsburg (Lkr);56 bis unter 57;4217;2126;2091
09772;      Augsburg (Lkr);57 bis unter 58;4073;2042;2031
09772;      Augsburg (Lkr);58 bis unter 59;3946;2007;1939
09772;      Augsburg (Lkr);59 bis unter 60;3707;1879;1828
09772;      Augsburg (Lkr);60 bis unter 61;3629;1808;1821
09772;      Augsburg (Lkr);61 bis unter 62;3498;1746;1752
09772;      Augsburg (Lkr);62 bis unter 63;3257;1599;1658
09772;      Augsburg (Lkr);63 bis unter 64;3123;1522;1601
09772;      Augsburg (Lkr);64 bis unter 65;3028;1463;1565
09772;      Augsburg (Lkr);65 bis unter 66;2882;1421;1461
09772;      Augsburg (Lkr);66 bis unter 67;2836;1344;1492
09772;      Augsburg (Lkr);67 bis unter 68;2757;1287;1470
09772;      Augsburg (Lkr);68 bis unter 69;2646;1269;1377
09772;      Augsburg (Lkr);69 bis unter 70;2708;1296;1412
09772;      Augsburg (Lkr);70 bis unter 71;2429;1123;1306
09772;      Augsburg (Lkr);71 bis unter 72;2474;1224;1250
09772;      Augsburg (Lkr);72 bis unter 73;2213;1071;1142
09772;      Augsburg (Lkr);73 bis unter 74;1805;853;952
09772;      Augsburg (Lkr);74 bis unter 75;2206;1051;1155
09772;      Augsburg (Lkr);75 bis unter 76;2233;1030;1203
09772;      Augsburg (Lkr);76 bis unter 77;2139;1024;1115
09772;      Augsburg (Lkr);77 bis unter 78;2646;1206;1440
09772;      Augsburg (Lkr);78 bis unter 79;2603;1163;1440
09772;      Augsburg (Lkr);79 bis unter 80;2438;1091;1347
09772;      Augsburg (Lkr);80 bis unter 81;2059;964;1095
09772;      Augsburg (Lkr);81 bis unter 82;1795;767;1028
09772;      Augsburg (Lkr);82 bis unter 83;1628;683;945
09772;      Augsburg (Lkr);83 bis unter 84;1484;572;912
09772;      Augsburg (Lkr);84 bis unter 85;1236;516;720
09772;      Augsburg (Lkr);85 bis unter 90;4177;1499;2678
09772;      Augsburg (Lkr);90 bis unter 95;1737;541;1196
09772;      Augsburg (Lkr);95 oder älter;427;90;337
09772;      Augsburg (Lkr);Insgesamt;251534;124807;126727
09773;      Dillingen a.d.Donau (Lkr);unter 1;902;460;442
09773;      Dillingen a.d.Donau (Lkr);1 bis unter 2;914;457;457
09773;      Dillingen a.d.Donau (Lkr);2 bis unter 3;925;497;428
09773;      Dillingen a.d.Donau (Lkr);3 bis unter 4;922;464;458
09773;      Dillingen a.d.Donau (Lkr);4 bis unter 5;883;459;424
09773;      Dillingen a.d.Donau (Lkr);5 bis unter 6;841;441;400
09773;      Dillingen a.d.Donau (Lkr);6 bis unter 7;853;433;420
09773;      Dillingen a.d.Donau (Lkr);7 bis unter 8;868;463;405
09773;      Dillingen a.d.Donau (Lkr);8 bis unter 9;858;439;419
09773;      Dillingen a.d.Donau (Lkr);9 bis unter 10;920;471;449
09773;      Dillingen a.d.Donau (Lkr);10 bis unter 11;862;437;425
09773;      Dillingen a.d.Donau (Lkr);11 bis unter 12;852;425;427
09773;      Dillingen a.d.Donau (Lkr);12 bis unter 13;899;456;443
09773;      Dillingen a.d.Donau (Lkr);13 bis unter 14;936;475;461
09773;      Dillingen a.d.Donau (Lkr);14 bis unter 15;948;498;450
09773;      Dillingen a.d.Donau (Lkr);15 bis unter 16;992;497;495
09773;      Dillingen a.d.Donau (Lkr);16 bis unter 17;1021;533;488
09773;      Dillingen a.d.Donau (Lkr);17 bis unter 18;1007;522;485
09773;      Dillingen a.d.Donau (Lkr);18 bis unter 19;1062;546;516
09773;      Dillingen a.d.Donau (Lkr);19 bis unter 20;1173;623;550
09773;      Dillingen a.d.Donau (Lkr);20 bis unter 21;1058;563;495
09773;      Dillingen a.d.Donau (Lkr);21 bis unter 22;1107;617;490
09773;      Dillingen a.d.Donau (Lkr);22 bis unter 23;1092;588;504
09773;      Dillingen a.d.Donau (Lkr);23 bis unter 24;1151;615;536
09773;      Dillingen a.d.Donau (Lkr);24 bis unter 25;1076;564;512
09773;      Dillingen a.d.Donau (Lkr);25 bis unter 26;1123;595;528
09773;      Dillingen a.d.Donau (Lkr);26 bis unter 27;1193;613;580
09773;      Dillingen a.d.Donau (Lkr);27 bis unter 28;1156;634;522
09773;      Dillingen a.d.Donau (Lkr);28 bis unter 29;1178;626;552
09773;      Dillingen a.d.Donau (Lkr);29 bis unter 30;1161;616;545
09773;      Dillingen a.d.Donau (Lkr);30 bis unter 31;1230;621;609
09773;      Dillingen a.d.Donau (Lkr);31 bis unter 32;1200;677;523
09773;      Dillingen a.d.Donau (Lkr);32 bis unter 33;1116;584;532
09773;      Dillingen a.d.Donau (Lkr);33 bis unter 34;1080;557;523
09773;      Dillingen a.d.Donau (Lkr);34 bis unter 35;1145;594;551
09773;      Dillingen a.d.Donau (Lkr);35 bis unter 36;1087;561;526
09773;      Dillingen a.d.Donau (Lkr);36 bis unter 37;1157;615;542
09773;      Dillingen a.d.Donau (Lkr);37 bis unter 38;1161;600;561
09773;      Dillingen a.d.Donau (Lkr);38 bis unter 39;1174;600;574
09773;      Dillingen a.d.Donau (Lkr);39 bis unter 40;1062;542;520
09773;      Dillingen a.d.Donau (Lkr);40 bis unter 41;1143;585;558
09773;      Dillingen a.d.Donau (Lkr);41 bis unter 42;1160;562;598
09773;      Dillingen a.d.Donau (Lkr);42 bis unter 43;1131;571;560
09773;      Dillingen a.d.Donau (Lkr);43 bis unter 44;1168;606;562
09773;      Dillingen a.d.Donau (Lkr);44 bis unter 45;1137;591;546
09773;      Dillingen a.d.Donau (Lkr);45 bis unter 46;1182;578;604
09773;      Dillingen a.d.Donau (Lkr);46 bis unter 47;1275;632;643
09773;      Dillingen a.d.Donau (Lkr);47 bis unter 48;1329;686;643
09773;      Dillingen a.d.Donau (Lkr);48 bis unter 49;1420;726;694
09773;      Dillingen a.d.Donau (Lkr);49 bis unter 50;1575;818;757
09773;      Dillingen a.d.Donau (Lkr);50 bis unter 51;1639;853;786
09773;      Dillingen a.d.Donau (Lkr);51 bis unter 52;1602;800;802
09773;      Dillingen a.d.Donau (Lkr);52 bis unter 53;1661;806;855
09773;      Dillingen a.d.Donau (Lkr);53 bis unter 54;1709;874;835
09773;      Dillingen a.d.Donau (Lkr);54 bis unter 55;1613;848;765
09773;      Dillingen a.d.Donau (Lkr);55 bis unter 56;1676;847;829
09773;      Dillingen a.d.Donau (Lkr);56 bis unter 57;1638;826;812
09773;      Dillingen a.d.Donau (Lkr);57 bis unter 58;1595;805;790
09773;      Dillingen a.d.Donau (Lkr);58 bis unter 59;1559;781;778
09773;      Dillingen a.d.Donau (Lkr);59 bis unter 60;1457;746;711
09773;      Dillingen a.d.Donau (Lkr);60 bis unter 61;1483;724;759
09773;      Dillingen a.d.Donau (Lkr);61 bis unter 62;1362;682;680
09773;      Dillingen a.d.Donau (Lkr);62 bis unter 63;1356;684;672
09773;      Dillingen a.d.Donau (Lkr);63 bis unter 64;1290;647;643
09773;      Dillingen a.d.Donau (Lkr);64 bis unter 65;1181;601;580
09773;      Dillingen a.d.Donau (Lkr);65 bis unter 66;1157;543;614
09773;      Dillingen a.d.Donau (Lkr);66 bis unter 67;1122;536;586
09773;      Dillingen a.d.Donau (Lkr);67 bis unter 68;1056;532;524
09773;      Dillingen a.d.Donau (Lkr);68 bis unter 69;1063;541;522
09773;      Dillingen a.d.Donau (Lkr);69 bis unter 70;1038;501;537
09773;      Dillingen a.d.Donau (Lkr);70 bis unter 71;995;502;493
09773;      Dillingen a.d.Donau (Lkr);71 bis unter 72;871;419;452
09773;      Dillingen a.d.Donau (Lkr);72 bis unter 73;762;345;417
09773;      Dillingen a.d.Donau (Lkr);73 bis unter 74;599;267;332
09773;      Dillingen a.d.Donau (Lkr);74 bis unter 75;723;366;357
09773;      Dillingen a.d.Donau (Lkr);75 bis unter 76;760;343;417
09773;      Dillingen a.d.Donau (Lkr);76 bis unter 77;757;352;405
09773;      Dillingen a.d.Donau (Lkr);77 bis unter 78;850;438;412
09773;      Dillingen a.d.Donau (Lkr);78 bis unter 79;887;418;469
09773;      Dillingen a.d.Donau (Lkr);79 bis unter 80;934;422;512
09773;      Dillingen a.d.Donau (Lkr);80 bis unter 81;780;339;441
09773;      Dillingen a.d.Donau (Lkr);81 bis unter 82;674;288;386
09773;      Dillingen a.d.Donau (Lkr);82 bis unter 83;693;284;409
09773;      Dillingen a.d.Donau (Lkr);83 bis unter 84;587;244;343
09773;      Dillingen a.d.Donau (Lkr);84 bis unter 85;468;192;276
09773;      Dillingen a.d.Donau (Lkr);85 bis unter 90;1708;596;1112
09773;      Dillingen a.d.Donau (Lkr);90 bis unter 95;674;183;491
09773;      Dillingen a.d.Donau (Lkr);95 oder älter;177;27;150
09773;      Dillingen a.d.Donau (Lkr);Insgesamt;96021;48135;47886
09774;      Günzburg (Lkr);unter 1;1242;654;588
09774;      Günzburg (Lkr);1 bis unter 2;1242;628;614
09774;      Günzburg (Lkr);2 bis unter 3;1209;636;573
09774;      Günzburg (Lkr);3 bis unter 4;1215;646;569
09774;      Günzburg (Lkr);4 bis unter 5;1170;597;573
09774;      Günzburg (Lkr);5 bis unter 6;1147;593;554
09774;      Günzburg (Lkr);6 bis unter 7;1104;583;521
09774;      Günzburg (Lkr);7 bis unter 8;1106;572;534
09774;      Günzburg (Lkr);8 bis unter 9;1169;605;564
09774;      Günzburg (Lkr);9 bis unter 10;1131;579;552
09774;      Günzburg (Lkr);10 bis unter 11;1148;606;542
09774;      Günzburg (Lkr);11 bis unter 12;1155;596;559
09774;      Günzburg (Lkr);12 bis unter 13;1138;575;563
09774;      Günzburg (Lkr);13 bis unter 14;1226;644;582
09774;      Günzburg (Lkr);14 bis unter 15;1232;619;613
09774;      Günzburg (Lkr);15 bis unter 16;1296;665;631
09774;      Günzburg (Lkr);16 bis unter 17;1285;677;608
09774;      Günzburg (Lkr);17 bis unter 18;1348;710;638
09774;      Günzburg (Lkr);18 bis unter 19;1403;713;690
09774;      Günzburg (Lkr);19 bis unter 20;1454;831;623
09774;      Günzburg (Lkr);20 bis unter 21;1406;792;614
09774;      Günzburg (Lkr);21 bis unter 22;1535;795;740
09774;      Günzburg (Lkr);22 bis unter 23;1489;807;682
09774;      Günzburg (Lkr);23 bis unter 24;1435;769;666
09774;      Günzburg (Lkr);24 bis unter 25;1448;795;653
09774;      Günzburg (Lkr);25 bis unter 26;1539;820;719
09774;      Günzburg (Lkr);26 bis unter 27;1621;884;737
09774;      Günzburg (Lkr);27 bis unter 28;1587;876;711
09774;      Günzburg (Lkr);28 bis unter 29;1672;891;781
09774;      Günzburg (Lkr);29 bis unter 30;1582;826;756
09774;      Günzburg (Lkr);30 bis unter 31;1677;886;791
09774;      Günzburg (Lkr);31 bis unter 32;1574;848;726
09774;      Günzburg (Lkr);32 bis unter 33;1608;869;739
09774;      Günzburg (Lkr);33 bis unter 34;1436;756;680
09774;      Günzburg (Lkr);34 bis unter 35;1533;818;715
09774;      Günzburg (Lkr);35 bis unter 36;1549;805;744
09774;      Günzburg (Lkr);36 bis unter 37;1494;758;736
09774;      Günzburg (Lkr);37 bis unter 38;1585;804;781
09774;      Günzburg (Lkr);38 bis unter 39;1506;753;753
09774;      Günzburg (Lkr);39 bis unter 40;1518;782;736
09774;      Günzburg (Lkr);40 bis unter 41;1538;801;737
09774;      Günzburg (Lkr);41 bis unter 42;1549;795;754
09774;      Günzburg (Lkr);42 bis unter 43;1516;784;732
09774;      Günzburg (Lkr);43 bis unter 44;1531;785;746
09774;      Günzburg (Lkr);44 bis unter 45;1603;846;757
09774;      Günzburg (Lkr);45 bis unter 46;1612;785;827
09774;      Günzburg (Lkr);46 bis unter 47;1619;825;794
09774;      Günzburg (Lkr);47 bis unter 48;1797;890;907
09774;      Günzburg (Lkr);48 bis unter 49;1858;929;929
09774;      Günzburg (Lkr);49 bis unter 50;2076;1047;1029
09774;      Günzburg (Lkr);50 bis unter 51;2085;1050;1035
09774;      Günzburg (Lkr);51 bis unter 52;2082;1099;983
09774;      Günzburg (Lkr);52 bis unter 53;2213;1121;1092
09774;      Günzburg (Lkr);53 bis unter 54;2116;1084;1032
09774;      Günzburg (Lkr);54 bis unter 55;2249;1151;1098
09774;      Günzburg (Lkr);55 bis unter 56;2147;1091;1056
09774;      Günzburg (Lkr);56 bis unter 57;2158;1115;1043
09774;      Günzburg (Lkr);57 bis unter 58;2075;1026;1049
09774;      Günzburg (Lkr);58 bis unter 59;1969;981;988
09774;      Günzburg (Lkr);59 bis unter 60;1987;1001;986
09774;      Günzburg (Lkr);60 bis unter 61;1792;861;931
09774;      Günzburg (Lkr);61 bis unter 62;1792;918;874
09774;      Günzburg (Lkr);62 bis unter 63;1682;861;821
09774;      Günzburg (Lkr);63 bis unter 64;1610;794;816
09774;      Günzburg (Lkr);64 bis unter 65;1504;736;768
09774;      Günzburg (Lkr);65 bis unter 66;1440;730;710
09774;      Günzburg (Lkr);66 bis unter 67;1445;735;710
09774;      Günzburg (Lkr);67 bis unter 68;1292;679;613
09774;      Günzburg (Lkr);68 bis unter 69;1333;662;671
09774;      Günzburg (Lkr);69 bis unter 70;1270;621;649
09774;      Günzburg (Lkr);70 bis unter 71;1213;597;616
09774;      Günzburg (Lkr);71 bis unter 72;1127;553;574
09774;      Günzburg (Lkr);72 bis unter 73;979;478;501
09774;      Günzburg (Lkr);73 bis unter 74;733;369;364
09774;      Günzburg (Lkr);74 bis unter 75;974;474;500
09774;      Günzburg (Lkr);75 bis unter 76;1042;501;541
09774;      Günzburg (Lkr);76 bis unter 77;947;455;492
09774;      Günzburg (Lkr);77 bis unter 78;1144;557;587
09774;      Günzburg (Lkr);78 bis unter 79;1229;554;675
09774;      Günzburg (Lkr);79 bis unter 80;1149;505;644
09774;      Günzburg (Lkr);80 bis unter 81;978;437;541
09774;      Günzburg (Lkr);81 bis unter 82;895;365;530
09774;      Günzburg (Lkr);82 bis unter 83;848;363;485
09774;      Günzburg (Lkr);83 bis unter 84;737;286;451
09774;      Günzburg (Lkr);84 bis unter 85;593;244;349
09774;      Günzburg (Lkr);85 bis unter 90;1985;706;1279
09774;      Günzburg (Lkr);90 bis unter 95;803;226;577
09774;      Günzburg (Lkr);95 oder älter;217;40;177
09774;      Günzburg (Lkr);Insgesamt;125747;63576;62171
09775;      Neu-Ulm (Lkr);unter 1;1686;855;831
09775;      Neu-Ulm (Lkr);1 bis unter 2;1751;932;819
09775;      Neu-Ulm (Lkr);2 bis unter 3;1756;864;892
09775;      Neu-Ulm (Lkr);3 bis unter 4;1638;870;768
09775;      Neu-Ulm (Lkr);4 bis unter 5;1619;817;802
09775;      Neu-Ulm (Lkr);5 bis unter 6;1577;800;777
09775;      Neu-Ulm (Lkr);6 bis unter 7;1577;823;754
09775;      Neu-Ulm (Lkr);7 bis unter 8;1575;832;743
09775;      Neu-Ulm (Lkr);8 bis unter 9;1644;828;816
09775;      Neu-Ulm (Lkr);9 bis unter 10;1582;778;804
09775;      Neu-Ulm (Lkr);10 bis unter 11;1593;797;796
09775;      Neu-Ulm (Lkr);11 bis unter 12;1647;804;843
09775;      Neu-Ulm (Lkr);12 bis unter 13;1551;788;763
09775;      Neu-Ulm (Lkr);13 bis unter 14;1570;769;801
09775;      Neu-Ulm (Lkr);14 bis unter 15;1651;835;816
09775;      Neu-Ulm (Lkr);15 bis unter 16;1710;912;798
09775;      Neu-Ulm (Lkr);16 bis unter 17;1726;885;841
09775;      Neu-Ulm (Lkr);17 bis unter 18;1798;906;892
09775;      Neu-Ulm (Lkr);18 bis unter 19;1835;945;890
09775;      Neu-Ulm (Lkr);19 bis unter 20;1959;1074;885
09775;      Neu-Ulm (Lkr);20 bis unter 21;1988;1038;950
09775;      Neu-Ulm (Lkr);21 bis unter 22;2104;1141;963
09775;      Neu-Ulm (Lkr);22 bis unter 23;2035;1026;1009
09775;      Neu-Ulm (Lkr);23 bis unter 24;2024;1079;945
09775;      Neu-Ulm (Lkr);24 bis unter 25;2082;1133;949
09775;      Neu-Ulm (Lkr);25 bis unter 26;2103;1104;999
09775;      Neu-Ulm (Lkr);26 bis unter 27;2178;1142;1036
09775;      Neu-Ulm (Lkr);27 bis unter 28;2147;1143;1004
09775;      Neu-Ulm (Lkr);28 bis unter 29;2336;1208;1128
09775;      Neu-Ulm (Lkr);29 bis unter 30;2319;1139;1180
09775;      Neu-Ulm (Lkr);30 bis unter 31;2399;1249;1150
09775;      Neu-Ulm (Lkr);31 bis unter 32;2247;1180;1067
09775;      Neu-Ulm (Lkr);32 bis unter 33;2288;1179;1109
09775;      Neu-Ulm (Lkr);33 bis unter 34;2214;1155;1059
09775;      Neu-Ulm (Lkr);34 bis unter 35;2313;1174;1139
09775;      Neu-Ulm (Lkr);35 bis unter 36;2288;1178;1110
09775;      Neu-Ulm (Lkr);36 bis unter 37;2306;1162;1144
09775;      Neu-Ulm (Lkr);37 bis unter 38;2436;1243;1193
09775;      Neu-Ulm (Lkr);38 bis unter 39;2258;1127;1131
09775;      Neu-Ulm (Lkr);39 bis unter 40;2187;1152;1035
09775;      Neu-Ulm (Lkr);40 bis unter 41;2081;1046;1035
09775;      Neu-Ulm (Lkr);41 bis unter 42;2204;1112;1092
09775;      Neu-Ulm (Lkr);42 bis unter 43;2058;1015;1043
09775;      Neu-Ulm (Lkr);43 bis unter 44;2067;1081;986
09775;      Neu-Ulm (Lkr);44 bis unter 45;2191;1122;1069
09775;      Neu-Ulm (Lkr);45 bis unter 46;2127;1052;1075
09775;      Neu-Ulm (Lkr);46 bis unter 47;2346;1163;1183
09775;      Neu-Ulm (Lkr);47 bis unter 48;2446;1265;1181
09775;      Neu-Ulm (Lkr);48 bis unter 49;2586;1293;1293
09775;      Neu-Ulm (Lkr);49 bis unter 50;2722;1379;1343
09775;      Neu-Ulm (Lkr);50 bis unter 51;2760;1394;1366
09775;      Neu-Ulm (Lkr);51 bis unter 52;2808;1449;1359
09775;      Neu-Ulm (Lkr);52 bis unter 53;2781;1410;1371
09775;      Neu-Ulm (Lkr);53 bis unter 54;2858;1427;1431
09775;      Neu-Ulm (Lkr);54 bis unter 55;2843;1436;1407
09775;      Neu-Ulm (Lkr);55 bis unter 56;2810;1412;1398
09775;      Neu-Ulm (Lkr);56 bis unter 57;2791;1413;1378
09775;      Neu-Ulm (Lkr);57 bis unter 58;2681;1360;1321
09775;      Neu-Ulm (Lkr);58 bis unter 59;2599;1283;1316
09775;      Neu-Ulm (Lkr);59 bis unter 60;2489;1221;1268
09775;      Neu-Ulm (Lkr);60 bis unter 61;2345;1219;1126
09775;      Neu-Ulm (Lkr);61 bis unter 62;2355;1147;1208
09775;      Neu-Ulm (Lkr);62 bis unter 63;2243;1079;1164
09775;      Neu-Ulm (Lkr);63 bis unter 64;2124;1036;1088
09775;      Neu-Ulm (Lkr);64 bis unter 65;2003;931;1072
09775;      Neu-Ulm (Lkr);65 bis unter 66;1967;984;983
09775;      Neu-Ulm (Lkr);66 bis unter 67;1927;848;1079
09775;      Neu-Ulm (Lkr);67 bis unter 68;1907;898;1009
09775;      Neu-Ulm (Lkr);68 bis unter 69;1832;892;940
09775;      Neu-Ulm (Lkr);69 bis unter 70;1795;877;918
09775;      Neu-Ulm (Lkr);70 bis unter 71;1703;829;874
09775;      Neu-Ulm (Lkr);71 bis unter 72;1554;739;815
09775;      Neu-Ulm (Lkr);72 bis unter 73;1414;664;750
09775;      Neu-Ulm (Lkr);73 bis unter 74;1138;536;602
09775;      Neu-Ulm (Lkr);74 bis unter 75;1502;714;788
09775;      Neu-Ulm (Lkr);75 bis unter 76;1562;720;842
09775;      Neu-Ulm (Lkr);76 bis unter 77;1522;678;844
09775;      Neu-Ulm (Lkr);77 bis unter 78;1722;817;905
09775;      Neu-Ulm (Lkr);78 bis unter 79;1862;858;1004
09775;      Neu-Ulm (Lkr);79 bis unter 80;1625;700;925
09775;      Neu-Ulm (Lkr);80 bis unter 81;1484;644;840
09775;      Neu-Ulm (Lkr);81 bis unter 82;1288;551;737
09775;      Neu-Ulm (Lkr);82 bis unter 83;1122;473;649
09775;      Neu-Ulm (Lkr);83 bis unter 84;1058;446;612
09775;      Neu-Ulm (Lkr);84 bis unter 85;880;348;532
09775;      Neu-Ulm (Lkr);85 bis unter 90;2825;1049;1776
09775;      Neu-Ulm (Lkr);90 bis unter 95;1230;344;886
09775;      Neu-Ulm (Lkr);95 oder älter;266;50;216
09775;      Neu-Ulm (Lkr);Insgesamt;174200;86470;87730
09776;      Lindau (Bodensee) (Lkr);unter 1;724;361;363
09776;      Lindau (Bodensee) (Lkr);1 bis unter 2;796;420;376
09776;      Lindau (Bodensee) (Lkr);2 bis unter 3;742;378;364
09776;      Lindau (Bodensee) (Lkr);3 bis unter 4;776;381;395
09776;      Lindau (Bodensee) (Lkr);4 bis unter 5;732;389;343
09776;      Lindau (Bodensee) (Lkr);5 bis unter 6;678;342;336
09776;      Lindau (Bodensee) (Lkr);6 bis unter 7;706;387;319
09776;      Lindau (Bodensee) (Lkr);7 bis unter 8;672;349;323
09776;      Lindau (Bodensee) (Lkr);8 bis unter 9;685;374;311
09776;      Lindau (Bodensee) (Lkr);9 bis unter 10;702;365;337
09776;      Lindau (Bodensee) (Lkr);10 bis unter 11;692;334;358
09776;      Lindau (Bodensee) (Lkr);11 bis unter 12;745;371;374
09776;      Lindau (Bodensee) (Lkr);12 bis unter 13;710;339;371
09776;      Lindau (Bodensee) (Lkr);13 bis unter 14;760;395;365
09776;      Lindau (Bodensee) (Lkr);14 bis unter 15;779;414;365
09776;      Lindau (Bodensee) (Lkr);15 bis unter 16;811;433;378
09776;      Lindau (Bodensee) (Lkr);16 bis unter 17;843;445;398
09776;      Lindau (Bodensee) (Lkr);17 bis unter 18;916;495;421
09776;      Lindau (Bodensee) (Lkr);18 bis unter 19;907;472;435
09776;      Lindau (Bodensee) (Lkr);19 bis unter 20;925;523;402
09776;      Lindau (Bodensee) (Lkr);20 bis unter 21;859;435;424
09776;      Lindau (Bodensee) (Lkr);21 bis unter 22;877;495;382
09776;      Lindau (Bodensee) (Lkr);22 bis unter 23;840;428;412
09776;      Lindau (Bodensee) (Lkr);23 bis unter 24;831;431;400
09776;      Lindau (Bodensee) (Lkr);24 bis unter 25;835;449;386
09776;      Lindau (Bodensee) (Lkr);25 bis unter 26;806;429;377
09776;      Lindau (Bodensee) (Lkr);26 bis unter 27;892;460;432
09776;      Lindau (Bodensee) (Lkr);27 bis unter 28;905;463;442
09776;      Lindau (Bodensee) (Lkr);28 bis unter 29;951;485;466
09776;      Lindau (Bodensee) (Lkr);29 bis unter 30;955;498;457
09776;      Lindau (Bodensee) (Lkr);30 bis unter 31;995;514;481
09776;      Lindau (Bodensee) (Lkr);31 bis unter 32;975;498;477
09776;      Lindau (Bodensee) (Lkr);32 bis unter 33;1000;541;459
09776;      Lindau (Bodensee) (Lkr);33 bis unter 34;947;485;462
09776;      Lindau (Bodensee) (Lkr);34 bis unter 35;926;487;439
09776;      Lindau (Bodensee) (Lkr);35 bis unter 36;1029;530;499
09776;      Lindau (Bodensee) (Lkr);36 bis unter 37;987;521;466
09776;      Lindau (Bodensee) (Lkr);37 bis unter 38;957;463;494
09776;      Lindau (Bodensee) (Lkr);38 bis unter 39;957;486;471
09776;      Lindau (Bodensee) (Lkr);39 bis unter 40;1006;494;512
09776;      Lindau (Bodensee) (Lkr);40 bis unter 41;911;448;463
09776;      Lindau (Bodensee) (Lkr);41 bis unter 42;958;488;470
09776;      Lindau (Bodensee) (Lkr);42 bis unter 43;887;442;445
09776;      Lindau (Bodensee) (Lkr);43 bis unter 44;900;444;456
09776;      Lindau (Bodensee) (Lkr);44 bis unter 45;928;440;488
09776;      Lindau (Bodensee) (Lkr);45 bis unter 46;945;447;498
09776;      Lindau (Bodensee) (Lkr);46 bis unter 47;1042;500;542
09776;      Lindau (Bodensee) (Lkr);47 bis unter 48;1150;544;606
09776;      Lindau (Bodensee) (Lkr);48 bis unter 49;1246;635;611
09776;      Lindau (Bodensee) (Lkr);49 bis unter 50;1335;615;720
09776;      Lindau (Bodensee) (Lkr);50 bis unter 51;1418;722;696
09776;      Lindau (Bodensee) (Lkr);51 bis unter 52;1415;714;701
09776;      Lindau (Bodensee) (Lkr);52 bis unter 53;1505;744;761
09776;      Lindau (Bodensee) (Lkr);53 bis unter 54;1428;731;697
09776;      Lindau (Bodensee) (Lkr);54 bis unter 55;1462;711;751
09776;      Lindau (Bodensee) (Lkr);55 bis unter 56;1426;678;748
09776;      Lindau (Bodensee) (Lkr);56 bis unter 57;1408;699;709
09776;      Lindau (Bodensee) (Lkr);57 bis unter 58;1359;684;675
09776;      Lindau (Bodensee) (Lkr);58 bis unter 59;1268;652;616
09776;      Lindau (Bodensee) (Lkr);59 bis unter 60;1255;613;642
09776;      Lindau (Bodensee) (Lkr);60 bis unter 61;1108;571;537
09776;      Lindau (Bodensee) (Lkr);61 bis unter 62;1098;515;583
09776;      Lindau (Bodensee) (Lkr);62 bis unter 63;1079;556;523
09776;      Lindau (Bodensee) (Lkr);63 bis unter 64;910;436;474
09776;      Lindau (Bodensee) (Lkr);64 bis unter 65;941;467;474
09776;      Lindau (Bodensee) (Lkr);65 bis unter 66;938;458;480
09776;      Lindau (Bodensee) (Lkr);66 bis unter 67;887;441;446
09776;      Lindau (Bodensee) (Lkr);67 bis unter 68;867;399;468
09776;      Lindau (Bodensee) (Lkr);68 bis unter 69;929;411;518
09776;      Lindau (Bodensee) (Lkr);69 bis unter 70;940;450;490
09776;      Lindau (Bodensee) (Lkr);70 bis unter 71;838;396;442
09776;      Lindau (Bodensee) (Lkr);71 bis unter 72;811;406;405
09776;      Lindau (Bodensee) (Lkr);72 bis unter 73;738;367;371
09776;      Lindau (Bodensee) (Lkr);73 bis unter 74;622;276;346
09776;      Lindau (Bodensee) (Lkr);74 bis unter 75;782;363;419
09776;      Lindau (Bodensee) (Lkr);75 bis unter 76;874;417;457
09776;      Lindau (Bodensee) (Lkr);76 bis unter 77;821;362;459
09776;      Lindau (Bodensee) (Lkr);77 bis unter 78;962;438;524
09776;      Lindau (Bodensee) (Lkr);78 bis unter 79;957;460;497
09776;      Lindau (Bodensee) (Lkr);79 bis unter 80;919;413;506
09776;      Lindau (Bodensee) (Lkr);80 bis unter 81;757;348;409
09776;      Lindau (Bodensee) (Lkr);81 bis unter 82;679;289;390
09776;      Lindau (Bodensee) (Lkr);82 bis unter 83;621;257;364
09776;      Lindau (Bodensee) (Lkr);83 bis unter 84;590;247;343
09776;      Lindau (Bodensee) (Lkr);84 bis unter 85;482;200;282
09776;      Lindau (Bodensee) (Lkr);85 bis unter 90;1538;565;973
09776;      Lindau (Bodensee) (Lkr);90 bis unter 95;744;231;513
09776;      Lindau (Bodensee) (Lkr);95 oder älter;160;36;124
09776;      Lindau (Bodensee) (Lkr);Insgesamt;81669;40285;41384
09777;      Ostallgäu (Lkr);unter 1;1437;760;677
09777;      Ostallgäu (Lkr);1 bis unter 2;1464;739;725
09777;      Ostallgäu (Lkr);2 bis unter 3;1446;727;719
09777;      Ostallgäu (Lkr);3 bis unter 4;1363;686;677
09777;      Ostallgäu (Lkr);4 bis unter 5;1362;733;629
09777;      Ostallgäu (Lkr);5 bis unter 6;1305;642;663
09777;      Ostallgäu (Lkr);6 bis unter 7;1256;647;609
09777;      Ostallgäu (Lkr);7 bis unter 8;1258;649;609
09777;      Ostallgäu (Lkr);8 bis unter 9;1253;624;629
09777;      Ostallgäu (Lkr);9 bis unter 10;1255;602;653
09777;      Ostallgäu (Lkr);10 bis unter 11;1324;671;653
09777;      Ostallgäu (Lkr);11 bis unter 12;1330;669;661
09777;      Ostallgäu (Lkr);12 bis unter 13;1344;680;664
09777;      Ostallgäu (Lkr);13 bis unter 14;1370;704;666
09777;      Ostallgäu (Lkr);14 bis unter 15;1489;740;749
09777;      Ostallgäu (Lkr);15 bis unter 16;1370;714;656
09777;      Ostallgäu (Lkr);16 bis unter 17;1498;797;701
09777;      Ostallgäu (Lkr);17 bis unter 18;1500;751;749
09777;      Ostallgäu (Lkr);18 bis unter 19;1583;822;761
09777;      Ostallgäu (Lkr);19 bis unter 20;1532;823;709
09777;      Ostallgäu (Lkr);20 bis unter 21;1580;831;749
09777;      Ostallgäu (Lkr);21 bis unter 22;1613;857;756
09777;      Ostallgäu (Lkr);22 bis unter 23;1554;828;726
09777;      Ostallgäu (Lkr);23 bis unter 24;1489;802;687
09777;      Ostallgäu (Lkr);24 bis unter 25;1508;843;665
09777;      Ostallgäu (Lkr);25 bis unter 26;1625;856;769
09777;      Ostallgäu (Lkr);26 bis unter 27;1599;822;777
09777;      Ostallgäu (Lkr);27 bis unter 28;1609;823;786
09777;      Ostallgäu (Lkr);28 bis unter 29;1710;917;793
09777;      Ostallgäu (Lkr);29 bis unter 30;1595;842;753
09777;      Ostallgäu (Lkr);30 bis unter 31;1635;886;749
09777;      Ostallgäu (Lkr);31 bis unter 32;1689;875;814
09777;      Ostallgäu (Lkr);32 bis unter 33;1686;880;806
09777;      Ostallgäu (Lkr);33 bis unter 34;1653;858;795
09777;      Ostallgäu (Lkr);34 bis unter 35;1651;825;826
09777;      Ostallgäu (Lkr);35 bis unter 36;1720;859;861
09777;      Ostallgäu (Lkr);36 bis unter 37;1729;867;862
09777;      Ostallgäu (Lkr);37 bis unter 38;1676;820;856
09777;      Ostallgäu (Lkr);38 bis unter 39;1736;877;859
09777;      Ostallgäu (Lkr);39 bis unter 40;1608;816;792
09777;      Ostallgäu (Lkr);40 bis unter 41;1604;820;784
09777;      Ostallgäu (Lkr);41 bis unter 42;1562;817;745
09777;      Ostallgäu (Lkr);42 bis unter 43;1594;795;799
09777;      Ostallgäu (Lkr);43 bis unter 44;1630;830;800
09777;      Ostallgäu (Lkr);44 bis unter 45;1615;794;821
09777;      Ostallgäu (Lkr);45 bis unter 46;1751;839;912
09777;      Ostallgäu (Lkr);46 bis unter 47;1872;913;959
09777;      Ostallgäu (Lkr);47 bis unter 48;1939;982;957
09777;      Ostallgäu (Lkr);48 bis unter 49;2067;1079;988
09777;      Ostallgäu (Lkr);49 bis unter 50;2166;1057;1109
09777;      Ostallgäu (Lkr);50 bis unter 51;2336;1210;1126
09777;      Ostallgäu (Lkr);51 bis unter 52;2428;1226;1202
09777;      Ostallgäu (Lkr);52 bis unter 53;2465;1246;1219
09777;      Ostallgäu (Lkr);53 bis unter 54;2448;1250;1198
09777;      Ostallgäu (Lkr);54 bis unter 55;2479;1229;1250
09777;      Ostallgäu (Lkr);55 bis unter 56;2386;1123;1263
09777;      Ostallgäu (Lkr);56 bis unter 57;2316;1159;1157
09777;      Ostallgäu (Lkr);57 bis unter 58;2204;1100;1104
09777;      Ostallgäu (Lkr);58 bis unter 59;2160;1098;1062
09777;      Ostallgäu (Lkr);59 bis unter 60;2187;1099;1088
09777;      Ostallgäu (Lkr);60 bis unter 61;1910;925;985
09777;      Ostallgäu (Lkr);61 bis unter 62;1805;922;883
09777;      Ostallgäu (Lkr);62 bis unter 63;1889;938;951
09777;      Ostallgäu (Lkr);63 bis unter 64;1746;878;868
09777;      Ostallgäu (Lkr);64 bis unter 65;1737;843;894
09777;      Ostallgäu (Lkr);65 bis unter 66;1592;754;838
09777;      Ostallgäu (Lkr);66 bis unter 67;1655;806;849
09777;      Ostallgäu (Lkr);67 bis unter 68;1612;812;800
09777;      Ostallgäu (Lkr);68 bis unter 69;1577;793;784
09777;      Ostallgäu (Lkr);69 bis unter 70;1537;738;799
09777;      Ostallgäu (Lkr);70 bis unter 71;1517;730;787
09777;      Ostallgäu (Lkr);71 bis unter 72;1394;720;674
09777;      Ostallgäu (Lkr);72 bis unter 73;1249;630;619
09777;      Ostallgäu (Lkr);73 bis unter 74;948;456;492
09777;      Ostallgäu (Lkr);74 bis unter 75;1327;645;682
09777;      Ostallgäu (Lkr);75 bis unter 76;1339;633;706
09777;      Ostallgäu (Lkr);76 bis unter 77;1238;607;631
09777;      Ostallgäu (Lkr);77 bis unter 78;1414;635;779
09777;      Ostallgäu (Lkr);78 bis unter 79;1468;684;784
09777;      Ostallgäu (Lkr);79 bis unter 80;1355;615;740
09777;      Ostallgäu (Lkr);80 bis unter 81;1179;562;617
09777;      Ostallgäu (Lkr);81 bis unter 82;1061;487;574
09777;      Ostallgäu (Lkr);82 bis unter 83;897;380;517
09777;      Ostallgäu (Lkr);83 bis unter 84;838;374;464
09777;      Ostallgäu (Lkr);84 bis unter 85;678;283;395
09777;      Ostallgäu (Lkr);85 bis unter 90;2382;886;1496
09777;      Ostallgäu (Lkr);90 bis unter 95;1046;331;715
09777;      Ostallgäu (Lkr);95 oder älter;313;71;242
09777;      Ostallgäu (Lkr);Insgesamt;140316;69968;70348
09778;      Unterallgäu (Lkr);unter 1;1421;723;698
09778;      Unterallgäu (Lkr);1 bis unter 2;1390;717;673
09778;      Unterallgäu (Lkr);2 bis unter 3;1508;738;770
09778;      Unterallgäu (Lkr);3 bis unter 4;1385;689;696
09778;      Unterallgäu (Lkr);4 bis unter 5;1374;686;688
09778;      Unterallgäu (Lkr);5 bis unter 6;1369;725;644
09778;      Unterallgäu (Lkr);6 bis unter 7;1275;656;619
09778;      Unterallgäu (Lkr);7 bis unter 8;1349;723;626
09778;      Unterallgäu (Lkr);8 bis unter 9;1264;638;626
09778;      Unterallgäu (Lkr);9 bis unter 10;1289;646;643
09778;      Unterallgäu (Lkr);10 bis unter 11;1338;709;629
09778;      Unterallgäu (Lkr);11 bis unter 12;1300;685;615
09778;      Unterallgäu (Lkr);12 bis unter 13;1306;672;634
09778;      Unterallgäu (Lkr);13 bis unter 14;1339;682;657
09778;      Unterallgäu (Lkr);14 bis unter 15;1341;658;683
09778;      Unterallgäu (Lkr);15 bis unter 16;1443;734;709
09778;      Unterallgäu (Lkr);16 bis unter 17;1445;737;708
09778;      Unterallgäu (Lkr);17 bis unter 18;1541;792;749
09778;      Unterallgäu (Lkr);18 bis unter 19;1621;879;742
09778;      Unterallgäu (Lkr);19 bis unter 20;1682;900;782
09778;      Unterallgäu (Lkr);20 bis unter 21;1720;974;746
09778;      Unterallgäu (Lkr);21 bis unter 22;1671;918;753
09778;      Unterallgäu (Lkr);22 bis unter 23;1650;905;745
09778;      Unterallgäu (Lkr);23 bis unter 24;1648;891;757
09778;      Unterallgäu (Lkr);24 bis unter 25;1636;878;758
09778;      Unterallgäu (Lkr);25 bis unter 26;1717;942;775
09778;      Unterallgäu (Lkr);26 bis unter 27;1669;909;760
09778;      Unterallgäu (Lkr);27 bis unter 28;1771;927;844
09778;      Unterallgäu (Lkr);28 bis unter 29;1816;982;834
09778;      Unterallgäu (Lkr);29 bis unter 30;1725;930;795
09778;      Unterallgäu (Lkr);30 bis unter 31;1728;860;868
09778;      Unterallgäu (Lkr);31 bis unter 32;1686;916;770
09778;      Unterallgäu (Lkr);32 bis unter 33;1731;913;818
09778;      Unterallgäu (Lkr);33 bis unter 34;1633;861;772
09778;      Unterallgäu (Lkr);34 bis unter 35;1697;886;811
09778;      Unterallgäu (Lkr);35 bis unter 36;1729;880;849
09778;      Unterallgäu (Lkr);36 bis unter 37;1713;893;820
09778;      Unterallgäu (Lkr);37 bis unter 38;1706;915;791
09778;      Unterallgäu (Lkr);38 bis unter 39;1766;923;843
09778;      Unterallgäu (Lkr);39 bis unter 40;1716;863;853
09778;      Unterallgäu (Lkr);40 bis unter 41;1706;837;869
09778;      Unterallgäu (Lkr);41 bis unter 42;1672;851;821
09778;      Unterallgäu (Lkr);42 bis unter 43;1708;865;843
09778;      Unterallgäu (Lkr);43 bis unter 44;1634;849;785
09778;      Unterallgäu (Lkr);44 bis unter 45;1741;904;837
09778;      Unterallgäu (Lkr);45 bis unter 46;1719;920;799
09778;      Unterallgäu (Lkr);46 bis unter 47;1827;973;854
09778;      Unterallgäu (Lkr);47 bis unter 48;2054;1047;1007
09778;      Unterallgäu (Lkr);48 bis unter 49;2175;1123;1052
09778;      Unterallgäu (Lkr);49 bis unter 50;2296;1197;1099
09778;      Unterallgäu (Lkr);50 bis unter 51;2472;1263;1209
09778;      Unterallgäu (Lkr);51 bis unter 52;2462;1305;1157
09778;      Unterallgäu (Lkr);52 bis unter 53;2500;1265;1235
09778;      Unterallgäu (Lkr);53 bis unter 54;2429;1259;1170
09778;      Unterallgäu (Lkr);54 bis unter 55;2484;1288;1196
09778;      Unterallgäu (Lkr);55 bis unter 56;2463;1341;1122
09778;      Unterallgäu (Lkr);56 bis unter 57;2367;1165;1202
09778;      Unterallgäu (Lkr);57 bis unter 58;2386;1198;1188
09778;      Unterallgäu (Lkr);58 bis unter 59;2198;1062;1136
09778;      Unterallgäu (Lkr);59 bis unter 60;2136;1087;1049
09778;      Unterallgäu (Lkr);60 bis unter 61;2022;1013;1009
09778;      Unterallgäu (Lkr);61 bis unter 62;1888;906;982
09778;      Unterallgäu (Lkr);62 bis unter 63;1835;926;909
09778;      Unterallgäu (Lkr);63 bis unter 64;1800;906;894
09778;      Unterallgäu (Lkr);64 bis unter 65;1689;808;881
09778;      Unterallgäu (Lkr);65 bis unter 66;1652;821;831
09778;      Unterallgäu (Lkr);66 bis unter 67;1624;824;800
09778;      Unterallgäu (Lkr);67 bis unter 68;1531;786;745
09778;      Unterallgäu (Lkr);68 bis unter 69;1583;820;763
09778;      Unterallgäu (Lkr);69 bis unter 70;1552;744;808
09778;      Unterallgäu (Lkr);70 bis unter 71;1489;687;802
09778;      Unterallgäu (Lkr);71 bis unter 72;1425;686;739
09778;      Unterallgäu (Lkr);72 bis unter 73;1243;605;638
09778;      Unterallgäu (Lkr);73 bis unter 74;967;473;494
09778;      Unterallgäu (Lkr);74 bis unter 75;1250;558;692
09778;      Unterallgäu (Lkr);75 bis unter 76;1272;585;687
09778;      Unterallgäu (Lkr);76 bis unter 77;1254;580;674
09778;      Unterallgäu (Lkr);77 bis unter 78;1451;674;777
09778;      Unterallgäu (Lkr);78 bis unter 79;1530;705;825
09778;      Unterallgäu (Lkr);79 bis unter 80;1516;680;836
09778;      Unterallgäu (Lkr);80 bis unter 81;1276;552;724
09778;      Unterallgäu (Lkr);81 bis unter 82;1052;449;603
09778;      Unterallgäu (Lkr);82 bis unter 83;1024;441;583
09778;      Unterallgäu (Lkr);83 bis unter 84;888;372;516
09778;      Unterallgäu (Lkr);84 bis unter 85;781;328;453
09778;      Unterallgäu (Lkr);85 bis unter 90;2546;953;1593
09778;      Unterallgäu (Lkr);90 bis unter 95;1083;319;764
09778;      Unterallgäu (Lkr);95 oder älter;281;53;228
09778;      Unterallgäu (Lkr);Insgesamt;144041;72608;71433
09779;      Donau-Ries (Lkr);unter 1;1198;616;582
09779;      Donau-Ries (Lkr);1 bis unter 2;1305;684;621
09779;      Donau-Ries (Lkr);2 bis unter 3;1308;693;615
09779;      Donau-Ries (Lkr);3 bis unter 4;1203;619;584
09779;      Donau-Ries (Lkr);4 bis unter 5;1182;624;558
09779;      Donau-Ries (Lkr);5 bis unter 6;1285;664;621
09779;      Donau-Ries (Lkr);6 bis unter 7;1233;641;592
09779;      Donau-Ries (Lkr);7 bis unter 8;1174;580;594
09779;      Donau-Ries (Lkr);8 bis unter 9;1215;625;590
09779;      Donau-Ries (Lkr);9 bis unter 10;1227;631;596
09779;      Donau-Ries (Lkr);10 bis unter 11;1249;625;624
09779;      Donau-Ries (Lkr);11 bis unter 12;1278;641;637
09779;      Donau-Ries (Lkr);12 bis unter 13;1233;630;603
09779;      Donau-Ries (Lkr);13 bis unter 14;1305;684;621
09779;      Donau-Ries (Lkr);14 bis unter 15;1375;718;657
09779;      Donau-Ries (Lkr);15 bis unter 16;1320;671;649
09779;      Donau-Ries (Lkr);16 bis unter 17;1372;700;672
09779;      Donau-Ries (Lkr);17 bis unter 18;1439;759;680
09779;      Donau-Ries (Lkr);18 bis unter 19;1578;817;761
09779;      Donau-Ries (Lkr);19 bis unter 20;1550;858;692
09779;      Donau-Ries (Lkr);20 bis unter 21;1597;885;712
09779;      Donau-Ries (Lkr);21 bis unter 22;1580;847;733
09779;      Donau-Ries (Lkr);22 bis unter 23;1527;851;676
09779;      Donau-Ries (Lkr);23 bis unter 24;1574;827;747
09779;      Donau-Ries (Lkr);24 bis unter 25;1506;848;658
09779;      Donau-Ries (Lkr);25 bis unter 26;1554;844;710
09779;      Donau-Ries (Lkr);26 bis unter 27;1595;838;757
09779;      Donau-Ries (Lkr);27 bis unter 28;1608;883;725
09779;      Donau-Ries (Lkr);28 bis unter 29;1677;919;758
09779;      Donau-Ries (Lkr);29 bis unter 30;1615;845;770
09779;      Donau-Ries (Lkr);30 bis unter 31;1657;922;735
09779;      Donau-Ries (Lkr);31 bis unter 32;1698;932;766
09779;      Donau-Ries (Lkr);32 bis unter 33;1779;944;835
09779;      Donau-Ries (Lkr);33 bis unter 34;1573;875;698
09779;      Donau-Ries (Lkr);34 bis unter 35;1554;824;730
09779;      Donau-Ries (Lkr);35 bis unter 36;1684;911;773
09779;      Donau-Ries (Lkr);36 bis unter 37;1661;886;775
09779;      Donau-Ries (Lkr);37 bis unter 38;1675;849;826
09779;      Donau-Ries (Lkr);38 bis unter 39;1726;920;806
09779;      Donau-Ries (Lkr);39 bis unter 40;1629;829;800
09779;      Donau-Ries (Lkr);40 bis unter 41;1611;849;762
09779;      Donau-Ries (Lkr);41 bis unter 42;1654;851;803
09779;      Donau-Ries (Lkr);42 bis unter 43;1672;879;793
09779;      Donau-Ries (Lkr);43 bis unter 44;1693;898;795
09779;      Donau-Ries (Lkr);44 bis unter 45;1650;831;819
09779;      Donau-Ries (Lkr);45 bis unter 46;1693;900;793
09779;      Donau-Ries (Lkr);46 bis unter 47;1685;861;824
09779;      Donau-Ries (Lkr);47 bis unter 48;1987;1011;976
09779;      Donau-Ries (Lkr);48 bis unter 49;1886;967;919
09779;      Donau-Ries (Lkr);49 bis unter 50;2108;1089;1019
09779;      Donau-Ries (Lkr);50 bis unter 51;2081;1048;1033
09779;      Donau-Ries (Lkr);51 bis unter 52;2190;1134;1056
09779;      Donau-Ries (Lkr);52 bis unter 53;2322;1210;1112
09779;      Donau-Ries (Lkr);53 bis unter 54;2330;1262;1068
09779;      Donau-Ries (Lkr);54 bis unter 55;2308;1151;1157
09779;      Donau-Ries (Lkr);55 bis unter 56;2235;1143;1092
09779;      Donau-Ries (Lkr);56 bis unter 57;2252;1118;1134
09779;      Donau-Ries (Lkr);57 bis unter 58;2237;1162;1075
09779;      Donau-Ries (Lkr);58 bis unter 59;2072;1010;1062
09779;      Donau-Ries (Lkr);59 bis unter 60;2027;1039;988
09779;      Donau-Ries (Lkr);60 bis unter 61;1908;998;910
09779;      Donau-Ries (Lkr);61 bis unter 62;1794;924;870
09779;      Donau-Ries (Lkr);62 bis unter 63;1816;909;907
09779;      Donau-Ries (Lkr);63 bis unter 64;1669;852;817
09779;      Donau-Ries (Lkr);64 bis unter 65;1627;804;823
09779;      Donau-Ries (Lkr);65 bis unter 66;1576;779;797
09779;      Donau-Ries (Lkr);66 bis unter 67;1519;754;765
09779;      Donau-Ries (Lkr);67 bis unter 68;1401;682;719
09779;      Donau-Ries (Lkr);68 bis unter 69;1457;727;730
09779;      Donau-Ries (Lkr);69 bis unter 70;1411;718;693
09779;      Donau-Ries (Lkr);70 bis unter 71;1245;626;619
09779;      Donau-Ries (Lkr);71 bis unter 72;1188;570;618
09779;      Donau-Ries (Lkr);72 bis unter 73;1082;531;551
09779;      Donau-Ries (Lkr);73 bis unter 74;763;344;419
09779;      Donau-Ries (Lkr);74 bis unter 75;1048;473;575
09779;      Donau-Ries (Lkr);75 bis unter 76;1007;496;511
09779;      Donau-Ries (Lkr);76 bis unter 77;1044;496;548
09779;      Donau-Ries (Lkr);77 bis unter 78;1270;581;689
09779;      Donau-Ries (Lkr);78 bis unter 79;1304;632;672
09779;      Donau-Ries (Lkr);79 bis unter 80;1330;613;717
09779;      Donau-Ries (Lkr);80 bis unter 81;1127;510;617
09779;      Donau-Ries (Lkr);81 bis unter 82;986;420;566
09779;      Donau-Ries (Lkr);82 bis unter 83;853;324;529
09779;      Donau-Ries (Lkr);83 bis unter 84;761;303;458
09779;      Donau-Ries (Lkr);84 bis unter 85;725;310;415
09779;      Donau-Ries (Lkr);85 bis unter 90;2231;793;1438
09779;      Donau-Ries (Lkr);90 bis unter 95;933;241;692
09779;      Donau-Ries (Lkr);95 oder älter;230;39;191
09779;      Donau-Ries (Lkr);Insgesamt;133496;67821;65675
09780;      Oberallgäu (Lkr);unter 1;1484;745;739
09780;      Oberallgäu (Lkr);1 bis unter 2;1491;812;679
09780;      Oberallgäu (Lkr);2 bis unter 3;1537;771;766
09780;      Oberallgäu (Lkr);3 bis unter 4;1471;726;745
09780;      Oberallgäu (Lkr);4 bis unter 5;1456;750;706
09780;      Oberallgäu (Lkr);5 bis unter 6;1308;692;616
09780;      Oberallgäu (Lkr);6 bis unter 7;1325;642;683
09780;      Oberallgäu (Lkr);7 bis unter 8;1296;690;606
09780;      Oberallgäu (Lkr);8 bis unter 9;1295;671;624
09780;      Oberallgäu (Lkr);9 bis unter 10;1282;664;618
09780;      Oberallgäu (Lkr);10 bis unter 11;1345;702;643
09780;      Oberallgäu (Lkr);11 bis unter 12;1407;741;666
09780;      Oberallgäu (Lkr);12 bis unter 13;1294;678;616
09780;      Oberallgäu (Lkr);13 bis unter 14;1410;712;698
09780;      Oberallgäu (Lkr);14 bis unter 15;1391;704;687
09780;      Oberallgäu (Lkr);15 bis unter 16;1428;729;699
09780;      Oberallgäu (Lkr);16 bis unter 17;1525;787;738
09780;      Oberallgäu (Lkr);17 bis unter 18;1591;784;807
09780;      Oberallgäu (Lkr);18 bis unter 19;1600;832;768
09780;      Oberallgäu (Lkr);19 bis unter 20;1703;900;803
09780;      Oberallgäu (Lkr);20 bis unter 21;1625;886;739
09780;      Oberallgäu (Lkr);21 bis unter 22;1642;887;755
09780;      Oberallgäu (Lkr);22 bis unter 23;1638;888;750
09780;      Oberallgäu (Lkr);23 bis unter 24;1574;861;713
09780;      Oberallgäu (Lkr);24 bis unter 25;1625;842;783
09780;      Oberallgäu (Lkr);25 bis unter 26;1723;911;812
09780;      Oberallgäu (Lkr);26 bis unter 27;1683;887;796
09780;      Oberallgäu (Lkr);27 bis unter 28;1813;938;875
09780;      Oberallgäu (Lkr);28 bis unter 29;1802;949;853
09780;      Oberallgäu (Lkr);29 bis unter 30;1819;911;908
09780;      Oberallgäu (Lkr);30 bis unter 31;1808;926;882
09780;      Oberallgäu (Lkr);31 bis unter 32;1857;993;864
09780;      Oberallgäu (Lkr);32 bis unter 33;1839;971;868
09780;      Oberallgäu (Lkr);33 bis unter 34;1777;898;879
09780;      Oberallgäu (Lkr);34 bis unter 35;1788;932;856
09780;      Oberallgäu (Lkr);35 bis unter 36;1734;811;923
09780;      Oberallgäu (Lkr);36 bis unter 37;1771;890;881
09780;      Oberallgäu (Lkr);37 bis unter 38;1857;937;920
09780;      Oberallgäu (Lkr);38 bis unter 39;1835;891;944
09780;      Oberallgäu (Lkr);39 bis unter 40;1790;886;904
09780;      Oberallgäu (Lkr);40 bis unter 41;1803;884;919
09780;      Oberallgäu (Lkr);41 bis unter 42;1736;832;904
09780;      Oberallgäu (Lkr);42 bis unter 43;1756;818;938
09780;      Oberallgäu (Lkr);43 bis unter 44;1782;866;916
09780;      Oberallgäu (Lkr);44 bis unter 45;1834;907;927
09780;      Oberallgäu (Lkr);45 bis unter 46;1840;925;915
09780;      Oberallgäu (Lkr);46 bis unter 47;1880;960;920
09780;      Oberallgäu (Lkr);47 bis unter 48;2198;1049;1149
09780;      Oberallgäu (Lkr);48 bis unter 49;2304;1103;1201
09780;      Oberallgäu (Lkr);49 bis unter 50;2564;1243;1321
09780;      Oberallgäu (Lkr);50 bis unter 51;2630;1331;1299
09780;      Oberallgäu (Lkr);51 bis unter 52;2811;1407;1404
09780;      Oberallgäu (Lkr);52 bis unter 53;2666;1330;1336
09780;      Oberallgäu (Lkr);53 bis unter 54;2761;1398;1363
09780;      Oberallgäu (Lkr);54 bis unter 55;2720;1430;1290
09780;      Oberallgäu (Lkr);55 bis unter 56;2727;1342;1385
09780;      Oberallgäu (Lkr);56 bis unter 57;2664;1307;1357
09780;      Oberallgäu (Lkr);57 bis unter 58;2629;1252;1377
09780;      Oberallgäu (Lkr);58 bis unter 59;2472;1246;1226
09780;      Oberallgäu (Lkr);59 bis unter 60;2405;1177;1228
09780;      Oberallgäu (Lkr);60 bis unter 61;2250;1100;1150
09780;      Oberallgäu (Lkr);61 bis unter 62;2110;1035;1075
09780;      Oberallgäu (Lkr);62 bis unter 63;2057;1039;1018
09780;      Oberallgäu (Lkr);63 bis unter 64;1931;912;1019
09780;      Oberallgäu (Lkr);64 bis unter 65;1987;949;1038
09780;      Oberallgäu (Lkr);65 bis unter 66;1788;879;909
09780;      Oberallgäu (Lkr);66 bis unter 67;1762;849;913
09780;      Oberallgäu (Lkr);67 bis unter 68;1733;829;904
09780;      Oberallgäu (Lkr);68 bis unter 69;1943;888;1055
09780;      Oberallgäu (Lkr);69 bis unter 70;1819;892;927
09780;      Oberallgäu (Lkr);70 bis unter 71;1728;812;916
09780;      Oberallgäu (Lkr);71 bis unter 72;1658;787;871
09780;      Oberallgäu (Lkr);72 bis unter 73;1512;723;789
09780;      Oberallgäu (Lkr);73 bis unter 74;1215;571;644
09780;      Oberallgäu (Lkr);74 bis unter 75;1525;725;800
09780;      Oberallgäu (Lkr);75 bis unter 76;1585;767;818
09780;      Oberallgäu (Lkr);76 bis unter 77;1578;770;808
09780;      Oberallgäu (Lkr);77 bis unter 78;1746;784;962
09780;      Oberallgäu (Lkr);78 bis unter 79;1721;763;958
09780;      Oberallgäu (Lkr);79 bis unter 80;1717;791;926
09780;      Oberallgäu (Lkr);80 bis unter 81;1530;720;810
09780;      Oberallgäu (Lkr);81 bis unter 82;1307;591;716
09780;      Oberallgäu (Lkr);82 bis unter 83;1168;530;638
09780;      Oberallgäu (Lkr);83 bis unter 84;1020;437;583
09780;      Oberallgäu (Lkr);84 bis unter 85;830;341;489
09780;      Oberallgäu (Lkr);85 bis unter 90;2769;1048;1721
09780;      Oberallgäu (Lkr);90 bis unter 95;1231;360;871
09780;      Oberallgäu (Lkr);95 oder älter;321;51;270
09780;      Oberallgäu (Lkr);Insgesamt;155362;76577;78785
LK097;    Landkreise Schwaben;unter 1;13967;7170;6797
LK097;    Landkreise Schwaben;1 bis unter 2;14449;7447;7002
LK097;    Landkreise Schwaben;2 bis unter 3;14492;7384;7108
LK097;    Landkreise Schwaben;3 bis unter 4;13893;7113;6780
LK097;    Landkreise Schwaben;4 bis unter 5;13619;7009;6610
LK097;    Landkreise Schwaben;5 bis unter 6;13257;6784;6473
LK097;    Landkreise Schwaben;6 bis unter 7;13132;6817;6315
LK097;    Landkreise Schwaben;7 bis unter 8;12870;6645;6225
LK097;    Landkreise Schwaben;8 bis unter 9;12953;6589;6364
LK097;    Landkreise Schwaben;9 bis unter 10;12902;6595;6307
LK097;    Landkreise Schwaben;10 bis unter 11;13292;6774;6518
LK097;    Landkreise Schwaben;11 bis unter 12;13313;6761;6552
LK097;    Landkreise Schwaben;12 bis unter 13;12975;6645;6330
LK097;    Landkreise Schwaben;13 bis unter 14;13483;6942;6541
LK097;    Landkreise Schwaben;14 bis unter 15;13978;7087;6891
LK097;    Landkreise Schwaben;15 bis unter 16;14266;7342;6924
LK097;    Landkreise Schwaben;16 bis unter 17;14612;7550;7062
LK097;    Landkreise Schwaben;17 bis unter 18;15251;7821;7430
LK097;    Landkreise Schwaben;18 bis unter 19;15806;8273;7533
LK097;    Landkreise Schwaben;19 bis unter 20;16285;8832;7453
LK097;    Landkreise Schwaben;20 bis unter 21;16095;8653;7442
LK097;    Landkreise Schwaben;21 bis unter 22;16467;8820;7647
LK097;    Landkreise Schwaben;22 bis unter 23;15978;8513;7465
LK097;    Landkreise Schwaben;23 bis unter 24;15701;8486;7215
LK097;    Landkreise Schwaben;24 bis unter 25;15635;8424;7211
LK097;    Landkreise Schwaben;25 bis unter 26;16312;8723;7589
LK097;    Landkreise Schwaben;26 bis unter 27;16523;8653;7870
LK097;    Landkreise Schwaben;27 bis unter 28;16786;8895;7891
LK097;    Landkreise Schwaben;28 bis unter 29;17608;9316;8292
LK097;    Landkreise Schwaben;29 bis unter 30;17199;8953;8246
LK097;    Landkreise Schwaben;30 bis unter 31;17703;9213;8490
LK097;    Landkreise Schwaben;31 bis unter 32;17355;9138;8217
LK097;    Landkreise Schwaben;32 bis unter 33;17752;9243;8509
LK097;    Landkreise Schwaben;33 bis unter 34;16880;8747;8133
LK097;    Landkreise Schwaben;34 bis unter 35;17181;8844;8337
LK097;    Landkreise Schwaben;35 bis unter 36;17466;8892;8574
LK097;    Landkreise Schwaben;36 bis unter 37;17669;9013;8656
LK097;    Landkreise Schwaben;37 bis unter 38;18080;9097;8983
LK097;    Landkreise Schwaben;38 bis unter 39;18044;9217;8827
LK097;    Landkreise Schwaben;39 bis unter 40;17173;8665;8508
LK097;    Landkreise Schwaben;40 bis unter 41;17021;8606;8415
LK097;    Landkreise Schwaben;41 bis unter 42;17270;8712;8558
LK097;    Landkreise Schwaben;42 bis unter 43;17078;8560;8518
LK097;    Landkreise Schwaben;43 bis unter 44;17040;8669;8371
LK097;    Landkreise Schwaben;44 bis unter 45;17352;8762;8590
LK097;    Landkreise Schwaben;45 bis unter 46;17423;8750;8673
LK097;    Landkreise Schwaben;46 bis unter 47;18699;9444;9255
LK097;    Landkreise Schwaben;47 bis unter 48;20329;10190;10139
LK097;    Landkreise Schwaben;48 bis unter 49;21297;10785;10512
LK097;    Landkreise Schwaben;49 bis unter 50;23275;11660;11615
LK097;    Landkreise Schwaben;50 bis unter 51;24199;12230;11969
LK097;    Landkreise Schwaben;51 bis unter 52;24601;12565;12036
LK097;    Landkreise Schwaben;52 bis unter 53;25051;12604;12447
LK097;    Landkreise Schwaben;53 bis unter 54;24951;12827;12124
LK097;    Landkreise Schwaben;54 bis unter 55;25118;12749;12369
LK097;    Landkreise Schwaben;55 bis unter 56;24655;12399;12256
LK097;    Landkreise Schwaben;56 bis unter 57;24032;12019;12013
LK097;    Landkreise Schwaben;57 bis unter 58;23405;11757;11648
LK097;    Landkreise Schwaben;58 bis unter 59;22378;11206;11172
LK097;    Landkreise Schwaben;59 bis unter 60;21722;10938;10784
LK097;    Landkreise Schwaben;60 bis unter 61;20306;10137;10169
LK097;    Landkreise Schwaben;61 bis unter 62;19572;9675;9897
LK097;    Landkreise Schwaben;62 bis unter 63;18935;9459;9476
LK097;    Landkreise Schwaben;63 bis unter 64;17679;8744;8935
LK097;    Landkreise Schwaben;64 bis unter 65;17218;8336;8882
LK097;    Landkreise Schwaben;65 bis unter 66;16479;8122;8357
LK097;    Landkreise Schwaben;66 bis unter 67;16277;7851;8426
LK097;    Landkreise Schwaben;67 bis unter 68;15590;7603;7987
LK097;    Landkreise Schwaben;68 bis unter 69;15748;7685;8063
LK097;    Landkreise Schwaben;69 bis unter 70;15457;7520;7937
LK097;    Landkreise Schwaben;70 bis unter 71;14438;6923;7515
LK097;    Landkreise Schwaben;71 bis unter 72;13739;6696;7043
LK097;    Landkreise Schwaben;72 bis unter 73;12293;5929;6364
LK097;    Landkreise Schwaben;73 bis unter 74;9679;4574;5105
LK097;    Landkreise Schwaben;74 bis unter 75;12489;5910;6579
LK097;    Landkreise Schwaben;75 bis unter 76;12818;6037;6781
LK097;    Landkreise Schwaben;76 bis unter 77;12407;5858;6549
LK097;    Landkreise Schwaben;77 bis unter 78;14503;6721;7782
LK097;    Landkreise Schwaben;78 bis unter 79;14927;6877;8050
LK097;    Landkreise Schwaben;79 bis unter 80;14304;6425;7879
LK097;    Landkreise Schwaben;80 bis unter 81;12291;5553;6738
LK097;    Landkreise Schwaben;81 bis unter 82;10709;4646;6063
LK097;    Landkreise Schwaben;82 bis unter 83;9714;4096;5618
LK097;    Landkreise Schwaben;83 bis unter 84;8703;3603;5100
LK097;    Landkreise Schwaben;84 bis unter 85;7320;3015;4305
LK097;    Landkreise Schwaben;85 bis unter 90;24256;8870;15386
LK097;    Landkreise Schwaben;90 bis unter 95;10267;3026;7241
LK097;    Landkreise Schwaben;95 oder älter;2566;490;2076
LK097;    Landkreise Schwaben;Insgesamt;1435982;716898;719084
097;  Schwaben;unter 1;18486;9451;9035
097;  Schwaben;1 bis unter 2;18984;9778;9206
097;  Schwaben;2 bis unter 3;19004;9715;9289
097;  Schwaben;3 bis unter 4;17995;9225;8770
097;  Schwaben;4 bis unter 5;17672;8991;8681
097;  Schwaben;5 bis unter 6;17088;8756;8332
097;  Schwaben;6 bis unter 7;16970;8798;8172
097;  Schwaben;7 bis unter 8;16338;8434;7904
097;  Schwaben;8 bis unter 9;16532;8402;8130
097;  Schwaben;9 bis unter 10;16438;8402;8036
097;  Schwaben;10 bis unter 11;17035;8705;8330
097;  Schwaben;11 bis unter 12;17114;8749;8365
097;  Schwaben;12 bis unter 13;16673;8580;8093
097;  Schwaben;13 bis unter 14;17244;8856;8388
097;  Schwaben;14 bis unter 15;17715;8979;8736
097;  Schwaben;15 bis unter 16;18189;9339;8850
097;  Schwaben;16 bis unter 17;18421;9507;8914
097;  Schwaben;17 bis unter 18;19174;9848;9326
097;  Schwaben;18 bis unter 19;20184;10498;9686
097;  Schwaben;19 bis unter 20;21296;11370;9926
097;  Schwaben;20 bis unter 21;21840;11569;10271
097;  Schwaben;21 bis unter 22;22360;11788;10572
097;  Schwaben;22 bis unter 23;22236;11652;10584
097;  Schwaben;23 bis unter 24;22105;11685;10420
097;  Schwaben;24 bis unter 25;22131;11755;10376
097;  Schwaben;25 bis unter 26;23457;12355;11102
097;  Schwaben;26 bis unter 27;23781;12402;11379
097;  Schwaben;27 bis unter 28;24318;12757;11561
097;  Schwaben;28 bis unter 29;25204;13320;11884
097;  Schwaben;29 bis unter 30;24731;12951;11780
097;  Schwaben;30 bis unter 31;25224;13200;12024
097;  Schwaben;31 bis unter 32;24575;13042;11533
097;  Schwaben;32 bis unter 33;24743;12989;11754
097;  Schwaben;33 bis unter 34;23323;12168;11155
097;  Schwaben;34 bis unter 35;23366;12080;11286
097;  Schwaben;35 bis unter 36;23821;12261;11560
097;  Schwaben;36 bis unter 37;24038;12408;11630
097;  Schwaben;37 bis unter 38;24400;12403;11997
097;  Schwaben;38 bis unter 39;24217;12464;11753
097;  Schwaben;39 bis unter 40;22965;11603;11362
097;  Schwaben;40 bis unter 41;22690;11485;11205
097;  Schwaben;41 bis unter 42;22811;11541;11270
097;  Schwaben;42 bis unter 43;22557;11381;11176
097;  Schwaben;43 bis unter 44;22426;11411;11015
097;  Schwaben;44 bis unter 45;22795;11576;11219
097;  Schwaben;45 bis unter 46;22522;11364;11158
097;  Schwaben;46 bis unter 47;24201;12249;11952
097;  Schwaben;47 bis unter 48;26216;13080;13136
097;  Schwaben;48 bis unter 49;27202;13760;13442
097;  Schwaben;49 bis unter 50;29535;14932;14603
097;  Schwaben;50 bis unter 51;30831;15628;15203
097;  Schwaben;51 bis unter 52;31162;15934;15228
097;  Schwaben;52 bis unter 53;31579;15916;15663
097;  Schwaben;53 bis unter 54;31580;16218;15362
097;  Schwaben;54 bis unter 55;31835;16221;15614
097;  Schwaben;55 bis unter 56;31202;15711;15491
097;  Schwaben;56 bis unter 57;30299;15082;15217
097;  Schwaben;57 bis unter 58;29680;14896;14784
097;  Schwaben;58 bis unter 59;28501;14239;14262
097;  Schwaben;59 bis unter 60;27513;13739;13774
097;  Schwaben;60 bis unter 61;25940;12894;13046
097;  Schwaben;61 bis unter 62;25141;12425;12716
097;  Schwaben;62 bis unter 63;24277;12031;12246
097;  Schwaben;63 bis unter 64;22742;11103;11639
097;  Schwaben;64 bis unter 65;22053;10548;11505
097;  Schwaben;65 bis unter 66;21078;10300;10778
097;  Schwaben;66 bis unter 67;20807;9913;10894
097;  Schwaben;67 bis unter 68;20096;9616;10480
097;  Schwaben;68 bis unter 69;20331;9717;10614
097;  Schwaben;69 bis unter 70;19908;9530;10378
097;  Schwaben;70 bis unter 71;18621;8799;9822
097;  Schwaben;71 bis unter 72;18061;8635;9426
097;  Schwaben;72 bis unter 73;16011;7583;8428
097;  Schwaben;73 bis unter 74;12946;5997;6949
097;  Schwaben;74 bis unter 75;16522;7731;8791
097;  Schwaben;75 bis unter 76;16774;7854;8920
097;  Schwaben;76 bis unter 77;16294;7649;8645
097;  Schwaben;77 bis unter 78;19022;8677;10345
097;  Schwaben;78 bis unter 79;19469;8816;10653
097;  Schwaben;79 bis unter 80;18664;8295;10369
097;  Schwaben;80 bis unter 81;16105;7178;8927
097;  Schwaben;81 bis unter 82;14162;6074;8088
097;  Schwaben;82 bis unter 83;12777;5317;7460
097;  Schwaben;83 bis unter 84;11491;4678;6813
097;  Schwaben;84 bis unter 85;9742;3942;5800
097;  Schwaben;85 bis unter 90;32542;11791;20751
097;  Schwaben;90 bis unter 95;13994;4101;9893
097;  Schwaben;95 oder älter;3660;725;2935
097;  Schwaben;Insgesamt;1887754;939517;948237
KS09;Kreisfreie Städte Bayern;unter 1;41533;21325;20208
KS09;Kreisfreie Städte Bayern;1 bis unter 2;40152;20429;19723
KS09;Kreisfreie Städte Bayern;2 bis unter 3;39030;20028;19002
KS09;Kreisfreie Städte Bayern;3 bis unter 4;36588;18708;17880
KS09;Kreisfreie Städte Bayern;4 bis unter 5;35587;18114;17473
KS09;Kreisfreie Städte Bayern;5 bis unter 6;33959;17283;16676
KS09;Kreisfreie Städte Bayern;6 bis unter 7;32998;16994;16004
KS09;Kreisfreie Städte Bayern;7 bis unter 8;31088;15811;15277
KS09;Kreisfreie Städte Bayern;8 bis unter 9;31506;16185;15321
KS09;Kreisfreie Städte Bayern;9 bis unter 10;30938;15902;15036
KS09;Kreisfreie Städte Bayern;10 bis unter 11;31488;16108;15380
KS09;Kreisfreie Städte Bayern;11 bis unter 12;31406;16131;15275
KS09;Kreisfreie Städte Bayern;12 bis unter 13;30607;15826;14781
KS09;Kreisfreie Städte Bayern;13 bis unter 14;30472;15597;14875
KS09;Kreisfreie Städte Bayern;14 bis unter 15;30296;15419;14877
KS09;Kreisfreie Städte Bayern;15 bis unter 16;30340;15583;14757
KS09;Kreisfreie Städte Bayern;16 bis unter 17;30401;15562;14839
KS09;Kreisfreie Städte Bayern;17 bis unter 18;31092;16435;14657
KS09;Kreisfreie Städte Bayern;18 bis unter 19;34683;17789;16894
KS09;Kreisfreie Städte Bayern;19 bis unter 20;40005;20624;19381
KS09;Kreisfreie Städte Bayern;20 bis unter 21;46335;23653;22682
KS09;Kreisfreie Städte Bayern;21 bis unter 22;50069;25294;24775
KS09;Kreisfreie Städte Bayern;22 bis unter 23;52810;26276;26534
KS09;Kreisfreie Städte Bayern;23 bis unter 24;54668;27224;27444
KS09;Kreisfreie Städte Bayern;24 bis unter 25;57753;28748;29005
KS09;Kreisfreie Städte Bayern;25 bis unter 26;61896;30989;30907
KS09;Kreisfreie Städte Bayern;26 bis unter 27;64538;32267;32271
KS09;Kreisfreie Städte Bayern;27 bis unter 28;67517;34044;33473
KS09;Kreisfreie Städte Bayern;28 bis unter 29;70993;36206;34787
KS09;Kreisfreie Städte Bayern;29 bis unter 30;69718;35369;34349
KS09;Kreisfreie Städte Bayern;30 bis unter 31;70403;36152;34251
KS09;Kreisfreie Städte Bayern;31 bis unter 32;67367;35042;32325
KS09;Kreisfreie Städte Bayern;32 bis unter 33;64569;33587;30982
KS09;Kreisfreie Städte Bayern;33 bis unter 34;60712;31307;29405
KS09;Kreisfreie Städte Bayern;34 bis unter 35;59385;30513;28872
KS09;Kreisfreie Städte Bayern;35 bis unter 36;58267;29891;28376
KS09;Kreisfreie Städte Bayern;36 bis unter 37;58454;29893;28561
KS09;Kreisfreie Städte Bayern;37 bis unter 38;56751;28629;28122
KS09;Kreisfreie Städte Bayern;38 bis unter 39;55094;27759;27335
KS09;Kreisfreie Städte Bayern;39 bis unter 40;52307;26179;26128
KS09;Kreisfreie Städte Bayern;40 bis unter 41;50605;25300;25305
KS09;Kreisfreie Städte Bayern;41 bis unter 42;49564;24975;24589
KS09;Kreisfreie Städte Bayern;42 bis unter 43;48688;24444;24244
KS09;Kreisfreie Städte Bayern;43 bis unter 44;47442;23637;23805
KS09;Kreisfreie Städte Bayern;44 bis unter 45;47611;23876;23735
KS09;Kreisfreie Städte Bayern;45 bis unter 46;45769;22857;22912
KS09;Kreisfreie Städte Bayern;46 bis unter 47;48511;24276;24235
KS09;Kreisfreie Städte Bayern;47 bis unter 48;51291;25813;25478
KS09;Kreisfreie Städte Bayern;48 bis unter 49;52505;26457;26048
KS09;Kreisfreie Städte Bayern;49 bis unter 50;55354;28243;27111
KS09;Kreisfreie Städte Bayern;50 bis unter 51;57494;29571;27923
KS09;Kreisfreie Städte Bayern;51 bis unter 52;58066;29450;28616
KS09;Kreisfreie Städte Bayern;52 bis unter 53;57406;29148;28258
KS09;Kreisfreie Städte Bayern;53 bis unter 54;56657;28731;27926
KS09;Kreisfreie Städte Bayern;54 bis unter 55;56947;28657;28290
KS09;Kreisfreie Städte Bayern;55 bis unter 56;55691;27791;27900
KS09;Kreisfreie Städte Bayern;56 bis unter 57;52565;26132;26433
KS09;Kreisfreie Städte Bayern;57 bis unter 58;51498;25354;26144
KS09;Kreisfreie Städte Bayern;58 bis unter 59;49498;24332;25166
KS09;Kreisfreie Städte Bayern;59 bis unter 60;47325;23084;24241
KS09;Kreisfreie Städte Bayern;60 bis unter 61;45282;21966;23316
KS09;Kreisfreie Städte Bayern;61 bis unter 62;43939;21293;22646
KS09;Kreisfreie Städte Bayern;62 bis unter 63;42632;20513;22119
KS09;Kreisfreie Städte Bayern;63 bis unter 64;40400;18932;21468
KS09;Kreisfreie Städte Bayern;64 bis unter 65;38745;17743;21002
KS09;Kreisfreie Städte Bayern;65 bis unter 66;36893;16801;20092
KS09;Kreisfreie Städte Bayern;66 bis unter 67;37494;16862;20632
KS09;Kreisfreie Städte Bayern;67 bis unter 68;35943;16136;19807
KS09;Kreisfreie Städte Bayern;68 bis unter 69;37119;16578;20541
KS09;Kreisfreie Städte Bayern;69 bis unter 70;36162;16385;19777
KS09;Kreisfreie Städte Bayern;70 bis unter 71;35084;16000;19084
KS09;Kreisfreie Städte Bayern;71 bis unter 72;35084;16005;19079
KS09;Kreisfreie Städte Bayern;72 bis unter 73;31165;13990;17175
KS09;Kreisfreie Städte Bayern;73 bis unter 74;26374;11777;14597
KS09;Kreisfreie Städte Bayern;74 bis unter 75;33199;15087;18112
KS09;Kreisfreie Städte Bayern;75 bis unter 76;32914;14796;18118
KS09;Kreisfreie Städte Bayern;76 bis unter 77;31029;13868;17161
KS09;Kreisfreie Städte Bayern;77 bis unter 78;36254;15755;20499
KS09;Kreisfreie Städte Bayern;78 bis unter 79;37035;15756;21279
KS09;Kreisfreie Städte Bayern;79 bis unter 80;34870;14768;20102
KS09;Kreisfreie Städte Bayern;80 bis unter 81;30769;12830;17939
KS09;Kreisfreie Städte Bayern;81 bis unter 82;27583;11256;16327
KS09;Kreisfreie Städte Bayern;82 bis unter 83;25232;10200;15032
KS09;Kreisfreie Städte Bayern;83 bis unter 84;22318;8592;13726
KS09;Kreisfreie Städte Bayern;84 bis unter 85;19429;7443;11986
KS09;Kreisfreie Städte Bayern;85 bis unter 90;62618;22282;40336
KS09;Kreisfreie Städte Bayern;90 bis unter 95;28606;8133;20473
KS09;Kreisfreie Städte Bayern;95 oder älter;7499;1484;6015
KS09;Kreisfreie Städte Bayern;Insgesamt;3865933;1890234;1975699
LK09;Landkreise Bayern;unter 1;85977;43901;42076
LK09;Landkreise Bayern;1 bis unter 2;88343;45087;43256
LK09;Landkreise Bayern;2 bis unter 3;88829;45573;43256
LK09;Landkreise Bayern;3 bis unter 4;86756;44449;42307
LK09;Landkreise Bayern;4 bis unter 5;85212;44015;41197
LK09;Landkreise Bayern;5 bis unter 6;83718;42732;40986
LK09;Landkreise Bayern;6 bis unter 7;83371;42940;40431
LK09;Landkreise Bayern;7 bis unter 8;81244;41988;39256
LK09;Landkreise Bayern;8 bis unter 9;82507;42236;40271
LK09;Landkreise Bayern;9 bis unter 10;81568;41912;39656
LK09;Landkreise Bayern;10 bis unter 11;84189;43284;40905
LK09;Landkreise Bayern;11 bis unter 12;84140;43041;41099
LK09;Landkreise Bayern;12 bis unter 13;82803;42602;40201
LK09;Landkreise Bayern;13 bis unter 14;84892;43699;41193
LK09;Landkreise Bayern;14 bis unter 15;87910;44861;43049
LK09;Landkreise Bayern;15 bis unter 16;89094;45546;43548
LK09;Landkreise Bayern;16 bis unter 17;91263;46952;44311
LK09;Landkreise Bayern;17 bis unter 18;94163;48718;45445
LK09;Landkreise Bayern;18 bis unter 19;98207;51276;46931
LK09;Landkreise Bayern;19 bis unter 20;100082;53685;46397
LK09;Landkreise Bayern;20 bis unter 21;101963;54948;47015
LK09;Landkreise Bayern;21 bis unter 22;105023;56747;48276
LK09;Landkreise Bayern;22 bis unter 23;102139;55163;46976
LK09;Landkreise Bayern;23 bis unter 24;99974;54027;45947
LK09;Landkreise Bayern;24 bis unter 25;100183;54008;46175
LK09;Landkreise Bayern;25 bis unter 26;103936;55691;48245
LK09;Landkreise Bayern;26 bis unter 27;104609;55445;49164
LK09;Landkreise Bayern;27 bis unter 28;105707;56463;49244
LK09;Landkreise Bayern;28 bis unter 29;111182;58878;52304
LK09;Landkreise Bayern;29 bis unter 30;107944;56606;51338
LK09;Landkreise Bayern;30 bis unter 31;111107;58282;52825
LK09;Landkreise Bayern;31 bis unter 32;108995;56824;52171
LK09;Landkreise Bayern;32 bis unter 33;110364;56927;53437
LK09;Landkreise Bayern;33 bis unter 34;107428;55147;52281
LK09;Landkreise Bayern;34 bis unter 35;108542;55503;53039
LK09;Landkreise Bayern;35 bis unter 36;110581;56596;53985
LK09;Landkreise Bayern;36 bis unter 37;114619;57955;56664
LK09;Landkreise Bayern;37 bis unter 38;115465;58295;57170
LK09;Landkreise Bayern;38 bis unter 39;115904;58420;57484
LK09;Landkreise Bayern;39 bis unter 40;111612;56422;55190
LK09;Landkreise Bayern;40 bis unter 41;110623;55601;55022
LK09;Landkreise Bayern;41 bis unter 42;110833;56050;54783
LK09;Landkreise Bayern;42 bis unter 43;110182;55578;54604
LK09;Landkreise Bayern;43 bis unter 44;108491;54716;53775
LK09;Landkreise Bayern;44 bis unter 45;110786;55562;55224
LK09;Landkreise Bayern;45 bis unter 46;111868;56205;55663
LK09;Landkreise Bayern;46 bis unter 47;121351;60796;60555
LK09;Landkreise Bayern;47 bis unter 48;132144;66346;65798
LK09;Landkreise Bayern;48 bis unter 49;137704;69235;68469
LK09;Landkreise Bayern;49 bis unter 50;149883;75725;74158
LK09;Landkreise Bayern;50 bis unter 51;155968;78801;77167
LK09;Landkreise Bayern;51 bis unter 52;160164;81088;79076
LK09;Landkreise Bayern;52 bis unter 53;161950;81834;80116
LK09;Landkreise Bayern;53 bis unter 54;160790;81827;78963
LK09;Landkreise Bayern;54 bis unter 55;163562;82710;80852
LK09;Landkreise Bayern;55 bis unter 56;161233;81117;80116
LK09;Landkreise Bayern;56 bis unter 57;157034;78821;78213
LK09;Landkreise Bayern;57 bis unter 58;154514;77854;76660
LK09;Landkreise Bayern;58 bis unter 59;147610;74305;73305
LK09;Landkreise Bayern;59 bis unter 60;142738;71972;70766
LK09;Landkreise Bayern;60 bis unter 61;134768;67709;67059
LK09;Landkreise Bayern;61 bis unter 62;129860;64802;65058
LK09;Landkreise Bayern;62 bis unter 63;123804;62032;61772
LK09;Landkreise Bayern;63 bis unter 64;116177;57685;58492
LK09;Landkreise Bayern;64 bis unter 65;113315;55798;57517
LK09;Landkreise Bayern;65 bis unter 66;108492;53042;55450
LK09;Landkreise Bayern;66 bis unter 67;107821;52399;55422
LK09;Landkreise Bayern;67 bis unter 68;103888;50447;53441
LK09;Landkreise Bayern;68 bis unter 69;103548;50471;53077
LK09;Landkreise Bayern;69 bis unter 70;100415;48506;51909
LK09;Landkreise Bayern;70 bis unter 71;94168;45558;48610
LK09;Landkreise Bayern;71 bis unter 72;90285;43702;46583
LK09;Landkreise Bayern;72 bis unter 73;78356;37272;41084
LK09;Landkreise Bayern;73 bis unter 74;61095;28980;32115
LK09;Landkreise Bayern;74 bis unter 75;79297;37516;41781
LK09;Landkreise Bayern;75 bis unter 76;78312;36920;41392
LK09;Landkreise Bayern;76 bis unter 77;75479;35267;40212
LK09;Landkreise Bayern;77 bis unter 78;91226;41670;49556
LK09;Landkreise Bayern;78 bis unter 79;95824;43228;52596
LK09;Landkreise Bayern;79 bis unter 80;93103;41562;51541
LK09;Landkreise Bayern;80 bis unter 81;81082;35783;45299
LK09;Landkreise Bayern;81 bis unter 82;70751;30550;40201
LK09;Landkreise Bayern;82 bis unter 83;63769;26804;36965
LK09;Landkreise Bayern;83 bis unter 84;57290;23529;33761
LK09;Landkreise Bayern;84 bis unter 85;49340;19755;29585
LK09;Landkreise Bayern;85 bis unter 90;157448;57269;100179
LK09;Landkreise Bayern;90 bis unter 95;65189;19086;46103
LK09;Landkreise Bayern;95 oder älter;15713;3230;12483
LK09;Landkreise Bayern;Insgesamt;9210788;4593559;4617229
09;Bayern;unter 1;127510;65226;62284
09;Bayern;1 bis unter 2;128495;65516;62979
09;Bayern;2 bis unter 3;127859;65601;62258
09;Bayern;3 bis unter 4;123344;63157;60187
09;Bayern;4 bis unter 5;120799;62129;58670
09;Bayern;5 bis unter 6;117677;60015;57662
09;Bayern;6 bis unter 7;116369;59934;56435
09;Bayern;7 bis unter 8;112332;57799;54533
09;Bayern;8 bis unter 9;114013;58421;55592
09;Bayern;9 bis unter 10;112506;57814;54692
09;Bayern;10 bis unter 11;115677;59392;56285
09;Bayern;11 bis unter 12;115546;59172;56374
09;Bayern;12 bis unter 13;113410;58428;54982
09;Bayern;13 bis unter 14;115364;59296;56068
09;Bayern;14 bis unter 15;118206;60280;57926
09;Bayern;15 bis unter 16;119434;61129;58305
09;Bayern;16 bis unter 17;121664;62514;59150
09;Bayern;17 bis unter 18;125255;65153;60102
09;Bayern;18 bis unter 19;132890;69065;63825
09;Bayern;19 bis unter 20;140087;74309;65778
09;Bayern;20 bis unter 21;148298;78601;69697
09;Bayern;21 bis unter 22;155092;82041;73051
09;Bayern;22 bis unter 23;154949;81439;73510
09;Bayern;23 bis unter 24;154642;81251;73391
09;Bayern;24 bis unter 25;157936;82756;75180
09;Bayern;25 bis unter 26;165832;86680;79152
09;Bayern;26 bis unter 27;169147;87712;81435
09;Bayern;27 bis unter 28;173224;90507;82717
09;Bayern;28 bis unter 29;182175;95084;87091
09;Bayern;29 bis unter 30;177662;91975;85687
09;Bayern;30 bis unter 31;181510;94434;87076
09;Bayern;31 bis unter 32;176362;91866;84496
09;Bayern;32 bis unter 33;174933;90514;84419
09;Bayern;33 bis unter 34;168140;86454;81686
09;Bayern;34 bis unter 35;167927;86016;81911
09;Bayern;35 bis unter 36;168848;86487;82361
09;Bayern;36 bis unter 37;173073;87848;85225
09;Bayern;37 bis unter 38;172216;86924;85292
09;Bayern;38 bis unter 39;170998;86179;84819
09;Bayern;39 bis unter 40;163919;82601;81318
09;Bayern;40 bis unter 41;161228;80901;80327
09;Bayern;41 bis unter 42;160397;81025;79372
09;Bayern;42 bis unter 43;158870;80022;78848
09;Bayern;43 bis unter 44;155933;78353;77580
09;Bayern;44 bis unter 45;158397;79438;78959
09;Bayern;45 bis unter 46;157637;79062;78575
09;Bayern;46 bis unter 47;169862;85072;84790
09;Bayern;47 bis unter 48;183435;92159;91276
09;Bayern;48 bis unter 49;190209;95692;94517
09;Bayern;49 bis unter 50;205237;103968;101269
09;Bayern;50 bis unter 51;213462;108372;105090
09;Bayern;51 bis unter 52;218230;110538;107692
09;Bayern;52 bis unter 53;219356;110982;108374
09;Bayern;53 bis unter 54;217447;110558;106889
09;Bayern;54 bis unter 55;220509;111367;109142
09;Bayern;55 bis unter 56;216924;108908;108016
09;Bayern;56 bis unter 57;209599;104953;104646
09;Bayern;57 bis unter 58;206012;103208;102804
09;Bayern;58 bis unter 59;197108;98637;98471
09;Bayern;59 bis unter 60;190063;95056;95007
09;Bayern;60 bis unter 61;180050;89675;90375
09;Bayern;61 bis unter 62;173799;86095;87704
09;Bayern;62 bis unter 63;166436;82545;83891
09;Bayern;63 bis unter 64;156577;76617;79960
09;Bayern;64 bis unter 65;152060;73541;78519
09;Bayern;65 bis unter 66;145385;69843;75542
09;Bayern;66 bis unter 67;145315;69261;76054
09;Bayern;67 bis unter 68;139831;66583;73248
09;Bayern;68 bis unter 69;140667;67049;73618
09;Bayern;69 bis unter 70;136577;64891;71686
09;Bayern;70 bis unter 71;129252;61558;67694
09;Bayern;71 bis unter 72;125369;59707;65662
09;Bayern;72 bis unter 73;109521;51262;58259
09;Bayern;73 bis unter 74;87469;40757;46712
09;Bayern;74 bis unter 75;112496;52603;59893
09;Bayern;75 bis unter 76;111226;51716;59510
09;Bayern;76 bis unter 77;106508;49135;57373
09;Bayern;77 bis unter 78;127480;57425;70055
09;Bayern;78 bis unter 79;132859;58984;73875
09;Bayern;79 bis unter 80;127973;56330;71643
09;Bayern;80 bis unter 81;111851;48613;63238
09;Bayern;81 bis unter 82;98334;41806;56528
09;Bayern;82 bis unter 83;89001;37004;51997
09;Bayern;83 bis unter 84;79608;32121;47487
09;Bayern;84 bis unter 85;68769;27198;41571
09;Bayern;85 bis unter 90;220066;79551;140515
09;Bayern;90 bis unter 95;93795;27219;66576
09;Bayern;95 oder älter;23212;4714;18498
09;Bayern;Insgesamt;13076721;6483793;6592928
