code;name;nationality;agegroup;population_total;population_m;population_f
09161;      Ingolstadt (Krfr.St);Insgesamt;unter 6;8619;4432;4187
09161;      Ingolstadt (Krfr.St);Insgesamt;6 bis unter 15;10676;5487;5189
09161;      Ingolstadt (Krfr.St);Insgesamt;15 bis unter 18;3621;1928;1693
09161;      Ingolstadt (Krfr.St);Insgesamt;18 bis unter 25;11036;6018;5018
09161;      Ingolstadt (Krfr.St);Insgesamt;25 bis unter 30;10992;5815;5177
09161;      Ingolstadt (Krfr.St);Insgesamt;30 bis unter 40;21917;11737;10180
09161;      Ingolstadt (Krfr.St);Insgesamt;40 bis unter 50;17959;9308;8651
09161;      Ingolstadt (Krfr.St);Insgesamt;50 bis unter 65;27023;13618;13405
09161;      Ingolstadt (Krfr.St);Insgesamt;65 oder älter;25138;10909;14229
09161;      Ingolstadt (Krfr.St);Insgesamt;Insgesamt;136981;69252;67729
09161;      Ingolstadt (Krfr.St);Deutsche;unter 6;7213;3689;3524
09161;      Ingolstadt (Krfr.St);Deutsche;6 bis unter 15;9177;4709;4468
09161;      Ingolstadt (Krfr.St);Deutsche;15 bis unter 18;3152;1668;1484
09161;      Ingolstadt (Krfr.St);Deutsche;18 bis unter 25;7912;4129;3783
09161;      Ingolstadt (Krfr.St);Deutsche;25 bis unter 30;7711;3971;3740
09161;      Ingolstadt (Krfr.St);Deutsche;30 bis unter 40;16180;8808;7372
09161;      Ingolstadt (Krfr.St);Deutsche;40 bis unter 50;13317;6935;6382
09161;      Ingolstadt (Krfr.St);Deutsche;50 bis unter 65;23508;11822;11686
09161;      Ingolstadt (Krfr.St);Deutsche;65 oder älter;23187;9917;13270
09161;      Ingolstadt (Krfr.St);Deutsche;Insgesamt;111357;55648;55709
09161;      Ingolstadt (Krfr.St);Ausländer;unter 6;1406;743;663
09161;      Ingolstadt (Krfr.St);Ausländer;6 bis unter 15;1499;778;721
09161;      Ingolstadt (Krfr.St);Ausländer;15 bis unter 18;469;260;209
09161;      Ingolstadt (Krfr.St);Ausländer;18 bis unter 25;3124;1889;1235
09161;      Ingolstadt (Krfr.St);Ausländer;25 bis unter 30;3281;1844;1437
09161;      Ingolstadt (Krfr.St);Ausländer;30 bis unter 40;5737;2929;2808
09161;      Ingolstadt (Krfr.St);Ausländer;40 bis unter 50;4642;2373;2269
09161;      Ingolstadt (Krfr.St);Ausländer;50 bis unter 65;3515;1796;1719
09161;      Ingolstadt (Krfr.St);Ausländer;65 oder älter;1951;992;959
09161;      Ingolstadt (Krfr.St);Ausländer;Insgesamt;25624;13604;12020
09162;      München, Landeshauptstadt;Insgesamt;unter 6;92683;47261;45422
09162;      München, Landeshauptstadt;Insgesamt;6 bis unter 15;106907;54644;52263
09162;      München, Landeshauptstadt;Insgesamt;15 bis unter 18;32480;16765;15715
09162;      München, Landeshauptstadt;Insgesamt;18 bis unter 25;118117;59656;58461
09162;      München, Landeshauptstadt;Insgesamt;25 bis unter 30;134040;65095;68945
09162;      München, Landeshauptstadt;Insgesamt;30 bis unter 40;257247;128331;128916
09162;      München, Landeshauptstadt;Insgesamt;40 bis unter 50;201449;101188;100261
09162;      München, Landeshauptstadt;Insgesamt;50 bis unter 65;269295;133367;135928
09162;      München, Landeshauptstadt;Insgesamt;65 oder älter;259290;111001;148289
09162;      München, Landeshauptstadt;Insgesamt;Insgesamt;1471508;717308;754200
09162;      München, Landeshauptstadt;Deutsche;unter 6;75962;38710;37252
09162;      München, Landeshauptstadt;Deutsche;6 bis unter 15;87901;44859;43042
09162;      München, Landeshauptstadt;Deutsche;15 bis unter 18;25978;13397;12581
09162;      München, Landeshauptstadt;Deutsche;18 bis unter 25;73740;35638;38102
09162;      München, Landeshauptstadt;Deutsche;25 bis unter 30;87044;41212;45832
09162;      München, Landeshauptstadt;Deutsche;30 bis unter 40;174186;87215;86971
09162;      München, Landeshauptstadt;Deutsche;40 bis unter 50;136404;69718;66686
09162;      München, Landeshauptstadt;Deutsche;50 bis unter 65;210771;104404;106367
09162;      München, Landeshauptstadt;Deutsche;65 oder älter;217289;90649;126640
09162;      München, Landeshauptstadt;Deutsche;Insgesamt;1089275;525802;563473
09162;      München, Landeshauptstadt;Ausländer;unter 6;16721;8551;8170
09162;      München, Landeshauptstadt;Ausländer;6 bis unter 15;19006;9785;9221
09162;      München, Landeshauptstadt;Ausländer;15 bis unter 18;6502;3368;3134
09162;      München, Landeshauptstadt;Ausländer;18 bis unter 25;44377;24018;20359
09162;      München, Landeshauptstadt;Ausländer;25 bis unter 30;46996;23883;23113
09162;      München, Landeshauptstadt;Ausländer;30 bis unter 40;83061;41116;41945
09162;      München, Landeshauptstadt;Ausländer;40 bis unter 50;65045;31470;33575
09162;      München, Landeshauptstadt;Ausländer;50 bis unter 65;58524;28963;29561
09162;      München, Landeshauptstadt;Ausländer;65 oder älter;42001;20352;21649
09162;      München, Landeshauptstadt;Ausländer;Insgesamt;382233;191506;190727
09163;      Rosenheim (Krfr.St);Insgesamt;unter 6;3658;1945;1713
09163;      Rosenheim (Krfr.St);Insgesamt;6 bis unter 15;4952;2505;2447
09163;      Rosenheim (Krfr.St);Insgesamt;15 bis unter 18;1725;915;810
09163;      Rosenheim (Krfr.St);Insgesamt;18 bis unter 25;5416;2772;2644
09163;      Rosenheim (Krfr.St);Insgesamt;25 bis unter 30;4872;2617;2255
09163;      Rosenheim (Krfr.St);Insgesamt;30 bis unter 40;9020;4711;4309
09163;      Rosenheim (Krfr.St);Insgesamt;40 bis unter 50;8214;4190;4024
09163;      Rosenheim (Krfr.St);Insgesamt;50 bis unter 65;12735;6309;6426
09163;      Rosenheim (Krfr.St);Insgesamt;65 oder älter;12732;5357;7375
09163;      Rosenheim (Krfr.St);Insgesamt;Insgesamt;63324;31321;32003
09163;      Rosenheim (Krfr.St);Deutsche;unter 6;3006;1592;1414
09163;      Rosenheim (Krfr.St);Deutsche;6 bis unter 15;4265;2142;2123
09163;      Rosenheim (Krfr.St);Deutsche;15 bis unter 18;1421;739;682
09163;      Rosenheim (Krfr.St);Deutsche;18 bis unter 25;3769;1848;1921
09163;      Rosenheim (Krfr.St);Deutsche;25 bis unter 30;3539;1836;1703
09163;      Rosenheim (Krfr.St);Deutsche;30 bis unter 40;6286;3230;3056
09163;      Rosenheim (Krfr.St);Deutsche;40 bis unter 50;5652;2859;2793
09163;      Rosenheim (Krfr.St);Deutsche;50 bis unter 65;10590;5225;5365
09163;      Rosenheim (Krfr.St);Deutsche;65 oder älter;11416;4723;6693
09163;      Rosenheim (Krfr.St);Deutsche;Insgesamt;49944;24194;25750
09163;      Rosenheim (Krfr.St);Ausländer;unter 6;652;353;299
09163;      Rosenheim (Krfr.St);Ausländer;6 bis unter 15;687;363;324
09163;      Rosenheim (Krfr.St);Ausländer;15 bis unter 18;304;176;128
09163;      Rosenheim (Krfr.St);Ausländer;18 bis unter 25;1647;924;723
09163;      Rosenheim (Krfr.St);Ausländer;25 bis unter 30;1333;781;552
09163;      Rosenheim (Krfr.St);Ausländer;30 bis unter 40;2734;1481;1253
09163;      Rosenheim (Krfr.St);Ausländer;40 bis unter 50;2562;1331;1231
09163;      Rosenheim (Krfr.St);Ausländer;50 bis unter 65;2145;1084;1061
09163;      Rosenheim (Krfr.St);Ausländer;65 oder älter;1316;634;682
09163;      Rosenheim (Krfr.St);Ausländer;Insgesamt;13380;7127;6253
KS091;    Kreisfreie Städte Oberbayern;Insgesamt;unter 6;104960;53638;51322
KS091;    Kreisfreie Städte Oberbayern;Insgesamt;6 bis unter 15;122535;62636;59899
KS091;    Kreisfreie Städte Oberbayern;Insgesamt;15 bis unter 18;37826;19608;18218
KS091;    Kreisfreie Städte Oberbayern;Insgesamt;18 bis unter 25;134569;68446;66123
KS091;    Kreisfreie Städte Oberbayern;Insgesamt;25 bis unter 30;149904;73527;76377
KS091;    Kreisfreie Städte Oberbayern;Insgesamt;30 bis unter 40;288184;144779;143405
KS091;    Kreisfreie Städte Oberbayern;Insgesamt;40 bis unter 50;227622;114686;112936
KS091;    Kreisfreie Städte Oberbayern;Insgesamt;50 bis unter 65;309053;153294;155759
KS091;    Kreisfreie Städte Oberbayern;Insgesamt;65 oder älter;297160;127267;169893
KS091;    Kreisfreie Städte Oberbayern;Insgesamt;Insgesamt;1671813;817881;853932
KS091;    Kreisfreie Städte Oberbayern;Deutsche;unter 6;86181;43991;42190
KS091;    Kreisfreie Städte Oberbayern;Deutsche;6 bis unter 15;101343;51710;49633
KS091;    Kreisfreie Städte Oberbayern;Deutsche;15 bis unter 18;30551;15804;14747
KS091;    Kreisfreie Städte Oberbayern;Deutsche;18 bis unter 25;85421;41615;43806
KS091;    Kreisfreie Städte Oberbayern;Deutsche;25 bis unter 30;98294;47019;51275
KS091;    Kreisfreie Städte Oberbayern;Deutsche;30 bis unter 40;196652;99253;97399
KS091;    Kreisfreie Städte Oberbayern;Deutsche;40 bis unter 50;155373;79512;75861
KS091;    Kreisfreie Städte Oberbayern;Deutsche;50 bis unter 65;244869;121451;123418
KS091;    Kreisfreie Städte Oberbayern;Deutsche;65 oder älter;251892;105289;146603
KS091;    Kreisfreie Städte Oberbayern;Deutsche;Insgesamt;1250576;605644;644932
KS091;    Kreisfreie Städte Oberbayern;Ausländer;unter 6;18779;9647;9132
KS091;    Kreisfreie Städte Oberbayern;Ausländer;6 bis unter 15;21192;10926;10266
KS091;    Kreisfreie Städte Oberbayern;Ausländer;15 bis unter 18;7275;3804;3471
KS091;    Kreisfreie Städte Oberbayern;Ausländer;18 bis unter 25;49148;26831;22317
KS091;    Kreisfreie Städte Oberbayern;Ausländer;25 bis unter 30;51610;26508;25102
KS091;    Kreisfreie Städte Oberbayern;Ausländer;30 bis unter 40;91532;45526;46006
KS091;    Kreisfreie Städte Oberbayern;Ausländer;40 bis unter 50;72249;35174;37075
KS091;    Kreisfreie Städte Oberbayern;Ausländer;50 bis unter 65;64184;31843;32341
KS091;    Kreisfreie Städte Oberbayern;Ausländer;65 oder älter;45268;21978;23290
KS091;    Kreisfreie Städte Oberbayern;Ausländer;Insgesamt;421237;212237;209000
09171;      Altötting (Lkr);Insgesamt;unter 6;6362;3185;3177
09171;      Altötting (Lkr);Insgesamt;6 bis unter 15;9135;4690;4445
09171;      Altötting (Lkr);Insgesamt;15 bis unter 18;3289;1691;1598
09171;      Altötting (Lkr);Insgesamt;18 bis unter 25;8456;4506;3950
09171;      Altötting (Lkr);Insgesamt;25 bis unter 30;6493;3407;3086
09171;      Altötting (Lkr);Insgesamt;30 bis unter 40;13475;6973;6502
09171;      Altötting (Lkr);Insgesamt;40 bis unter 50;13836;7070;6766
09171;      Altötting (Lkr);Insgesamt;50 bis unter 65;25966;12952;13014
09171;      Altötting (Lkr);Insgesamt;65 oder älter;24198;10468;13730
09171;      Altötting (Lkr);Insgesamt;Insgesamt;111210;54942;56268
09171;      Altötting (Lkr);Deutsche;unter 6;5400;2711;2689
09171;      Altötting (Lkr);Deutsche;6 bis unter 15;8171;4196;3975
09171;      Altötting (Lkr);Deutsche;15 bis unter 18;3037;1556;1481
09171;      Altötting (Lkr);Deutsche;18 bis unter 25;7199;3751;3448
09171;      Altötting (Lkr);Deutsche;25 bis unter 30;5245;2703;2542
09171;      Altötting (Lkr);Deutsche;30 bis unter 40;10706;5471;5235
09171;      Altötting (Lkr);Deutsche;40 bis unter 50;11469;5727;5742
09171;      Altötting (Lkr);Deutsche;50 bis unter 65;23953;11880;12073
09171;      Altötting (Lkr);Deutsche;65 oder älter;23186;9965;13221
09171;      Altötting (Lkr);Deutsche;Insgesamt;98366;47960;50406
09171;      Altötting (Lkr);Ausländer;unter 6;962;474;488
09171;      Altötting (Lkr);Ausländer;6 bis unter 15;964;494;470
09171;      Altötting (Lkr);Ausländer;15 bis unter 18;252;135;117
09171;      Altötting (Lkr);Ausländer;18 bis unter 25;1257;755;502
09171;      Altötting (Lkr);Ausländer;25 bis unter 30;1248;704;544
09171;      Altötting (Lkr);Ausländer;30 bis unter 40;2769;1502;1267
09171;      Altötting (Lkr);Ausländer;40 bis unter 50;2367;1343;1024
09171;      Altötting (Lkr);Ausländer;50 bis unter 65;2013;1072;941
09171;      Altötting (Lkr);Ausländer;65 oder älter;1012;503;509
09171;      Altötting (Lkr);Ausländer;Insgesamt;12844;6982;5862
09172;      Berchtesgadener Land (Lkr);Insgesamt;unter 6;5677;2939;2738
09172;      Berchtesgadener Land (Lkr);Insgesamt;6 bis unter 15;7900;4052;3848
09172;      Berchtesgadener Land (Lkr);Insgesamt;15 bis unter 18;2749;1401;1348
09172;      Berchtesgadener Land (Lkr);Insgesamt;18 bis unter 25;8203;4390;3813
09172;      Berchtesgadener Land (Lkr);Insgesamt;25 bis unter 30;6723;3602;3121
09172;      Berchtesgadener Land (Lkr);Insgesamt;30 bis unter 40;13349;6923;6426
09172;      Berchtesgadener Land (Lkr);Insgesamt;40 bis unter 50;12864;6411;6453
09172;      Berchtesgadener Land (Lkr);Insgesamt;50 bis unter 65;23257;11493;11764
09172;      Berchtesgadener Land (Lkr);Insgesamt;65 oder älter;25000;10796;14204
09172;      Berchtesgadener Land (Lkr);Insgesamt;Insgesamt;105722;52007;53715
09172;      Berchtesgadener Land (Lkr);Deutsche;unter 6;4823;2492;2331
09172;      Berchtesgadener Land (Lkr);Deutsche;6 bis unter 15;6888;3547;3341
09172;      Berchtesgadener Land (Lkr);Deutsche;15 bis unter 18;2464;1252;1212
09172;      Berchtesgadener Land (Lkr);Deutsche;18 bis unter 25;6792;3681;3111
09172;      Berchtesgadener Land (Lkr);Deutsche;25 bis unter 30;5202;2853;2349
09172;      Berchtesgadener Land (Lkr);Deutsche;30 bis unter 40;9910;5165;4745
09172;      Berchtesgadener Land (Lkr);Deutsche;40 bis unter 50;9815;4855;4960
09172;      Berchtesgadener Land (Lkr);Deutsche;50 bis unter 65;19766;9785;9981
09172;      Berchtesgadener Land (Lkr);Deutsche;65 oder älter;22860;9832;13028
09172;      Berchtesgadener Land (Lkr);Deutsche;Insgesamt;88520;43462;45058
09172;      Berchtesgadener Land (Lkr);Ausländer;unter 6;854;447;407
09172;      Berchtesgadener Land (Lkr);Ausländer;6 bis unter 15;1012;505;507
09172;      Berchtesgadener Land (Lkr);Ausländer;15 bis unter 18;285;149;136
09172;      Berchtesgadener Land (Lkr);Ausländer;18 bis unter 25;1411;709;702
09172;      Berchtesgadener Land (Lkr);Ausländer;25 bis unter 30;1521;749;772
09172;      Berchtesgadener Land (Lkr);Ausländer;30 bis unter 40;3439;1758;1681
09172;      Berchtesgadener Land (Lkr);Ausländer;40 bis unter 50;3049;1556;1493
09172;      Berchtesgadener Land (Lkr);Ausländer;50 bis unter 65;3491;1708;1783
09172;      Berchtesgadener Land (Lkr);Ausländer;65 oder älter;2140;964;1176
09172;      Berchtesgadener Land (Lkr);Ausländer;Insgesamt;17202;8545;8657
09173;      Bad Tölz-Wolfratshausen (Lkr);Insgesamt;unter 6;7535;3873;3662
09173;      Bad Tölz-Wolfratshausen (Lkr);Insgesamt;6 bis unter 15;10682;5544;5138
09173;      Bad Tölz-Wolfratshausen (Lkr);Insgesamt;15 bis unter 18;3849;1948;1901
09173;      Bad Tölz-Wolfratshausen (Lkr);Insgesamt;18 bis unter 25;9740;5167;4573
09173;      Bad Tölz-Wolfratshausen (Lkr);Insgesamt;25 bis unter 30;7202;3821;3381
09173;      Bad Tölz-Wolfratshausen (Lkr);Insgesamt;30 bis unter 40;15228;7616;7612
09173;      Bad Tölz-Wolfratshausen (Lkr);Insgesamt;40 bis unter 50;16585;8126;8459
09173;      Bad Tölz-Wolfratshausen (Lkr);Insgesamt;50 bis unter 65;29261;14606;14655
09173;      Bad Tölz-Wolfratshausen (Lkr);Insgesamt;65 oder älter;27145;12030;15115
09173;      Bad Tölz-Wolfratshausen (Lkr);Insgesamt;Insgesamt;127227;62731;64496
09173;      Bad Tölz-Wolfratshausen (Lkr);Deutsche;unter 6;6529;3367;3162
09173;      Bad Tölz-Wolfratshausen (Lkr);Deutsche;6 bis unter 15;9657;4980;4677
09173;      Bad Tölz-Wolfratshausen (Lkr);Deutsche;15 bis unter 18;3561;1790;1771
09173;      Bad Tölz-Wolfratshausen (Lkr);Deutsche;18 bis unter 25;8019;4187;3832
09173;      Bad Tölz-Wolfratshausen (Lkr);Deutsche;25 bis unter 30;5557;2861;2696
09173;      Bad Tölz-Wolfratshausen (Lkr);Deutsche;30 bis unter 40;12034;5943;6091
09173;      Bad Tölz-Wolfratshausen (Lkr);Deutsche;40 bis unter 50;13523;6554;6969
09173;      Bad Tölz-Wolfratshausen (Lkr);Deutsche;50 bis unter 65;26530;13150;13380
09173;      Bad Tölz-Wolfratshausen (Lkr);Deutsche;65 oder älter;25751;11341;14410
09173;      Bad Tölz-Wolfratshausen (Lkr);Deutsche;Insgesamt;111161;54173;56988
09173;      Bad Tölz-Wolfratshausen (Lkr);Ausländer;unter 6;1006;506;500
09173;      Bad Tölz-Wolfratshausen (Lkr);Ausländer;6 bis unter 15;1025;564;461
09173;      Bad Tölz-Wolfratshausen (Lkr);Ausländer;15 bis unter 18;288;158;130
09173;      Bad Tölz-Wolfratshausen (Lkr);Ausländer;18 bis unter 25;1721;980;741
09173;      Bad Tölz-Wolfratshausen (Lkr);Ausländer;25 bis unter 30;1645;960;685
09173;      Bad Tölz-Wolfratshausen (Lkr);Ausländer;30 bis unter 40;3194;1673;1521
09173;      Bad Tölz-Wolfratshausen (Lkr);Ausländer;40 bis unter 50;3062;1572;1490
09173;      Bad Tölz-Wolfratshausen (Lkr);Ausländer;50 bis unter 65;2731;1456;1275
09173;      Bad Tölz-Wolfratshausen (Lkr);Ausländer;65 oder älter;1394;689;705
09173;      Bad Tölz-Wolfratshausen (Lkr);Ausländer;Insgesamt;16066;8558;7508
09174;      Dachau (Lkr);Insgesamt;unter 6;9409;4870;4539
09174;      Dachau (Lkr);Insgesamt;6 bis unter 15;13240;6744;6496
09174;      Dachau (Lkr);Insgesamt;15 bis unter 18;4503;2322;2181
09174;      Dachau (Lkr);Insgesamt;18 bis unter 25;11929;6456;5473
09174;      Dachau (Lkr);Insgesamt;25 bis unter 30;9434;4992;4442
09174;      Dachau (Lkr);Insgesamt;30 bis unter 40;21118;10765;10353
09174;      Dachau (Lkr);Insgesamt;40 bis unter 50;21517;10871;10646
09174;      Dachau (Lkr);Insgesamt;50 bis unter 65;34344;17408;16936
09174;      Dachau (Lkr);Insgesamt;65 oder älter;28390;12692;15698
09174;      Dachau (Lkr);Insgesamt;Insgesamt;153884;77120;76764
09174;      Dachau (Lkr);Deutsche;unter 6;8354;4341;4013
09174;      Dachau (Lkr);Deutsche;6 bis unter 15;11711;5995;5716
09174;      Dachau (Lkr);Deutsche;15 bis unter 18;4006;2075;1931
09174;      Dachau (Lkr);Deutsche;18 bis unter 25;9352;4858;4494
09174;      Dachau (Lkr);Deutsche;25 bis unter 30;6844;3511;3333
09174;      Dachau (Lkr);Deutsche;30 bis unter 40;15714;7791;7923
09174;      Dachau (Lkr);Deutsche;40 bis unter 50;16654;8275;8379
09174;      Dachau (Lkr);Deutsche;50 bis unter 65;30265;15131;15134
09174;      Dachau (Lkr);Deutsche;65 oder älter;26445;11730;14715
09174;      Dachau (Lkr);Deutsche;Insgesamt;129345;63707;65638
09174;      Dachau (Lkr);Ausländer;unter 6;1055;529;526
09174;      Dachau (Lkr);Ausländer;6 bis unter 15;1529;749;780
09174;      Dachau (Lkr);Ausländer;15 bis unter 18;497;247;250
09174;      Dachau (Lkr);Ausländer;18 bis unter 25;2577;1598;979
09174;      Dachau (Lkr);Ausländer;25 bis unter 30;2590;1481;1109
09174;      Dachau (Lkr);Ausländer;30 bis unter 40;5404;2974;2430
09174;      Dachau (Lkr);Ausländer;40 bis unter 50;4863;2596;2267
09174;      Dachau (Lkr);Ausländer;50 bis unter 65;4079;2277;1802
09174;      Dachau (Lkr);Ausländer;65 oder älter;1945;962;983
09174;      Dachau (Lkr);Ausländer;Insgesamt;24539;13413;11126
09175;      Ebersberg (Lkr);Insgesamt;unter 6;8908;4536;4372
09175;      Ebersberg (Lkr);Insgesamt;6 bis unter 15;13199;6856;6343
09175;      Ebersberg (Lkr);Insgesamt;15 bis unter 18;4398;2258;2140
09175;      Ebersberg (Lkr);Insgesamt;18 bis unter 25;11115;5994;5121
09175;      Ebersberg (Lkr);Insgesamt;25 bis unter 30;7790;4162;3628
09175;      Ebersberg (Lkr);Insgesamt;30 bis unter 40;17955;8897;9058
09175;      Ebersberg (Lkr);Insgesamt;40 bis unter 50;20634;10404;10230
09175;      Ebersberg (Lkr);Insgesamt;50 bis unter 65;31582;15966;15616
09175;      Ebersberg (Lkr);Insgesamt;65 oder älter;26561;11899;14662
09175;      Ebersberg (Lkr);Insgesamt;Insgesamt;142142;70972;71170
09175;      Ebersberg (Lkr);Deutsche;unter 6;7985;4083;3902
09175;      Ebersberg (Lkr);Deutsche;6 bis unter 15;12015;6238;5777
09175;      Ebersberg (Lkr);Deutsche;15 bis unter 18;4052;2077;1975
09175;      Ebersberg (Lkr);Deutsche;18 bis unter 25;9104;4729;4375
09175;      Ebersberg (Lkr);Deutsche;25 bis unter 30;5786;3017;2769
09175;      Ebersberg (Lkr);Deutsche;30 bis unter 40;13654;6575;7079
09175;      Ebersberg (Lkr);Deutsche;40 bis unter 50;16660;8339;8321
09175;      Ebersberg (Lkr);Deutsche;50 bis unter 65;28505;14341;14164
09175;      Ebersberg (Lkr);Deutsche;65 oder älter;25096;11175;13921
09175;      Ebersberg (Lkr);Deutsche;Insgesamt;122857;60574;62283
09175;      Ebersberg (Lkr);Ausländer;unter 6;923;453;470
09175;      Ebersberg (Lkr);Ausländer;6 bis unter 15;1184;618;566
09175;      Ebersberg (Lkr);Ausländer;15 bis unter 18;346;181;165
09175;      Ebersberg (Lkr);Ausländer;18 bis unter 25;2011;1265;746
09175;      Ebersberg (Lkr);Ausländer;25 bis unter 30;2004;1145;859
09175;      Ebersberg (Lkr);Ausländer;30 bis unter 40;4301;2322;1979
09175;      Ebersberg (Lkr);Ausländer;40 bis unter 50;3974;2065;1909
09175;      Ebersberg (Lkr);Ausländer;50 bis unter 65;3077;1625;1452
09175;      Ebersberg (Lkr);Ausländer;65 oder älter;1465;724;741
09175;      Ebersberg (Lkr);Ausländer;Insgesamt;19285;10398;8887
09176;      Eichstätt (Lkr);Insgesamt;unter 6;8664;4359;4305
09176;      Eichstätt (Lkr);Insgesamt;6 bis unter 15;11719;6062;5657
09176;      Eichstätt (Lkr);Insgesamt;15 bis unter 18;4215;2208;2007
09176;      Eichstätt (Lkr);Insgesamt;18 bis unter 25;11121;5933;5188
09176;      Eichstätt (Lkr);Insgesamt;25 bis unter 30;8333;4473;3860
09176;      Eichstätt (Lkr);Insgesamt;30 bis unter 40;17803;9192;8611
09176;      Eichstätt (Lkr);Insgesamt;40 bis unter 50;17675;9225;8450
09176;      Eichstätt (Lkr);Insgesamt;50 bis unter 65;29608;15225;14383
09176;      Eichstätt (Lkr);Insgesamt;65 oder älter;23203;10648;12555
09176;      Eichstätt (Lkr);Insgesamt;Insgesamt;132341;67325;65016
09176;      Eichstätt (Lkr);Deutsche;unter 6;7871;3964;3907
09176;      Eichstätt (Lkr);Deutsche;6 bis unter 15;10986;5682;5304
09176;      Eichstätt (Lkr);Deutsche;15 bis unter 18;3985;2075;1910
09176;      Eichstätt (Lkr);Deutsche;18 bis unter 25;9521;4894;4627
09176;      Eichstätt (Lkr);Deutsche;25 bis unter 30;6851;3570;3281
09176;      Eichstätt (Lkr);Deutsche;30 bis unter 40;15100;7676;7424
09176;      Eichstätt (Lkr);Deutsche;40 bis unter 50;15186;7795;7391
09176;      Eichstätt (Lkr);Deutsche;50 bis unter 65;27940;14236;13704
09176;      Eichstätt (Lkr);Deutsche;65 oder älter;22588;10343;12245
09176;      Eichstätt (Lkr);Deutsche;Insgesamt;120028;60235;59793
09176;      Eichstätt (Lkr);Ausländer;unter 6;793;395;398
09176;      Eichstätt (Lkr);Ausländer;6 bis unter 15;733;380;353
09176;      Eichstätt (Lkr);Ausländer;15 bis unter 18;230;133;97
09176;      Eichstätt (Lkr);Ausländer;18 bis unter 25;1600;1039;561
09176;      Eichstätt (Lkr);Ausländer;25 bis unter 30;1482;903;579
09176;      Eichstätt (Lkr);Ausländer;30 bis unter 40;2703;1516;1187
09176;      Eichstätt (Lkr);Ausländer;40 bis unter 50;2489;1430;1059
09176;      Eichstätt (Lkr);Ausländer;50 bis unter 65;1668;989;679
09176;      Eichstätt (Lkr);Ausländer;65 oder älter;615;305;310
09176;      Eichstätt (Lkr);Ausländer;Insgesamt;12313;7090;5223
09177;      Erding (Lkr);Insgesamt;unter 6;8323;4274;4049
09177;      Erding (Lkr);Insgesamt;6 bis unter 15;12071;6256;5815
09177;      Erding (Lkr);Insgesamt;15 bis unter 18;4283;2186;2097
09177;      Erding (Lkr);Insgesamt;18 bis unter 25;11171;5817;5354
09177;      Erding (Lkr);Insgesamt;25 bis unter 30;8540;4520;4020
09177;      Erding (Lkr);Insgesamt;30 bis unter 40;17925;9045;8880
09177;      Erding (Lkr);Insgesamt;40 bis unter 50;19984;10301;9683
09177;      Erding (Lkr);Insgesamt;50 bis unter 65;32092;16410;15682
09177;      Erding (Lkr);Insgesamt;65 oder älter;23271;10558;12713
09177;      Erding (Lkr);Insgesamt;Insgesamt;137660;69367;68293
09177;      Erding (Lkr);Deutsche;unter 6;7465;3810;3655
09177;      Erding (Lkr);Deutsche;6 bis unter 15;11118;5760;5358
09177;      Erding (Lkr);Deutsche;15 bis unter 18;3984;2027;1957
09177;      Erding (Lkr);Deutsche;18 bis unter 25;9562;4908;4654
09177;      Erding (Lkr);Deutsche;25 bis unter 30;6864;3567;3297
09177;      Erding (Lkr);Deutsche;30 bis unter 40;14368;7063;7305
09177;      Erding (Lkr);Deutsche;40 bis unter 50;16457;8372;8085
09177;      Erding (Lkr);Deutsche;50 bis unter 65;29494;14921;14573
09177;      Erding (Lkr);Deutsche;65 oder älter;22296;10077;12219
09177;      Erding (Lkr);Deutsche;Insgesamt;121608;60505;61103
09177;      Erding (Lkr);Ausländer;unter 6;858;464;394
09177;      Erding (Lkr);Ausländer;6 bis unter 15;953;496;457
09177;      Erding (Lkr);Ausländer;15 bis unter 18;299;159;140
09177;      Erding (Lkr);Ausländer;18 bis unter 25;1609;909;700
09177;      Erding (Lkr);Ausländer;25 bis unter 30;1676;953;723
09177;      Erding (Lkr);Ausländer;30 bis unter 40;3557;1982;1575
09177;      Erding (Lkr);Ausländer;40 bis unter 50;3527;1929;1598
09177;      Erding (Lkr);Ausländer;50 bis unter 65;2598;1489;1109
09177;      Erding (Lkr);Ausländer;65 oder älter;975;481;494
09177;      Erding (Lkr);Ausländer;Insgesamt;16052;8862;7190
09178;      Freising (Lkr);Insgesamt;unter 6;10999;5633;5366
09178;      Freising (Lkr);Insgesamt;6 bis unter 15;15118;7849;7269
09178;      Freising (Lkr);Insgesamt;15 bis unter 18;5251;2709;2542
09178;      Freising (Lkr);Insgesamt;18 bis unter 25;16136;8595;7541
09178;      Freising (Lkr);Insgesamt;25 bis unter 30;13272;7141;6131
09178;      Freising (Lkr);Insgesamt;30 bis unter 40;25598;13295;12303
09178;      Freising (Lkr);Insgesamt;40 bis unter 50;25437;13262;12175
09178;      Freising (Lkr);Insgesamt;50 bis unter 65;39068;20133;18935
09178;      Freising (Lkr);Insgesamt;65 oder älter;28237;12776;15461
09178;      Freising (Lkr);Insgesamt;Insgesamt;179116;91393;87723
09178;      Freising (Lkr);Deutsche;unter 6;9496;4842;4654
09178;      Freising (Lkr);Deutsche;6 bis unter 15;13505;6990;6515
09178;      Freising (Lkr);Deutsche;15 bis unter 18;4738;2440;2298
09178;      Freising (Lkr);Deutsche;18 bis unter 25;12611;6522;6089
09178;      Freising (Lkr);Deutsche;25 bis unter 30;9365;4934;4431
09178;      Freising (Lkr);Deutsche;30 bis unter 40;18352;9200;9152
09178;      Freising (Lkr);Deutsche;40 bis unter 50;19207;9785;9422
09178;      Freising (Lkr);Deutsche;50 bis unter 65;34361;17455;16906
09178;      Freising (Lkr);Deutsche;65 oder älter;26490;11938;14552
09178;      Freising (Lkr);Deutsche;Insgesamt;148125;74106;74019
09178;      Freising (Lkr);Ausländer;unter 6;1503;791;712
09178;      Freising (Lkr);Ausländer;6 bis unter 15;1613;859;754
09178;      Freising (Lkr);Ausländer;15 bis unter 18;513;269;244
09178;      Freising (Lkr);Ausländer;18 bis unter 25;3525;2073;1452
09178;      Freising (Lkr);Ausländer;25 bis unter 30;3907;2207;1700
09178;      Freising (Lkr);Ausländer;30 bis unter 40;7246;4095;3151
09178;      Freising (Lkr);Ausländer;40 bis unter 50;6230;3477;2753
09178;      Freising (Lkr);Ausländer;50 bis unter 65;4707;2678;2029
09178;      Freising (Lkr);Ausländer;65 oder älter;1747;838;909
09178;      Freising (Lkr);Ausländer;Insgesamt;30991;17287;13704
09179;      Fürstenfeldbruck (Lkr);Insgesamt;unter 6;13117;6669;6448
09179;      Fürstenfeldbruck (Lkr);Insgesamt;6 bis unter 15;19055;9769;9286
09179;      Fürstenfeldbruck (Lkr);Insgesamt;15 bis unter 18;6348;3171;3177
09179;      Fürstenfeldbruck (Lkr);Insgesamt;18 bis unter 25;16508;8825;7683
09179;      Fürstenfeldbruck (Lkr);Insgesamt;25 bis unter 30;12512;6533;5979
09179;      Fürstenfeldbruck (Lkr);Insgesamt;30 bis unter 40;27189;13622;13567
09179;      Fürstenfeldbruck (Lkr);Insgesamt;40 bis unter 50;29827;14889;14938
09179;      Fürstenfeldbruck (Lkr);Insgesamt;50 bis unter 65;47526;23493;24033
09179;      Fürstenfeldbruck (Lkr);Insgesamt;65 oder älter;47238;20715;26523
09179;      Fürstenfeldbruck (Lkr);Insgesamt;Insgesamt;219320;107686;111634
09179;      Fürstenfeldbruck (Lkr);Deutsche;unter 6;11355;5719;5636
09179;      Fürstenfeldbruck (Lkr);Deutsche;6 bis unter 15;16929;8660;8269
09179;      Fürstenfeldbruck (Lkr);Deutsche;15 bis unter 18;5693;2840;2853
09179;      Fürstenfeldbruck (Lkr);Deutsche;18 bis unter 25;12971;6841;6130
09179;      Fürstenfeldbruck (Lkr);Deutsche;25 bis unter 30;8934;4561;4373
09179;      Fürstenfeldbruck (Lkr);Deutsche;30 bis unter 40;19824;9718;10106
09179;      Fürstenfeldbruck (Lkr);Deutsche;40 bis unter 50;23578;11634;11944
09179;      Fürstenfeldbruck (Lkr);Deutsche;50 bis unter 65;42574;20939;21635
09179;      Fürstenfeldbruck (Lkr);Deutsche;65 oder älter;44457;19341;25116
09179;      Fürstenfeldbruck (Lkr);Deutsche;Insgesamt;186315;90253;96062
09179;      Fürstenfeldbruck (Lkr);Ausländer;unter 6;1762;950;812
09179;      Fürstenfeldbruck (Lkr);Ausländer;6 bis unter 15;2126;1109;1017
09179;      Fürstenfeldbruck (Lkr);Ausländer;15 bis unter 18;655;331;324
09179;      Fürstenfeldbruck (Lkr);Ausländer;18 bis unter 25;3537;1984;1553
09179;      Fürstenfeldbruck (Lkr);Ausländer;25 bis unter 30;3578;1972;1606
09179;      Fürstenfeldbruck (Lkr);Ausländer;30 bis unter 40;7365;3904;3461
09179;      Fürstenfeldbruck (Lkr);Ausländer;40 bis unter 50;6249;3255;2994
09179;      Fürstenfeldbruck (Lkr);Ausländer;50 bis unter 65;4952;2554;2398
09179;      Fürstenfeldbruck (Lkr);Ausländer;65 oder älter;2781;1374;1407
09179;      Fürstenfeldbruck (Lkr);Ausländer;Insgesamt;33005;17433;15572
09180;      Garmisch-Partenkirchen (Lkr);Insgesamt;unter 6;4703;2419;2284
09180;      Garmisch-Partenkirchen (Lkr);Insgesamt;6 bis unter 15;6421;3334;3087
09180;      Garmisch-Partenkirchen (Lkr);Insgesamt;15 bis unter 18;2339;1211;1128
09180;      Garmisch-Partenkirchen (Lkr);Insgesamt;18 bis unter 25;6729;3621;3108
09180;      Garmisch-Partenkirchen (Lkr);Insgesamt;25 bis unter 30;5121;2722;2399
09180;      Garmisch-Partenkirchen (Lkr);Insgesamt;30 bis unter 40;9899;4958;4941
09180;      Garmisch-Partenkirchen (Lkr);Insgesamt;40 bis unter 50;10705;5253;5452
09180;      Garmisch-Partenkirchen (Lkr);Insgesamt;50 bis unter 65;20377;9842;10535
09180;      Garmisch-Partenkirchen (Lkr);Insgesamt;65 oder älter;22173;9609;12564
09180;      Garmisch-Partenkirchen (Lkr);Insgesamt;Insgesamt;88467;42969;45498
09180;      Garmisch-Partenkirchen (Lkr);Deutsche;unter 6;4000;2030;1970
09180;      Garmisch-Partenkirchen (Lkr);Deutsche;6 bis unter 15;5728;2986;2742
09180;      Garmisch-Partenkirchen (Lkr);Deutsche;15 bis unter 18;2086;1060;1026
09180;      Garmisch-Partenkirchen (Lkr);Deutsche;18 bis unter 25;5542;2926;2616
09180;      Garmisch-Partenkirchen (Lkr);Deutsche;25 bis unter 30;3967;2099;1868
09180;      Garmisch-Partenkirchen (Lkr);Deutsche;30 bis unter 40;7640;3704;3936
09180;      Garmisch-Partenkirchen (Lkr);Deutsche;40 bis unter 50;8626;4140;4486
09180;      Garmisch-Partenkirchen (Lkr);Deutsche;50 bis unter 65;18216;8768;9448
09180;      Garmisch-Partenkirchen (Lkr);Deutsche;65 oder älter;20979;9023;11956
09180;      Garmisch-Partenkirchen (Lkr);Deutsche;Insgesamt;76784;36736;40048
09180;      Garmisch-Partenkirchen (Lkr);Ausländer;unter 6;703;389;314
09180;      Garmisch-Partenkirchen (Lkr);Ausländer;6 bis unter 15;693;348;345
09180;      Garmisch-Partenkirchen (Lkr);Ausländer;15 bis unter 18;253;151;102
09180;      Garmisch-Partenkirchen (Lkr);Ausländer;18 bis unter 25;1187;695;492
09180;      Garmisch-Partenkirchen (Lkr);Ausländer;25 bis unter 30;1154;623;531
09180;      Garmisch-Partenkirchen (Lkr);Ausländer;30 bis unter 40;2259;1254;1005
09180;      Garmisch-Partenkirchen (Lkr);Ausländer;40 bis unter 50;2079;1113;966
09180;      Garmisch-Partenkirchen (Lkr);Ausländer;50 bis unter 65;2161;1074;1087
09180;      Garmisch-Partenkirchen (Lkr);Ausländer;65 oder älter;1194;586;608
09180;      Garmisch-Partenkirchen (Lkr);Ausländer;Insgesamt;11683;6233;5450
09181;      Landsberg am Lech (Lkr);Insgesamt;unter 6;6800;3439;3361
09181;      Landsberg am Lech (Lkr);Insgesamt;6 bis unter 15;10457;5359;5098
09181;      Landsberg am Lech (Lkr);Insgesamt;15 bis unter 18;3820;1929;1891
09181;      Landsberg am Lech (Lkr);Insgesamt;18 bis unter 25;9658;5311;4347
09181;      Landsberg am Lech (Lkr);Insgesamt;25 bis unter 30;6669;3646;3023
09181;      Landsberg am Lech (Lkr);Insgesamt;30 bis unter 40;14043;7266;6777
09181;      Landsberg am Lech (Lkr);Insgesamt;40 bis unter 50;15919;7907;8012
09181;      Landsberg am Lech (Lkr);Insgesamt;50 bis unter 65;28744;14308;14436
09181;      Landsberg am Lech (Lkr);Insgesamt;65 oder älter;23961;10912;13049
09181;      Landsberg am Lech (Lkr);Insgesamt;Insgesamt;120071;60077;59994
09181;      Landsberg am Lech (Lkr);Deutsche;unter 6;6312;3177;3135
09181;      Landsberg am Lech (Lkr);Deutsche;6 bis unter 15;9845;5027;4818
09181;      Landsberg am Lech (Lkr);Deutsche;15 bis unter 18;3598;1813;1785
09181;      Landsberg am Lech (Lkr);Deutsche;18 bis unter 25;8436;4476;3960
09181;      Landsberg am Lech (Lkr);Deutsche;25 bis unter 30;5492;2856;2636
09181;      Landsberg am Lech (Lkr);Deutsche;30 bis unter 40;11786;5971;5815
09181;      Landsberg am Lech (Lkr);Deutsche;40 bis unter 50;14002;6869;7133
09181;      Landsberg am Lech (Lkr);Deutsche;50 bis unter 65;27023;13410;13613
09181;      Landsberg am Lech (Lkr);Deutsche;65 oder älter;23083;10505;12578
09181;      Landsberg am Lech (Lkr);Deutsche;Insgesamt;109577;54104;55473
09181;      Landsberg am Lech (Lkr);Ausländer;unter 6;488;262;226
09181;      Landsberg am Lech (Lkr);Ausländer;6 bis unter 15;612;332;280
09181;      Landsberg am Lech (Lkr);Ausländer;15 bis unter 18;222;116;106
09181;      Landsberg am Lech (Lkr);Ausländer;18 bis unter 25;1222;835;387
09181;      Landsberg am Lech (Lkr);Ausländer;25 bis unter 30;1177;790;387
09181;      Landsberg am Lech (Lkr);Ausländer;30 bis unter 40;2257;1295;962
09181;      Landsberg am Lech (Lkr);Ausländer;40 bis unter 50;1917;1038;879
09181;      Landsberg am Lech (Lkr);Ausländer;50 bis unter 65;1721;898;823
09181;      Landsberg am Lech (Lkr);Ausländer;65 oder älter;878;407;471
09181;      Landsberg am Lech (Lkr);Ausländer;Insgesamt;10494;5973;4521
09182;      Miesbach (Lkr);Insgesamt;unter 6;5524;2847;2677
09182;      Miesbach (Lkr);Insgesamt;6 bis unter 15;8101;4164;3937
09182;      Miesbach (Lkr);Insgesamt;15 bis unter 18;2799;1438;1361
09182;      Miesbach (Lkr);Insgesamt;18 bis unter 25;7252;3943;3309
09182;      Miesbach (Lkr);Insgesamt;25 bis unter 30;5549;2919;2630
09182;      Miesbach (Lkr);Insgesamt;30 bis unter 40;11599;5813;5786
09182;      Miesbach (Lkr);Insgesamt;40 bis unter 50;13136;6441;6695
09182;      Miesbach (Lkr);Insgesamt;50 bis unter 65;23214;11471;11743
09182;      Miesbach (Lkr);Insgesamt;65 oder älter;22552;9834;12718
09182;      Miesbach (Lkr);Insgesamt;Insgesamt;99726;48870;50856
09182;      Miesbach (Lkr);Deutsche;unter 6;4936;2553;2383
09182;      Miesbach (Lkr);Deutsche;6 bis unter 15;7433;3837;3596
09182;      Miesbach (Lkr);Deutsche;15 bis unter 18;2598;1332;1266
09182;      Miesbach (Lkr);Deutsche;18 bis unter 25;6079;3251;2828
09182;      Miesbach (Lkr);Deutsche;25 bis unter 30;4295;2197;2098
09182;      Miesbach (Lkr);Deutsche;30 bis unter 40;8957;4396;4561
09182;      Miesbach (Lkr);Deutsche;40 bis unter 50;10675;5164;5511
09182;      Miesbach (Lkr);Deutsche;50 bis unter 65;20942;10292;10650
09182;      Miesbach (Lkr);Deutsche;65 oder älter;21427;9265;12162
09182;      Miesbach (Lkr);Deutsche;Insgesamt;87342;42287;45055
09182;      Miesbach (Lkr);Ausländer;unter 6;588;294;294
09182;      Miesbach (Lkr);Ausländer;6 bis unter 15;668;327;341
09182;      Miesbach (Lkr);Ausländer;15 bis unter 18;201;106;95
09182;      Miesbach (Lkr);Ausländer;18 bis unter 25;1173;692;481
09182;      Miesbach (Lkr);Ausländer;25 bis unter 30;1254;722;532
09182;      Miesbach (Lkr);Ausländer;30 bis unter 40;2642;1417;1225
09182;      Miesbach (Lkr);Ausländer;40 bis unter 50;2461;1277;1184
09182;      Miesbach (Lkr);Ausländer;50 bis unter 65;2272;1179;1093
09182;      Miesbach (Lkr);Ausländer;65 oder älter;1125;569;556
09182;      Miesbach (Lkr);Ausländer;Insgesamt;12384;6583;5801
09183;      Mühldorf a.Inn (Lkr);Insgesamt;unter 6;6741;3556;3185
09183;      Mühldorf a.Inn (Lkr);Insgesamt;6 bis unter 15;9518;4913;4605
09183;      Mühldorf a.Inn (Lkr);Insgesamt;15 bis unter 18;3406;1723;1683
09183;      Mühldorf a.Inn (Lkr);Insgesamt;18 bis unter 25;9312;5000;4312
09183;      Mühldorf a.Inn (Lkr);Insgesamt;25 bis unter 30;7312;3971;3341
09183;      Mühldorf a.Inn (Lkr);Insgesamt;30 bis unter 40;14109;7515;6594
09183;      Mühldorf a.Inn (Lkr);Insgesamt;40 bis unter 50;15258;7866;7392
09183;      Mühldorf a.Inn (Lkr);Insgesamt;50 bis unter 65;26673;13599;13074
09183;      Mühldorf a.Inn (Lkr);Insgesamt;65 oder älter;22921;10217;12704
09183;      Mühldorf a.Inn (Lkr);Insgesamt;Insgesamt;115250;58360;56890
09183;      Mühldorf a.Inn (Lkr);Deutsche;unter 6;5927;3149;2778
09183;      Mühldorf a.Inn (Lkr);Deutsche;6 bis unter 15;8606;4444;4162
09183;      Mühldorf a.Inn (Lkr);Deutsche;15 bis unter 18;3104;1581;1523
09183;      Mühldorf a.Inn (Lkr);Deutsche;18 bis unter 25;7696;3958;3738
09183;      Mühldorf a.Inn (Lkr);Deutsche;25 bis unter 30;5773;3010;2763
09183;      Mühldorf a.Inn (Lkr);Deutsche;30 bis unter 40;11159;5821;5338
09183;      Mühldorf a.Inn (Lkr);Deutsche;40 bis unter 50;12450;6229;6221
09183;      Mühldorf a.Inn (Lkr);Deutsche;50 bis unter 65;24586;12449;12137
09183;      Mühldorf a.Inn (Lkr);Deutsche;65 oder älter;22086;9829;12257
09183;      Mühldorf a.Inn (Lkr);Deutsche;Insgesamt;101387;50470;50917
09183;      Mühldorf a.Inn (Lkr);Ausländer;unter 6;814;407;407
09183;      Mühldorf a.Inn (Lkr);Ausländer;6 bis unter 15;912;469;443
09183;      Mühldorf a.Inn (Lkr);Ausländer;15 bis unter 18;302;142;160
09183;      Mühldorf a.Inn (Lkr);Ausländer;18 bis unter 25;1616;1042;574
09183;      Mühldorf a.Inn (Lkr);Ausländer;25 bis unter 30;1539;961;578
09183;      Mühldorf a.Inn (Lkr);Ausländer;30 bis unter 40;2950;1694;1256
09183;      Mühldorf a.Inn (Lkr);Ausländer;40 bis unter 50;2808;1637;1171
09183;      Mühldorf a.Inn (Lkr);Ausländer;50 bis unter 65;2087;1150;937
09183;      Mühldorf a.Inn (Lkr);Ausländer;65 oder älter;835;388;447
09183;      Mühldorf a.Inn (Lkr);Ausländer;Insgesamt;13863;7890;5973
09184;      München (Lkr);Insgesamt;unter 6;20772;10603;10169
09184;      München (Lkr);Insgesamt;6 bis unter 15;32452;16723;15729
09184;      München (Lkr);Insgesamt;15 bis unter 18;10106;5255;4851
09184;      München (Lkr);Insgesamt;18 bis unter 25;27485;15223;12262
09184;      München (Lkr);Insgesamt;25 bis unter 30;20159;10778;9381
09184;      München (Lkr);Insgesamt;30 bis unter 40;43978;22157;21821
09184;      München (Lkr);Insgesamt;40 bis unter 50;49325;24488;24837
09184;      München (Lkr);Insgesamt;50 bis unter 65;73272;36751;36521
09184;      München (Lkr);Insgesamt;65 oder älter;71322;31623;39699
09184;      München (Lkr);Insgesamt;Insgesamt;348871;173601;175270
09184;      München (Lkr);Deutsche;unter 6;17982;9164;8818
09184;      München (Lkr);Deutsche;6 bis unter 15;28846;14900;13946
09184;      München (Lkr);Deutsche;15 bis unter 18;9013;4689;4324
09184;      München (Lkr);Deutsche;18 bis unter 25;21114;11441;9673
09184;      München (Lkr);Deutsche;25 bis unter 30;13668;7181;6487
09184;      München (Lkr);Deutsche;30 bis unter 40;30340;14813;15527
09184;      München (Lkr);Deutsche;40 bis unter 50;37340;18353;18987
09184;      München (Lkr);Deutsche;50 bis unter 65;63510;31671;31839
09184;      München (Lkr);Deutsche;65 oder älter;65779;28865;36914
09184;      München (Lkr);Deutsche;Insgesamt;287592;141077;146515
09184;      München (Lkr);Ausländer;unter 6;2790;1439;1351
09184;      München (Lkr);Ausländer;6 bis unter 15;3606;1823;1783
09184;      München (Lkr);Ausländer;15 bis unter 18;1093;566;527
09184;      München (Lkr);Ausländer;18 bis unter 25;6371;3782;2589
09184;      München (Lkr);Ausländer;25 bis unter 30;6491;3597;2894
09184;      München (Lkr);Ausländer;30 bis unter 40;13638;7344;6294
09184;      München (Lkr);Ausländer;40 bis unter 50;11985;6135;5850
09184;      München (Lkr);Ausländer;50 bis unter 65;9762;5080;4682
09184;      München (Lkr);Ausländer;65 oder älter;5543;2758;2785
09184;      München (Lkr);Ausländer;Insgesamt;61279;32524;28755
09185;      Neuburg-Schrobenhausen (Lkr);Insgesamt;unter 6;5896;2972;2924
09185;      Neuburg-Schrobenhausen (Lkr);Insgesamt;6 bis unter 15;8199;4228;3971
09185;      Neuburg-Schrobenhausen (Lkr);Insgesamt;15 bis unter 18;3000;1530;1470
09185;      Neuburg-Schrobenhausen (Lkr);Insgesamt;18 bis unter 25;7606;4090;3516
09185;      Neuburg-Schrobenhausen (Lkr);Insgesamt;25 bis unter 30;5843;3101;2742
09185;      Neuburg-Schrobenhausen (Lkr);Insgesamt;30 bis unter 40;12583;6479;6104
09185;      Neuburg-Schrobenhausen (Lkr);Insgesamt;40 bis unter 50;12893;6696;6197
09185;      Neuburg-Schrobenhausen (Lkr);Insgesamt;50 bis unter 65;22268;11297;10971
09185;      Neuburg-Schrobenhausen (Lkr);Insgesamt;65 oder älter;18392;8286;10106
09185;      Neuburg-Schrobenhausen (Lkr);Insgesamt;Insgesamt;96680;48679;48001
09185;      Neuburg-Schrobenhausen (Lkr);Deutsche;unter 6;5219;2635;2584
09185;      Neuburg-Schrobenhausen (Lkr);Deutsche;6 bis unter 15;7400;3785;3615
09185;      Neuburg-Schrobenhausen (Lkr);Deutsche;15 bis unter 18;2745;1387;1358
09185;      Neuburg-Schrobenhausen (Lkr);Deutsche;18 bis unter 25;6531;3415;3116
09185;      Neuburg-Schrobenhausen (Lkr);Deutsche;25 bis unter 30;4807;2517;2290
09185;      Neuburg-Schrobenhausen (Lkr);Deutsche;30 bis unter 40;10380;5243;5137
09185;      Neuburg-Schrobenhausen (Lkr);Deutsche;40 bis unter 50;10876;5495;5381
09185;      Neuburg-Schrobenhausen (Lkr);Deutsche;50 bis unter 65;20883;10500;10383
09185;      Neuburg-Schrobenhausen (Lkr);Deutsche;65 oder älter;17853;8028;9825
09185;      Neuburg-Schrobenhausen (Lkr);Deutsche;Insgesamt;86694;43005;43689
09185;      Neuburg-Schrobenhausen (Lkr);Ausländer;unter 6;677;337;340
09185;      Neuburg-Schrobenhausen (Lkr);Ausländer;6 bis unter 15;799;443;356
09185;      Neuburg-Schrobenhausen (Lkr);Ausländer;15 bis unter 18;255;143;112
09185;      Neuburg-Schrobenhausen (Lkr);Ausländer;18 bis unter 25;1075;675;400
09185;      Neuburg-Schrobenhausen (Lkr);Ausländer;25 bis unter 30;1036;584;452
09185;      Neuburg-Schrobenhausen (Lkr);Ausländer;30 bis unter 40;2203;1236;967
09185;      Neuburg-Schrobenhausen (Lkr);Ausländer;40 bis unter 50;2017;1201;816
09185;      Neuburg-Schrobenhausen (Lkr);Ausländer;50 bis unter 65;1385;797;588
09185;      Neuburg-Schrobenhausen (Lkr);Ausländer;65 oder älter;539;258;281
09185;      Neuburg-Schrobenhausen (Lkr);Ausländer;Insgesamt;9986;5674;4312
09186;      Pfaffenhofen a.d.Ilm (Lkr);Insgesamt;unter 6;7859;4007;3852
09186;      Pfaffenhofen a.d.Ilm (Lkr);Insgesamt;6 bis unter 15;10713;5475;5238
09186;      Pfaffenhofen a.d.Ilm (Lkr);Insgesamt;15 bis unter 18;3668;1869;1799
09186;      Pfaffenhofen a.d.Ilm (Lkr);Insgesamt;18 bis unter 25;9774;5252;4522
09186;      Pfaffenhofen a.d.Ilm (Lkr);Insgesamt;25 bis unter 30;7990;4333;3657
09186;      Pfaffenhofen a.d.Ilm (Lkr);Insgesamt;30 bis unter 40;17586;9142;8444
09186;      Pfaffenhofen a.d.Ilm (Lkr);Insgesamt;40 bis unter 50;17059;8972;8087
09186;      Pfaffenhofen a.d.Ilm (Lkr);Insgesamt;50 bis unter 65;29415;15055;14360
09186;      Pfaffenhofen a.d.Ilm (Lkr);Insgesamt;65 oder älter;23087;10534;12553
09186;      Pfaffenhofen a.d.Ilm (Lkr);Insgesamt;Insgesamt;127151;64639;62512
09186;      Pfaffenhofen a.d.Ilm (Lkr);Deutsche;unter 6;7109;3621;3488
09186;      Pfaffenhofen a.d.Ilm (Lkr);Deutsche;6 bis unter 15;9737;4987;4750
09186;      Pfaffenhofen a.d.Ilm (Lkr);Deutsche;15 bis unter 18;3407;1726;1681
09186;      Pfaffenhofen a.d.Ilm (Lkr);Deutsche;18 bis unter 25;8220;4265;3955
09186;      Pfaffenhofen a.d.Ilm (Lkr);Deutsche;25 bis unter 30;6392;3304;3088
09186;      Pfaffenhofen a.d.Ilm (Lkr);Deutsche;30 bis unter 40;14244;7214;7030
09186;      Pfaffenhofen a.d.Ilm (Lkr);Deutsche;40 bis unter 50;14235;7296;6939
09186;      Pfaffenhofen a.d.Ilm (Lkr);Deutsche;50 bis unter 65;27255;13801;13454
09186;      Pfaffenhofen a.d.Ilm (Lkr);Deutsche;65 oder älter;22328;10185;12143
09186;      Pfaffenhofen a.d.Ilm (Lkr);Deutsche;Insgesamt;112927;56399;56528
09186;      Pfaffenhofen a.d.Ilm (Lkr);Ausländer;unter 6;750;386;364
09186;      Pfaffenhofen a.d.Ilm (Lkr);Ausländer;6 bis unter 15;976;488;488
09186;      Pfaffenhofen a.d.Ilm (Lkr);Ausländer;15 bis unter 18;261;143;118
09186;      Pfaffenhofen a.d.Ilm (Lkr);Ausländer;18 bis unter 25;1554;987;567
09186;      Pfaffenhofen a.d.Ilm (Lkr);Ausländer;25 bis unter 30;1598;1029;569
09186;      Pfaffenhofen a.d.Ilm (Lkr);Ausländer;30 bis unter 40;3342;1928;1414
09186;      Pfaffenhofen a.d.Ilm (Lkr);Ausländer;40 bis unter 50;2824;1676;1148
09186;      Pfaffenhofen a.d.Ilm (Lkr);Ausländer;50 bis unter 65;2160;1254;906
09186;      Pfaffenhofen a.d.Ilm (Lkr);Ausländer;65 oder älter;759;349;410
09186;      Pfaffenhofen a.d.Ilm (Lkr);Ausländer;Insgesamt;14224;8240;5984
09187;      Rosenheim (Lkr);Insgesamt;unter 6;14752;7546;7206
09187;      Rosenheim (Lkr);Insgesamt;6 bis unter 15;21798;11294;10504
09187;      Rosenheim (Lkr);Insgesamt;15 bis unter 18;7997;4148;3849
09187;      Rosenheim (Lkr);Insgesamt;18 bis unter 25;20038;10855;9183
09187;      Rosenheim (Lkr);Insgesamt;25 bis unter 30;15141;7971;7170
09187;      Rosenheim (Lkr);Insgesamt;30 bis unter 40;30988;15891;15097
09187;      Rosenheim (Lkr);Insgesamt;40 bis unter 50;33806;16661;17145
09187;      Rosenheim (Lkr);Insgesamt;50 bis unter 65;60910;29985;30925
09187;      Rosenheim (Lkr);Insgesamt;65 oder älter;55553;24902;30651
09187;      Rosenheim (Lkr);Insgesamt;Insgesamt;260983;129253;131730
09187;      Rosenheim (Lkr);Deutsche;unter 6;13431;6847;6584
09187;      Rosenheim (Lkr);Deutsche;6 bis unter 15;20257;10454;9803
09187;      Rosenheim (Lkr);Deutsche;15 bis unter 18;7401;3806;3595
09187;      Rosenheim (Lkr);Deutsche;18 bis unter 25;17423;9235;8188
09187;      Rosenheim (Lkr);Deutsche;25 bis unter 30;12444;6419;6025
09187;      Rosenheim (Lkr);Deutsche;30 bis unter 40;25518;12817;12701
09187;      Rosenheim (Lkr);Deutsche;40 bis unter 50;28497;13907;14590
09187;      Rosenheim (Lkr);Deutsche;50 bis unter 65;56145;27581;28564
09187;      Rosenheim (Lkr);Deutsche;65 oder älter;53082;23690;29392
09187;      Rosenheim (Lkr);Deutsche;Insgesamt;234198;114756;119442
09187;      Rosenheim (Lkr);Ausländer;unter 6;1321;699;622
09187;      Rosenheim (Lkr);Ausländer;6 bis unter 15;1541;840;701
09187;      Rosenheim (Lkr);Ausländer;15 bis unter 18;596;342;254
09187;      Rosenheim (Lkr);Ausländer;18 bis unter 25;2615;1620;995
09187;      Rosenheim (Lkr);Ausländer;25 bis unter 30;2697;1552;1145
09187;      Rosenheim (Lkr);Ausländer;30 bis unter 40;5470;3074;2396
09187;      Rosenheim (Lkr);Ausländer;40 bis unter 50;5309;2754;2555
09187;      Rosenheim (Lkr);Ausländer;50 bis unter 65;4765;2404;2361
09187;      Rosenheim (Lkr);Ausländer;65 oder älter;2471;1212;1259
09187;      Rosenheim (Lkr);Ausländer;Insgesamt;26785;14497;12288
09188;      Starnberg (Lkr);Insgesamt;unter 6;7562;3860;3702
09188;      Starnberg (Lkr);Insgesamt;6 bis unter 15;12512;6430;6082
09188;      Starnberg (Lkr);Insgesamt;15 bis unter 18;4411;2247;2164
09188;      Starnberg (Lkr);Insgesamt;18 bis unter 25;9878;5259;4619
09188;      Starnberg (Lkr);Insgesamt;25 bis unter 30;6539;3437;3102
09188;      Starnberg (Lkr);Insgesamt;30 bis unter 40;14328;6923;7405
09188;      Starnberg (Lkr);Insgesamt;40 bis unter 50;18215;8735;9480
09188;      Starnberg (Lkr);Insgesamt;50 bis unter 65;31471;15280;16191
09188;      Starnberg (Lkr);Insgesamt;65 oder älter;31176;13849;17327
09188;      Starnberg (Lkr);Insgesamt;Insgesamt;136092;66020;70072
09188;      Starnberg (Lkr);Deutsche;unter 6;6625;3362;3263
09188;      Starnberg (Lkr);Deutsche;6 bis unter 15;11187;5744;5443
09188;      Starnberg (Lkr);Deutsche;15 bis unter 18;3937;2007;1930
09188;      Starnberg (Lkr);Deutsche;18 bis unter 25;7871;4118;3753
09188;      Starnberg (Lkr);Deutsche;25 bis unter 30;4603;2371;2232
09188;      Starnberg (Lkr);Deutsche;30 bis unter 40;10556;5019;5537
09188;      Starnberg (Lkr);Deutsche;40 bis unter 50;14465;6900;7565
09188;      Starnberg (Lkr);Deutsche;50 bis unter 65;28029;13577;14452
09188;      Starnberg (Lkr);Deutsche;65 oder älter;29362;12978;16384
09188;      Starnberg (Lkr);Deutsche;Insgesamt;116635;56076;60559
09188;      Starnberg (Lkr);Ausländer;unter 6;937;498;439
09188;      Starnberg (Lkr);Ausländer;6 bis unter 15;1325;686;639
09188;      Starnberg (Lkr);Ausländer;15 bis unter 18;474;240;234
09188;      Starnberg (Lkr);Ausländer;18 bis unter 25;2007;1141;866
09188;      Starnberg (Lkr);Ausländer;25 bis unter 30;1936;1066;870
09188;      Starnberg (Lkr);Ausländer;30 bis unter 40;3772;1904;1868
09188;      Starnberg (Lkr);Ausländer;40 bis unter 50;3750;1835;1915
09188;      Starnberg (Lkr);Ausländer;50 bis unter 65;3442;1703;1739
09188;      Starnberg (Lkr);Ausländer;65 oder älter;1814;871;943
09188;      Starnberg (Lkr);Ausländer;Insgesamt;19457;9944;9513
09189;      Traunstein (Lkr);Insgesamt;unter 6;9568;4868;4700
09189;      Traunstein (Lkr);Insgesamt;6 bis unter 15;14072;7127;6945
09189;      Traunstein (Lkr);Insgesamt;15 bis unter 18;5065;2672;2393
09189;      Traunstein (Lkr);Insgesamt;18 bis unter 25;13656;7326;6330
09189;      Traunstein (Lkr);Insgesamt;25 bis unter 30;10637;5557;5080
09189;      Traunstein (Lkr);Insgesamt;30 bis unter 40;20717;10738;9979
09189;      Traunstein (Lkr);Insgesamt;40 bis unter 50;22050;11020;11030
09189;      Traunstein (Lkr);Insgesamt;50 bis unter 65;41191;20376;20815
09189;      Traunstein (Lkr);Insgesamt;65 oder älter;40133;17880;22253
09189;      Traunstein (Lkr);Insgesamt;Insgesamt;177089;87564;89525
09189;      Traunstein (Lkr);Deutsche;unter 6;8645;4400;4245
09189;      Traunstein (Lkr);Deutsche;6 bis unter 15;12953;6551;6402
09189;      Traunstein (Lkr);Deutsche;15 bis unter 18;4692;2480;2212
09189;      Traunstein (Lkr);Deutsche;18 bis unter 25;11694;6092;5602
09189;      Traunstein (Lkr);Deutsche;25 bis unter 30;8848;4543;4305
09189;      Traunstein (Lkr);Deutsche;30 bis unter 40;17098;8757;8341
09189;      Traunstein (Lkr);Deutsche;40 bis unter 50;18543;9116;9427
09189;      Traunstein (Lkr);Deutsche;50 bis unter 65;38213;18848;19365
09189;      Traunstein (Lkr);Deutsche;65 oder älter;38428;17038;21390
09189;      Traunstein (Lkr);Deutsche;Insgesamt;159114;77825;81289
09189;      Traunstein (Lkr);Ausländer;unter 6;923;468;455
09189;      Traunstein (Lkr);Ausländer;6 bis unter 15;1119;576;543
09189;      Traunstein (Lkr);Ausländer;15 bis unter 18;373;192;181
09189;      Traunstein (Lkr);Ausländer;18 bis unter 25;1962;1234;728
09189;      Traunstein (Lkr);Ausländer;25 bis unter 30;1789;1014;775
09189;      Traunstein (Lkr);Ausländer;30 bis unter 40;3619;1981;1638
09189;      Traunstein (Lkr);Ausländer;40 bis unter 50;3507;1904;1603
09189;      Traunstein (Lkr);Ausländer;50 bis unter 65;2978;1528;1450
09189;      Traunstein (Lkr);Ausländer;65 oder älter;1705;842;863
09189;      Traunstein (Lkr);Ausländer;Insgesamt;17975;9739;8236
09190;      Weilheim-Schongau (Lkr);Insgesamt;unter 6;7812;3983;3829
09190;      Weilheim-Schongau (Lkr);Insgesamt;6 bis unter 15;11395;5859;5536
09190;      Weilheim-Schongau (Lkr);Insgesamt;15 bis unter 18;4167;2158;2009
09190;      Weilheim-Schongau (Lkr);Insgesamt;18 bis unter 25;10292;5557;4735
09190;      Weilheim-Schongau (Lkr);Insgesamt;25 bis unter 30;7699;4094;3605
09190;      Weilheim-Schongau (Lkr);Insgesamt;30 bis unter 40;15908;8109;7799
09190;      Weilheim-Schongau (Lkr);Insgesamt;40 bis unter 50;17012;8387;8625
09190;      Weilheim-Schongau (Lkr);Insgesamt;50 bis unter 65;31884;15855;16029
09190;      Weilheim-Schongau (Lkr);Insgesamt;65 oder älter;29179;13319;15860
09190;      Weilheim-Schongau (Lkr);Insgesamt;Insgesamt;135348;67321;68027
09190;      Weilheim-Schongau (Lkr);Deutsche;unter 6;7207;3660;3547
09190;      Weilheim-Schongau (Lkr);Deutsche;6 bis unter 15;10661;5476;5185
09190;      Weilheim-Schongau (Lkr);Deutsche;15 bis unter 18;3870;1993;1877
09190;      Weilheim-Schongau (Lkr);Deutsche;18 bis unter 25;8803;4640;4163
09190;      Weilheim-Schongau (Lkr);Deutsche;25 bis unter 30;6382;3297;3085
09190;      Weilheim-Schongau (Lkr);Deutsche;30 bis unter 40;13334;6649;6685
09190;      Weilheim-Schongau (Lkr);Deutsche;40 bis unter 50;14486;7100;7386
09190;      Weilheim-Schongau (Lkr);Deutsche;50 bis unter 65;29662;14675;14987
09190;      Weilheim-Schongau (Lkr);Deutsche;65 oder älter;27954;12703;15251
09190;      Weilheim-Schongau (Lkr);Deutsche;Insgesamt;122359;60193;62166
09190;      Weilheim-Schongau (Lkr);Ausländer;unter 6;605;323;282
09190;      Weilheim-Schongau (Lkr);Ausländer;6 bis unter 15;734;383;351
09190;      Weilheim-Schongau (Lkr);Ausländer;15 bis unter 18;297;165;132
09190;      Weilheim-Schongau (Lkr);Ausländer;18 bis unter 25;1489;917;572
09190;      Weilheim-Schongau (Lkr);Ausländer;25 bis unter 30;1317;797;520
09190;      Weilheim-Schongau (Lkr);Ausländer;30 bis unter 40;2574;1460;1114
09190;      Weilheim-Schongau (Lkr);Ausländer;40 bis unter 50;2526;1287;1239
09190;      Weilheim-Schongau (Lkr);Ausländer;50 bis unter 65;2222;1180;1042
09190;      Weilheim-Schongau (Lkr);Ausländer;65 oder älter;1225;616;609
09190;      Weilheim-Schongau (Lkr);Ausländer;Insgesamt;12989;7128;5861
LK091;    Landkreise Oberbayern;Insgesamt;unter 6;176983;90438;86545
LK091;    Landkreise Oberbayern;Insgesamt;6 bis unter 15;257757;132728;125029
LK091;    Landkreise Oberbayern;Insgesamt;15 bis unter 18;89663;46074;43589
LK091;    Landkreise Oberbayern;Insgesamt;18 bis unter 25;236059;127120;108939
LK091;    Landkreise Oberbayern;Insgesamt;25 bis unter 30;178958;95180;83778
LK091;    Landkreise Oberbayern;Insgesamt;30 bis unter 40;375378;191319;184059
LK091;    Landkreise Oberbayern;Insgesamt;40 bis unter 50;403737;202985;200752
LK091;    Landkreise Oberbayern;Insgesamt;50 bis unter 65;682123;341505;340618
LK091;    Landkreise Oberbayern;Insgesamt;65 oder älter;613692;273547;340145
LK091;    Landkreise Oberbayern;Insgesamt;Insgesamt;3014350;1500896;1513454
LK091;    Landkreise Oberbayern;Deutsche;unter 6;156671;79927;76744
LK091;    Landkreise Oberbayern;Deutsche;6 bis unter 15;233633;120239;113394
LK091;    Landkreise Oberbayern;Deutsche;15 bis unter 18;81971;42006;39965
LK091;    Landkreise Oberbayern;Deutsche;18 bis unter 25;194540;102188;92352
LK091;    Landkreise Oberbayern;Deutsche;25 bis unter 30;137319;71371;65948
LK091;    Landkreise Oberbayern;Deutsche;30 bis unter 40;290674;145006;145668
LK091;    Landkreise Oberbayern;Deutsche;40 bis unter 50;326744;161905;164839
LK091;    Landkreise Oberbayern;Deutsche;50 bis unter 65;617852;307410;310442
LK091;    Landkreise Oberbayern;Deutsche;65 oder älter;581530;257851;323679
LK091;    Landkreise Oberbayern;Deutsche;Insgesamt;2620934;1287903;1333031
LK091;    Landkreise Oberbayern;Ausländer;unter 6;20312;10511;9801
LK091;    Landkreise Oberbayern;Ausländer;6 bis unter 15;24124;12489;11635
LK091;    Landkreise Oberbayern;Ausländer;15 bis unter 18;7692;4068;3624
LK091;    Landkreise Oberbayern;Ausländer;18 bis unter 25;41519;24932;16587
LK091;    Landkreise Oberbayern;Ausländer;25 bis unter 30;41639;23809;17830
LK091;    Landkreise Oberbayern;Ausländer;30 bis unter 40;84704;46313;38391
LK091;    Landkreise Oberbayern;Ausländer;40 bis unter 50;76993;41080;35913
LK091;    Landkreise Oberbayern;Ausländer;50 bis unter 65;64271;34095;30176
LK091;    Landkreise Oberbayern;Ausländer;65 oder älter;32162;15696;16466
LK091;    Landkreise Oberbayern;Ausländer;Insgesamt;393416;212993;180423
091;  Oberbayern;Insgesamt;unter 6;281943;144076;137867
091;  Oberbayern;Insgesamt;6 bis unter 15;380292;195364;184928
091;  Oberbayern;Insgesamt;15 bis unter 18;127489;65682;61807
091;  Oberbayern;Insgesamt;18 bis unter 25;370628;195566;175062
091;  Oberbayern;Insgesamt;25 bis unter 30;328862;168707;160155
091;  Oberbayern;Insgesamt;30 bis unter 40;663562;336098;327464
091;  Oberbayern;Insgesamt;40 bis unter 50;631359;317671;313688
091;  Oberbayern;Insgesamt;50 bis unter 65;991176;494799;496377
091;  Oberbayern;Insgesamt;65 oder älter;910852;400814;510038
091;  Oberbayern;Insgesamt;Insgesamt;4686163;2318777;2367386
091;  Oberbayern;Deutsche;unter 6;242852;123918;118934
091;  Oberbayern;Deutsche;6 bis unter 15;334976;171949;163027
091;  Oberbayern;Deutsche;15 bis unter 18;112522;57810;54712
091;  Oberbayern;Deutsche;18 bis unter 25;279961;143803;136158
091;  Oberbayern;Deutsche;25 bis unter 30;235613;118390;117223
091;  Oberbayern;Deutsche;30 bis unter 40;487326;244259;243067
091;  Oberbayern;Deutsche;40 bis unter 50;482117;241417;240700
091;  Oberbayern;Deutsche;50 bis unter 65;862721;428861;433860
091;  Oberbayern;Deutsche;65 oder älter;833422;363140;470282
091;  Oberbayern;Deutsche;Insgesamt;3871510;1893547;1977963
091;  Oberbayern;Ausländer;unter 6;39091;20158;18933
091;  Oberbayern;Ausländer;6 bis unter 15;45316;23415;21901
091;  Oberbayern;Ausländer;15 bis unter 18;14967;7872;7095
091;  Oberbayern;Ausländer;18 bis unter 25;90667;51763;38904
091;  Oberbayern;Ausländer;25 bis unter 30;93249;50317;42932
091;  Oberbayern;Ausländer;30 bis unter 40;176236;91839;84397
091;  Oberbayern;Ausländer;40 bis unter 50;149242;76254;72988
091;  Oberbayern;Ausländer;50 bis unter 65;128455;65938;62517
091;  Oberbayern;Ausländer;65 oder älter;77430;37674;39756
091;  Oberbayern;Ausländer;Insgesamt;814653;425230;389423
09261;      Landshut (Krfr.St);Insgesamt;unter 6;3962;2013;1949
09261;      Landshut (Krfr.St);Insgesamt;6 bis unter 15;5440;2778;2662
09261;      Landshut (Krfr.St);Insgesamt;15 bis unter 18;1801;916;885
09261;      Landshut (Krfr.St);Insgesamt;18 bis unter 25;6087;3178;2909
09261;      Landshut (Krfr.St);Insgesamt;25 bis unter 30;5672;2969;2703
09261;      Landshut (Krfr.St);Insgesamt;30 bis unter 40;10162;5204;4958
09261;      Landshut (Krfr.St);Insgesamt;40 bis unter 50;9683;4879;4804
09261;      Landshut (Krfr.St);Insgesamt;50 bis unter 65;14797;7273;7524
09261;      Landshut (Krfr.St);Insgesamt;65 oder älter;14800;6193;8607
09261;      Landshut (Krfr.St);Insgesamt;Insgesamt;72404;35403;37001
09261;      Landshut (Krfr.St);Deutsche;unter 6;3206;1629;1577
09261;      Landshut (Krfr.St);Deutsche;6 bis unter 15;4549;2340;2209
09261;      Landshut (Krfr.St);Deutsche;15 bis unter 18;1507;763;744
09261;      Landshut (Krfr.St);Deutsche;18 bis unter 25;4487;2206;2281
09261;      Landshut (Krfr.St);Deutsche;25 bis unter 30;4053;2036;2017
09261;      Landshut (Krfr.St);Deutsche;30 bis unter 40;7090;3509;3581
09261;      Landshut (Krfr.St);Deutsche;40 bis unter 50;7106;3502;3604
09261;      Landshut (Krfr.St);Deutsche;50 bis unter 65;12871;6240;6631
09261;      Landshut (Krfr.St);Deutsche;65 oder älter;13879;5788;8091
09261;      Landshut (Krfr.St);Deutsche;Insgesamt;58748;28013;30735
09261;      Landshut (Krfr.St);Ausländer;unter 6;756;384;372
09261;      Landshut (Krfr.St);Ausländer;6 bis unter 15;891;438;453
09261;      Landshut (Krfr.St);Ausländer;15 bis unter 18;294;153;141
09261;      Landshut (Krfr.St);Ausländer;18 bis unter 25;1600;972;628
09261;      Landshut (Krfr.St);Ausländer;25 bis unter 30;1619;933;686
09261;      Landshut (Krfr.St);Ausländer;30 bis unter 40;3072;1695;1377
09261;      Landshut (Krfr.St);Ausländer;40 bis unter 50;2577;1377;1200
09261;      Landshut (Krfr.St);Ausländer;50 bis unter 65;1926;1033;893
09261;      Landshut (Krfr.St);Ausländer;65 oder älter;921;405;516
09261;      Landshut (Krfr.St);Ausländer;Insgesamt;13656;7390;6266
09262;      Passau (Krfr.St);Insgesamt;unter 6;2367;1186;1181
09262;      Passau (Krfr.St);Insgesamt;6 bis unter 15;3224;1619;1605
09262;      Passau (Krfr.St);Insgesamt;15 bis unter 18;1188;606;582
09262;      Passau (Krfr.St);Insgesamt;18 bis unter 25;6529;3081;3448
09262;      Passau (Krfr.St);Insgesamt;25 bis unter 30;5064;2671;2393
09262;      Passau (Krfr.St);Insgesamt;30 bis unter 40;7056;3735;3321
09262;      Passau (Krfr.St);Insgesamt;40 bis unter 50;5635;2857;2778
09262;      Passau (Krfr.St);Insgesamt;50 bis unter 65;10188;4963;5225
09262;      Passau (Krfr.St);Insgesamt;65 oder älter;11218;4626;6592
09262;      Passau (Krfr.St);Insgesamt;Insgesamt;52469;25344;27125
09262;      Passau (Krfr.St);Deutsche;unter 6;1919;957;962
09262;      Passau (Krfr.St);Deutsche;6 bis unter 15;2736;1354;1382
09262;      Passau (Krfr.St);Deutsche;15 bis unter 18;1046;524;522
09262;      Passau (Krfr.St);Deutsche;18 bis unter 25;5090;2287;2803
09262;      Passau (Krfr.St);Deutsche;25 bis unter 30;3669;1875;1794
09262;      Passau (Krfr.St);Deutsche;30 bis unter 40;5499;2886;2613
09262;      Passau (Krfr.St);Deutsche;40 bis unter 50;4467;2225;2242
09262;      Passau (Krfr.St);Deutsche;50 bis unter 65;9186;4420;4766
09262;      Passau (Krfr.St);Deutsche;65 oder älter;10635;4345;6290
09262;      Passau (Krfr.St);Deutsche;Insgesamt;44247;20873;23374
09262;      Passau (Krfr.St);Ausländer;unter 6;448;229;219
09262;      Passau (Krfr.St);Ausländer;6 bis unter 15;488;265;223
09262;      Passau (Krfr.St);Ausländer;15 bis unter 18;142;82;60
09262;      Passau (Krfr.St);Ausländer;18 bis unter 25;1439;794;645
09262;      Passau (Krfr.St);Ausländer;25 bis unter 30;1395;796;599
09262;      Passau (Krfr.St);Ausländer;30 bis unter 40;1557;849;708
09262;      Passau (Krfr.St);Ausländer;40 bis unter 50;1168;632;536
09262;      Passau (Krfr.St);Ausländer;50 bis unter 65;1002;543;459
09262;      Passau (Krfr.St);Ausländer;65 oder älter;583;281;302
09262;      Passau (Krfr.St);Ausländer;Insgesamt;8222;4471;3751
09263;      Straubing (Krfr.St);Insgesamt;unter 6;2379;1220;1159
09263;      Straubing (Krfr.St);Insgesamt;6 bis unter 15;3364;1755;1609
09263;      Straubing (Krfr.St);Insgesamt;15 bis unter 18;1164;609;555
09263;      Straubing (Krfr.St);Insgesamt;18 bis unter 25;3758;1985;1773
09263;      Straubing (Krfr.St);Insgesamt;25 bis unter 30;3650;2082;1568
09263;      Straubing (Krfr.St);Insgesamt;30 bis unter 40;6440;3494;2946
09263;      Straubing (Krfr.St);Insgesamt;40 bis unter 50;6187;3269;2918
09263;      Straubing (Krfr.St);Insgesamt;50 bis unter 65;10680;5374;5306
09263;      Straubing (Krfr.St);Insgesamt;65 oder älter;10172;4329;5843
09263;      Straubing (Krfr.St);Insgesamt;Insgesamt;47794;24117;23677
09263;      Straubing (Krfr.St);Deutsche;unter 6;1848;962;886
09263;      Straubing (Krfr.St);Deutsche;6 bis unter 15;2809;1498;1311
09263;      Straubing (Krfr.St);Deutsche;15 bis unter 18;996;517;479
09263;      Straubing (Krfr.St);Deutsche;18 bis unter 25;2777;1361;1416
09263;      Straubing (Krfr.St);Deutsche;25 bis unter 30;2671;1457;1214
09263;      Straubing (Krfr.St);Deutsche;30 bis unter 40;4835;2566;2269
09263;      Straubing (Krfr.St);Deutsche;40 bis unter 50;4651;2466;2185
09263;      Straubing (Krfr.St);Deutsche;50 bis unter 65;9636;4822;4814
09263;      Straubing (Krfr.St);Deutsche;65 oder älter;9748;4154;5594
09263;      Straubing (Krfr.St);Deutsche;Insgesamt;39971;19803;20168
09263;      Straubing (Krfr.St);Ausländer;unter 6;531;258;273
09263;      Straubing (Krfr.St);Ausländer;6 bis unter 15;555;257;298
09263;      Straubing (Krfr.St);Ausländer;15 bis unter 18;168;92;76
09263;      Straubing (Krfr.St);Ausländer;18 bis unter 25;981;624;357
09263;      Straubing (Krfr.St);Ausländer;25 bis unter 30;979;625;354
09263;      Straubing (Krfr.St);Ausländer;30 bis unter 40;1605;928;677
09263;      Straubing (Krfr.St);Ausländer;40 bis unter 50;1536;803;733
09263;      Straubing (Krfr.St);Ausländer;50 bis unter 65;1044;552;492
09263;      Straubing (Krfr.St);Ausländer;65 oder älter;424;175;249
09263;      Straubing (Krfr.St);Ausländer;Insgesamt;7823;4314;3509
KS092;    Kreisfreie Städte Niederbayern;Insgesamt;unter 6;8708;4419;4289
KS092;    Kreisfreie Städte Niederbayern;Insgesamt;6 bis unter 15;12028;6152;5876
KS092;    Kreisfreie Städte Niederbayern;Insgesamt;15 bis unter 18;4153;2131;2022
KS092;    Kreisfreie Städte Niederbayern;Insgesamt;18 bis unter 25;16374;8244;8130
KS092;    Kreisfreie Städte Niederbayern;Insgesamt;25 bis unter 30;14386;7722;6664
KS092;    Kreisfreie Städte Niederbayern;Insgesamt;30 bis unter 40;23658;12433;11225
KS092;    Kreisfreie Städte Niederbayern;Insgesamt;40 bis unter 50;21505;11005;10500
KS092;    Kreisfreie Städte Niederbayern;Insgesamt;50 bis unter 65;35665;17610;18055
KS092;    Kreisfreie Städte Niederbayern;Insgesamt;65 oder älter;36190;15148;21042
KS092;    Kreisfreie Städte Niederbayern;Insgesamt;Insgesamt;172667;84864;87803
KS092;    Kreisfreie Städte Niederbayern;Deutsche;unter 6;6973;3548;3425
KS092;    Kreisfreie Städte Niederbayern;Deutsche;6 bis unter 15;10094;5192;4902
KS092;    Kreisfreie Städte Niederbayern;Deutsche;15 bis unter 18;3549;1804;1745
KS092;    Kreisfreie Städte Niederbayern;Deutsche;18 bis unter 25;12354;5854;6500
KS092;    Kreisfreie Städte Niederbayern;Deutsche;25 bis unter 30;10393;5368;5025
KS092;    Kreisfreie Städte Niederbayern;Deutsche;30 bis unter 40;17424;8961;8463
KS092;    Kreisfreie Städte Niederbayern;Deutsche;40 bis unter 50;16224;8193;8031
KS092;    Kreisfreie Städte Niederbayern;Deutsche;50 bis unter 65;31693;15482;16211
KS092;    Kreisfreie Städte Niederbayern;Deutsche;65 oder älter;34262;14287;19975
KS092;    Kreisfreie Städte Niederbayern;Deutsche;Insgesamt;142966;68689;74277
KS092;    Kreisfreie Städte Niederbayern;Ausländer;unter 6;1735;871;864
KS092;    Kreisfreie Städte Niederbayern;Ausländer;6 bis unter 15;1934;960;974
KS092;    Kreisfreie Städte Niederbayern;Ausländer;15 bis unter 18;604;327;277
KS092;    Kreisfreie Städte Niederbayern;Ausländer;18 bis unter 25;4020;2390;1630
KS092;    Kreisfreie Städte Niederbayern;Ausländer;25 bis unter 30;3993;2354;1639
KS092;    Kreisfreie Städte Niederbayern;Ausländer;30 bis unter 40;6234;3472;2762
KS092;    Kreisfreie Städte Niederbayern;Ausländer;40 bis unter 50;5281;2812;2469
KS092;    Kreisfreie Städte Niederbayern;Ausländer;50 bis unter 65;3972;2128;1844
KS092;    Kreisfreie Städte Niederbayern;Ausländer;65 oder älter;1928;861;1067
KS092;    Kreisfreie Städte Niederbayern;Ausländer;Insgesamt;29701;16175;13526
09271;      Deggendorf (Lkr);Insgesamt;unter 6;6167;3157;3010
09271;      Deggendorf (Lkr);Insgesamt;6 bis unter 15;9286;4732;4554
09271;      Deggendorf (Lkr);Insgesamt;15 bis unter 18;3479;1816;1663
09271;      Deggendorf (Lkr);Insgesamt;18 bis unter 25;10047;5413;4634
09271;      Deggendorf (Lkr);Insgesamt;25 bis unter 30;7650;4093;3557
09271;      Deggendorf (Lkr);Insgesamt;30 bis unter 40;14670;7632;7038
09271;      Deggendorf (Lkr);Insgesamt;40 bis unter 50;15446;7847;7599
09271;      Deggendorf (Lkr);Insgesamt;50 bis unter 65;28322;14115;14207
09271;      Deggendorf (Lkr);Insgesamt;65 oder älter;24259;10742;13517
09271;      Deggendorf (Lkr);Insgesamt;Insgesamt;119326;59547;59779
09271;      Deggendorf (Lkr);Deutsche;unter 6;5483;2783;2700
09271;      Deggendorf (Lkr);Deutsche;6 bis unter 15;8530;4357;4173
09271;      Deggendorf (Lkr);Deutsche;15 bis unter 18;3220;1671;1549
09271;      Deggendorf (Lkr);Deutsche;18 bis unter 25;8548;4481;4067
09271;      Deggendorf (Lkr);Deutsche;25 bis unter 30;6378;3328;3050
09271;      Deggendorf (Lkr);Deutsche;30 bis unter 40;12326;6325;6001
09271;      Deggendorf (Lkr);Deutsche;40 bis unter 50;13377;6676;6701
09271;      Deggendorf (Lkr);Deutsche;50 bis unter 65;26898;13298;13600
09271;      Deggendorf (Lkr);Deutsche;65 oder älter;23709;10483;13226
09271;      Deggendorf (Lkr);Deutsche;Insgesamt;108469;53402;55067
09271;      Deggendorf (Lkr);Ausländer;unter 6;684;374;310
09271;      Deggendorf (Lkr);Ausländer;6 bis unter 15;756;375;381
09271;      Deggendorf (Lkr);Ausländer;15 bis unter 18;259;145;114
09271;      Deggendorf (Lkr);Ausländer;18 bis unter 25;1499;932;567
09271;      Deggendorf (Lkr);Ausländer;25 bis unter 30;1272;765;507
09271;      Deggendorf (Lkr);Ausländer;30 bis unter 40;2344;1307;1037
09271;      Deggendorf (Lkr);Ausländer;40 bis unter 50;2069;1171;898
09271;      Deggendorf (Lkr);Ausländer;50 bis unter 65;1424;817;607
09271;      Deggendorf (Lkr);Ausländer;65 oder älter;550;259;291
09271;      Deggendorf (Lkr);Ausländer;Insgesamt;10857;6145;4712
09272;      Freyung-Grafenau (Lkr);Insgesamt;unter 6;3965;2005;1960
09272;      Freyung-Grafenau (Lkr);Insgesamt;6 bis unter 15;5611;2885;2726
09272;      Freyung-Grafenau (Lkr);Insgesamt;15 bis unter 18;2393;1263;1130
09272;      Freyung-Grafenau (Lkr);Insgesamt;18 bis unter 25;6127;3283;2844
09272;      Freyung-Grafenau (Lkr);Insgesamt;25 bis unter 30;4540;2391;2149
09272;      Freyung-Grafenau (Lkr);Insgesamt;30 bis unter 40;8739;4497;4242
09272;      Freyung-Grafenau (Lkr);Insgesamt;40 bis unter 50;9945;5002;4943
09272;      Freyung-Grafenau (Lkr);Insgesamt;50 bis unter 65;20065;10053;10012
09272;      Freyung-Grafenau (Lkr);Insgesamt;65 oder älter;16970;7724;9246
09272;      Freyung-Grafenau (Lkr);Insgesamt;Insgesamt;78355;39103;39252
09272;      Freyung-Grafenau (Lkr);Deutsche;unter 6;3705;1870;1835
09272;      Freyung-Grafenau (Lkr);Deutsche;6 bis unter 15;5333;2729;2604
09272;      Freyung-Grafenau (Lkr);Deutsche;15 bis unter 18;2298;1200;1098
09272;      Freyung-Grafenau (Lkr);Deutsche;18 bis unter 25;5737;3008;2729
09272;      Freyung-Grafenau (Lkr);Deutsche;25 bis unter 30;4178;2185;1993
09272;      Freyung-Grafenau (Lkr);Deutsche;30 bis unter 40;7942;4052;3890
09272;      Freyung-Grafenau (Lkr);Deutsche;40 bis unter 50;9182;4597;4585
09272;      Freyung-Grafenau (Lkr);Deutsche;50 bis unter 65;19428;9737;9691
09272;      Freyung-Grafenau (Lkr);Deutsche;65 oder älter;16680;7585;9095
09272;      Freyung-Grafenau (Lkr);Deutsche;Insgesamt;74483;36963;37520
09272;      Freyung-Grafenau (Lkr);Ausländer;unter 6;260;135;125
09161;      Freyung-Grafenau (Lkr);Ausländer;6 bis unter 15;278;156;122
09161;      Freyung-Grafenau (Lkr);Ausländer;15 bis unter 18;95;63;32
09161;      Freyung-Grafenau (Lkr);Ausländer;18 bis unter 25;390;275;115
09161;      Freyung-Grafenau (Lkr);Ausländer;25 bis unter 30;362;206;156
09161;      Freyung-Grafenau (Lkr);Ausländer;30 bis unter 40;797;445;352
09161;      Freyung-Grafenau (Lkr);Ausländer;40 bis unter 50;763;405;358
09161;      Freyung-Grafenau (Lkr);Ausländer;50 bis unter 65;637;316;321
09161;      Freyung-Grafenau (Lkr);Ausländer;65 oder älter;290;139;151
09161;      Freyung-Grafenau (Lkr);Ausländer;Insgesamt;3872;2140;1732
09161;      Kelheim (Lkr);Insgesamt;unter 6;7140;3679;3461
09161;      Kelheim (Lkr);Insgesamt;6 bis unter 15;10563;5419;5144
09161;      Kelheim (Lkr);Insgesamt;15 bis unter 18;3783;1918;1865
09161;      Kelheim (Lkr);Insgesamt;18 bis unter 25;10047;5438;4609
09161;      Kelheim (Lkr);Insgesamt;25 bis unter 30;7733;4203;3530
09161;      Kelheim (Lkr);Insgesamt;30 bis unter 40;15731;8300;7431
09161;      Kelheim (Lkr);Insgesamt;40 bis unter 50;16593;8563;8030
09161;      Kelheim (Lkr);Insgesamt;50 bis unter 65;27966;14402;13564
09161;      Kelheim (Lkr);Insgesamt;65 oder älter;22702;10215;12487
09161;      Kelheim (Lkr);Insgesamt;Insgesamt;122258;62137;60121
09161;      Kelheim (Lkr);Deutsche;unter 6;6206;3220;2986
09161;      Kelheim (Lkr);Deutsche;6 bis unter 15;9370;4779;4591
09161;      Kelheim (Lkr);Deutsche;15 bis unter 18;3394;1700;1694
09161;      Kelheim (Lkr);Deutsche;18 bis unter 25;8297;4363;3934
09161;      Kelheim (Lkr);Deutsche;25 bis unter 30;5956;3165;2791
09161;      Kelheim (Lkr);Deutsche;30 bis unter 40;12242;6259;5983
09161;      Kelheim (Lkr);Deutsche;40 bis unter 50;13671;6896;6775
09161;      Kelheim (Lkr);Deutsche;50 bis unter 65;26025;13245;12780
09161;      Kelheim (Lkr);Deutsche;65 oder älter;21942;9819;12123
09161;      Kelheim (Lkr);Deutsche;Insgesamt;107103;53446;53657
09161;      Kelheim (Lkr);Ausländer;unter 6;934;459;475
09162;      Kelheim (Lkr);Ausländer;6 bis unter 15;1193;640;553
09162;      Kelheim (Lkr);Ausländer;15 bis unter 18;389;218;171
09162;      Kelheim (Lkr);Ausländer;18 bis unter 25;1750;1075;675
09162;      Kelheim (Lkr);Ausländer;25 bis unter 30;1777;1038;739
09162;      Kelheim (Lkr);Ausländer;30 bis unter 40;3489;2041;1448
09162;      Kelheim (Lkr);Ausländer;40 bis unter 50;2922;1667;1255
09162;      Kelheim (Lkr);Ausländer;50 bis unter 65;1941;1157;784
09162;      Kelheim (Lkr);Ausländer;65 oder älter;760;396;364
09162;      Kelheim (Lkr);Ausländer;Insgesamt;15155;8691;6464
09162;      Landshut (Lkr);Insgesamt;unter 6;9426;4838;4588
09162;      Landshut (Lkr);Insgesamt;6 bis unter 15;13825;7140;6685
09162;      Landshut (Lkr);Insgesamt;15 bis unter 18;4806;2469;2337
09162;      Landshut (Lkr);Insgesamt;18 bis unter 25;12446;6705;5741
09162;      Landshut (Lkr);Insgesamt;25 bis unter 30;9188;5001;4187
09162;      Landshut (Lkr);Insgesamt;30 bis unter 40;19788;10294;9494
09162;      Landshut (Lkr);Insgesamt;40 bis unter 50;22085;11288;10797
09162;      Landshut (Lkr);Insgesamt;50 bis unter 65;37604;19260;18344
09162;      Landshut (Lkr);Insgesamt;65 oder älter;29530;13524;16006
09162;      Landshut (Lkr);Insgesamt;Insgesamt;158698;80519;78179
09162;      Landshut (Lkr);Deutsche;unter 6;8454;4329;4125
09162;      Landshut (Lkr);Deutsche;6 bis unter 15;12731;6571;6160
09162;      Landshut (Lkr);Deutsche;15 bis unter 18;4468;2274;2194
09162;      Landshut (Lkr);Deutsche;18 bis unter 25;10765;5663;5102
09162;      Landshut (Lkr);Deutsche;25 bis unter 30;7468;3934;3534
09162;      Landshut (Lkr);Deutsche;30 bis unter 40;16161;8180;7981
09162;      Landshut (Lkr);Deutsche;40 bis unter 50;18888;9427;9461
09162;      Landshut (Lkr);Deutsche;50 bis unter 65;35426;17971;17455
09162;      Landshut (Lkr);Deutsche;65 oder älter;28706;13140;15566
09162;      Landshut (Lkr);Deutsche;Insgesamt;143067;71489;71578
09162;      Landshut (Lkr);Ausländer;unter 6;972;509;463
09163;      Landshut (Lkr);Ausländer;6 bis unter 15;1094;569;525
09163;      Landshut (Lkr);Ausländer;15 bis unter 18;338;195;143
09163;      Landshut (Lkr);Ausländer;18 bis unter 25;1681;1042;639
09163;      Landshut (Lkr);Ausländer;25 bis unter 30;1720;1067;653
09163;      Landshut (Lkr);Ausländer;30 bis unter 40;3627;2114;1513
09163;      Landshut (Lkr);Ausländer;40 bis unter 50;3197;1861;1336
09163;      Landshut (Lkr);Ausländer;50 bis unter 65;2178;1289;889
09163;      Landshut (Lkr);Ausländer;65 oder älter;824;384;440
09163;      Landshut (Lkr);Ausländer;Insgesamt;15631;9030;6601
09163;      Passau (Lkr);Insgesamt;unter 6;9818;4999;4819
09163;      Passau (Lkr);Insgesamt;6 bis unter 15;14842;7695;7147
09163;      Passau (Lkr);Insgesamt;15 bis unter 18;5624;2944;2680
09163;      Passau (Lkr);Insgesamt;18 bis unter 25;14727;7818;6909
09163;      Passau (Lkr);Insgesamt;25 bis unter 30;11009;5822;5187
09163;      Passau (Lkr);Insgesamt;30 bis unter 40;22292;11481;10811
09163;      Passau (Lkr);Insgesamt;40 bis unter 50;25007;12737;12270
09163;      Passau (Lkr);Insgesamt;50 bis unter 65;46460;23170;23290
09163;      Passau (Lkr);Insgesamt;65 oder älter;42264;18805;23459
09163;      Passau (Lkr);Insgesamt;Insgesamt;192043;95471;96572
09163;      Passau (Lkr);Deutsche;unter 6;8698;4435;4263
09163;      Passau (Lkr);Deutsche;6 bis unter 15;13626;7062;6564
09163;      Passau (Lkr);Deutsche;15 bis unter 18;5282;2756;2526
09163;      Passau (Lkr);Deutsche;18 bis unter 25;13126;6803;6323
09163;      Passau (Lkr);Deutsche;25 bis unter 30;9511;4949;4562
09163;      Passau (Lkr);Deutsche;30 bis unter 40;19077;9619;9458
09163;      Passau (Lkr);Deutsche;40 bis unter 50;21956;10980;10976
09163;      Passau (Lkr);Deutsche;50 bis unter 65;43998;21806;22192
09163;      Passau (Lkr);Deutsche;65 oder älter;41178;18251;22927
09163;      Passau (Lkr);Deutsche;Insgesamt;176452;86661;89791
09163;      Passau (Lkr);Ausländer;unter 6;1120;564;556
KS091;      Passau (Lkr);Ausländer;6 bis unter 15;1216;633;583
KS091;      Passau (Lkr);Ausländer;15 bis unter 18;342;188;154
KS091;      Passau (Lkr);Ausländer;18 bis unter 25;1601;1015;586
KS091;      Passau (Lkr);Ausländer;25 bis unter 30;1498;873;625
KS091;      Passau (Lkr);Ausländer;30 bis unter 40;3215;1862;1353
KS091;      Passau (Lkr);Ausländer;40 bis unter 50;3051;1757;1294
KS091;      Passau (Lkr);Ausländer;50 bis unter 65;2462;1364;1098
KS091;      Passau (Lkr);Ausländer;65 oder älter;1086;554;532
KS091;      Passau (Lkr);Ausländer;Insgesamt;15591;8810;6781
KS091;      Regen (Lkr);Insgesamt;unter 6;3974;2043;1931
KS091;      Regen (Lkr);Insgesamt;6 bis unter 15;5781;3019;2762
KS091;      Regen (Lkr);Insgesamt;15 bis unter 18;2231;1175;1056
KS091;      Regen (Lkr);Insgesamt;18 bis unter 25;5986;3206;2780
KS091;      Regen (Lkr);Insgesamt;25 bis unter 30;4566;2469;2097
KS091;      Regen (Lkr);Insgesamt;30 bis unter 40;8979;4708;4271
KS091;      Regen (Lkr);Insgesamt;40 bis unter 50;9754;4900;4854
KS091;      Regen (Lkr);Insgesamt;50 bis unter 65;19113;9552;9561
KS091;      Regen (Lkr);Insgesamt;65 oder älter;17272;7673;9599
KS091;      Regen (Lkr);Insgesamt;Insgesamt;77656;38745;38911
KS091;      Regen (Lkr);Deutsche;unter 6;3549;1823;1726
KS091;      Regen (Lkr);Deutsche;6 bis unter 15;5300;2777;2523
KS091;      Regen (Lkr);Deutsche;15 bis unter 18;2084;1100;984
KS091;      Regen (Lkr);Deutsche;18 bis unter 25;5367;2793;2574
KS091;      Regen (Lkr);Deutsche;25 bis unter 30;4092;2171;1921
KS091;      Regen (Lkr);Deutsche;30 bis unter 40;8056;4181;3875
KS091;      Regen (Lkr);Deutsche;40 bis unter 50;8739;4400;4339
KS091;      Regen (Lkr);Deutsche;50 bis unter 65;18447;9209;9238
KS091;      Regen (Lkr);Deutsche;65 oder älter;17010;7534;9476
KS091;      Regen (Lkr);Deutsche;Insgesamt;72644;35988;36656
KS091;      Regen (Lkr);Ausländer;unter 6;425;220;205
09171;      Regen (Lkr);Ausländer;6 bis unter 15;481;242;239
09171;      Regen (Lkr);Ausländer;15 bis unter 18;147;75;72
09171;      Regen (Lkr);Ausländer;18 bis unter 25;619;413;206
09171;      Regen (Lkr);Ausländer;25 bis unter 30;474;298;176
09171;      Regen (Lkr);Ausländer;30 bis unter 40;923;527;396
09171;      Regen (Lkr);Ausländer;40 bis unter 50;1015;500;515
09171;      Regen (Lkr);Ausländer;50 bis unter 65;666;343;323
09171;      Regen (Lkr);Ausländer;65 oder älter;262;139;123
09171;      Regen (Lkr);Ausländer;Insgesamt;5012;2757;2255
09171;      Rottal-Inn (Lkr);Insgesamt;unter 6;6414;3319;3095
09171;      Rottal-Inn (Lkr);Insgesamt;6 bis unter 15;9584;4924;4660
09171;      Rottal-Inn (Lkr);Insgesamt;15 bis unter 18;3558;1793;1765
09171;      Rottal-Inn (Lkr);Insgesamt;18 bis unter 25;9886;5292;4594
09171;      Rottal-Inn (Lkr);Insgesamt;25 bis unter 30;7246;3862;3384
09171;      Rottal-Inn (Lkr);Insgesamt;30 bis unter 40;14221;7317;6904
09171;      Rottal-Inn (Lkr);Insgesamt;40 bis unter 50;15427;7984;7443
09171;      Rottal-Inn (Lkr);Insgesamt;50 bis unter 65;28588;14376;14212
09171;      Rottal-Inn (Lkr);Insgesamt;65 oder älter;25735;11479;14256
09171;      Rottal-Inn (Lkr);Insgesamt;Insgesamt;120659;60346;60313
09171;      Rottal-Inn (Lkr);Deutsche;unter 6;5679;2943;2736
09171;      Rottal-Inn (Lkr);Deutsche;6 bis unter 15;8686;4483;4203
09171;      Rottal-Inn (Lkr);Deutsche;15 bis unter 18;3301;1652;1649
09171;      Rottal-Inn (Lkr);Deutsche;18 bis unter 25;8543;4434;4109
09171;      Rottal-Inn (Lkr);Deutsche;25 bis unter 30;5956;3071;2885
09171;      Rottal-Inn (Lkr);Deutsche;30 bis unter 40;11697;5876;5821
09171;      Rottal-Inn (Lkr);Deutsche;40 bis unter 50;13077;6611;6466
09171;      Rottal-Inn (Lkr);Deutsche;50 bis unter 65;26683;13305;13378
09171;      Rottal-Inn (Lkr);Deutsche;65 oder älter;25024;11130;13894
09171;      Rottal-Inn (Lkr);Deutsche;Insgesamt;108646;53505;55141
09171;      Rottal-Inn (Lkr);Ausländer;unter 6;735;376;359
09172;      Rottal-Inn (Lkr);Ausländer;6 bis unter 15;898;441;457
09172;      Rottal-Inn (Lkr);Ausländer;15 bis unter 18;257;141;116
09172;      Rottal-Inn (Lkr);Ausländer;18 bis unter 25;1343;858;485
09172;      Rottal-Inn (Lkr);Ausländer;25 bis unter 30;1290;791;499
09172;      Rottal-Inn (Lkr);Ausländer;30 bis unter 40;2524;1441;1083
09172;      Rottal-Inn (Lkr);Ausländer;40 bis unter 50;2350;1373;977
09172;      Rottal-Inn (Lkr);Ausländer;50 bis unter 65;1905;1071;834
09172;      Rottal-Inn (Lkr);Ausländer;65 oder älter;711;349;362
09172;      Rottal-Inn (Lkr);Ausländer;Insgesamt;12013;6841;5172
09172;      Straubing-Bogen (Lkr);Insgesamt;unter 6;5646;2918;2728
09172;      Straubing-Bogen (Lkr);Insgesamt;6 bis unter 15;8389;4223;4166
09172;      Straubing-Bogen (Lkr);Insgesamt;15 bis unter 18;3128;1686;1442
09172;      Straubing-Bogen (Lkr);Insgesamt;18 bis unter 25;7798;4187;3611
09172;      Straubing-Bogen (Lkr);Insgesamt;25 bis unter 30;5760;3061;2699
09172;      Straubing-Bogen (Lkr);Insgesamt;30 bis unter 40;12184;6299;5885
09172;      Straubing-Bogen (Lkr);Insgesamt;40 bis unter 50;13762;6971;6791
09172;      Straubing-Bogen (Lkr);Insgesamt;50 bis unter 65;24300;12397;11903
09172;      Straubing-Bogen (Lkr);Insgesamt;65 oder älter;19682;8885;10797
09172;      Straubing-Bogen (Lkr);Insgesamt;Insgesamt;100649;50627;50022
09172;      Straubing-Bogen (Lkr);Deutsche;unter 6;5058;2621;2437
09172;      Straubing-Bogen (Lkr);Deutsche;6 bis unter 15;7801;3911;3890
09172;      Straubing-Bogen (Lkr);Deutsche;15 bis unter 18;2972;1595;1377
09172;      Straubing-Bogen (Lkr);Deutsche;18 bis unter 25;6973;3663;3310
09172;      Straubing-Bogen (Lkr);Deutsche;25 bis unter 30;4889;2540;2349
09172;      Straubing-Bogen (Lkr);Deutsche;30 bis unter 40;10460;5277;5183
09172;      Straubing-Bogen (Lkr);Deutsche;40 bis unter 50;12251;6093;6158
09172;      Straubing-Bogen (Lkr);Deutsche;50 bis unter 65;23328;11829;11499
09172;      Straubing-Bogen (Lkr);Deutsche;65 oder älter;19413;8747;10666
09172;      Straubing-Bogen (Lkr);Deutsche;Insgesamt;93145;46276;46869
09172;      Straubing-Bogen (Lkr);Ausländer;unter 6;588;297;291
09173;      Straubing-Bogen (Lkr);Ausländer;6 bis unter 15;588;312;276
09173;      Straubing-Bogen (Lkr);Ausländer;15 bis unter 18;156;91;65
09173;      Straubing-Bogen (Lkr);Ausländer;18 bis unter 25;825;524;301
09173;      Straubing-Bogen (Lkr);Ausländer;25 bis unter 30;871;521;350
09173;      Straubing-Bogen (Lkr);Ausländer;30 bis unter 40;1724;1022;702
09173;      Straubing-Bogen (Lkr);Ausländer;40 bis unter 50;1511;878;633
09173;      Straubing-Bogen (Lkr);Ausländer;50 bis unter 65;972;568;404
09173;      Straubing-Bogen (Lkr);Ausländer;65 oder älter;269;138;131
09173;      Straubing-Bogen (Lkr);Ausländer;Insgesamt;7504;4351;3153
09173;      Dingolfing-Landau (Lkr);Insgesamt;unter 6;5327;2743;2584
09173;      Dingolfing-Landau (Lkr);Insgesamt;6 bis unter 15;7633;3932;3701
09173;      Dingolfing-Landau (Lkr);Insgesamt;15 bis unter 18;2865;1445;1420
09173;      Dingolfing-Landau (Lkr);Insgesamt;18 bis unter 25;7589;4182;3407
09173;      Dingolfing-Landau (Lkr);Insgesamt;25 bis unter 30;6531;3602;2929
09173;      Dingolfing-Landau (Lkr);Insgesamt;30 bis unter 40;12454;6729;5725
09173;      Dingolfing-Landau (Lkr);Insgesamt;40 bis unter 50;12811;6784;6027
09173;      Dingolfing-Landau (Lkr);Insgesamt;50 bis unter 65;22706;11674;11032
09173;      Dingolfing-Landau (Lkr);Insgesamt;65 oder älter;18301;8359;9942
09173;      Dingolfing-Landau (Lkr);Insgesamt;Insgesamt;96217;49450;46767
09173;      Dingolfing-Landau (Lkr);Deutsche;unter 6;4656;2407;2249
09173;      Dingolfing-Landau (Lkr);Deutsche;6 bis unter 15;6809;3512;3297
09173;      Dingolfing-Landau (Lkr);Deutsche;15 bis unter 18;2659;1329;1330
09173;      Dingolfing-Landau (Lkr);Deutsche;18 bis unter 25;6385;3397;2988
09173;      Dingolfing-Landau (Lkr);Deutsche;25 bis unter 30;4953;2652;2301
09173;      Dingolfing-Landau (Lkr);Deutsche;30 bis unter 40;9732;5089;4643
09173;      Dingolfing-Landau (Lkr);Deutsche;40 bis unter 50;10514;5344;5170
09173;      Dingolfing-Landau (Lkr);Deutsche;50 bis unter 65;21100;10649;10451
09173;      Dingolfing-Landau (Lkr);Deutsche;65 oder älter;17788;8089;9699
09173;      Dingolfing-Landau (Lkr);Deutsche;Insgesamt;84596;42468;42128
09173;      Dingolfing-Landau (Lkr);Ausländer;unter 6;671;336;335
09174;      Dingolfing-Landau (Lkr);Ausländer;6 bis unter 15;824;420;404
09174;      Dingolfing-Landau (Lkr);Ausländer;15 bis unter 18;206;116;90
09174;      Dingolfing-Landau (Lkr);Ausländer;18 bis unter 25;1204;785;419
09174;      Dingolfing-Landau (Lkr);Ausländer;25 bis unter 30;1578;950;628
09174;      Dingolfing-Landau (Lkr);Ausländer;30 bis unter 40;2722;1640;1082
09174;      Dingolfing-Landau (Lkr);Ausländer;40 bis unter 50;2297;1440;857
09174;      Dingolfing-Landau (Lkr);Ausländer;50 bis unter 65;1606;1025;581
09174;      Dingolfing-Landau (Lkr);Ausländer;65 oder älter;513;270;243
09174;      Dingolfing-Landau (Lkr);Ausländer;Insgesamt;11621;6982;4639
09174;    Landkreise Niederbayern;Insgesamt;unter 6;57877;29701;28176
09174;    Landkreise Niederbayern;Insgesamt;6 bis unter 15;85514;43969;41545
09174;    Landkreise Niederbayern;Insgesamt;15 bis unter 18;31867;16509;15358
LK092;    Landkreise Niederbayern;Insgesamt;18 bis unter 25;84653;45524;39129
LK092;    Landkreise Niederbayern;Insgesamt;25 bis unter 30;64223;34504;29719
LK092;    Landkreise Niederbayern;Insgesamt;30 bis unter 40;129058;67257;61801
LK092;    Landkreise Niederbayern;Insgesamt;40 bis unter 50;140830;72076;68754
LK092;    Landkreise Niederbayern;Insgesamt;50 bis unter 65;255124;128999;126125
LK092;    Landkreise Niederbayern;Insgesamt;65 oder älter;216715;97406;119309
LK092;    Landkreise Niederbayern;Insgesamt;Insgesamt;1065861;535945;529916
LK092;    Landkreise Niederbayern;Deutsche;unter 6;51488;26431;25057
LK092;    Landkreise Niederbayern;Deutsche;6 bis unter 15;78186;40181;38005
LK092;    Landkreise Niederbayern;Deutsche;15 bis unter 18;29678;15277;14401
LK092;    Landkreise Niederbayern;Deutsche;18 bis unter 25;73741;38605;35136
LK092;    Landkreise Niederbayern;Deutsche;25 bis unter 30;53381;27995;25386
LK092;    Landkreise Niederbayern;Deutsche;30 bis unter 40;107693;54858;52835
LK092;    Landkreise Niederbayern;Deutsche;40 bis unter 50;121655;61024;60631
LK092;    Landkreise Niederbayern;Deutsche;50 bis unter 65;241333;121049;120284
LK092;    Landkreise Niederbayern;Deutsche;65 oder älter;211450;94778;116672
LK092;    Landkreise Niederbayern;Deutsche;Insgesamt;968605;480198;488407
LK092;    Landkreise Niederbayern;Ausländer;unter 6;6389;3270;3119
LK092;    Landkreise Niederbayern;Ausländer;6 bis unter 15;7328;3788;3540
LK092;    Landkreise Niederbayern;Ausländer;15 bis unter 18;2189;1232;957
LK092;    Landkreise Niederbayern;Ausländer;18 bis unter 25;10912;6919;3993
LK092;    Landkreise Niederbayern;Ausländer;25 bis unter 30;10842;6509;4333
LK092;    Landkreise Niederbayern;Ausländer;30 bis unter 40;21365;12399;8966
LK092;    Landkreise Niederbayern;Ausländer;40 bis unter 50;19175;11052;8123
LK092;    Landkreise Niederbayern;Ausländer;50 bis unter 65;13791;7950;5841
LK092;    Landkreise Niederbayern;Ausländer;65 oder älter;5265;2628;2637
LK092;    Landkreise Niederbayern;Ausländer;Insgesamt;97256;55747;41509
092;  Niederbayern;Insgesamt;unter 6;66585;34120;32465
092;  Niederbayern;Insgesamt;6 bis unter 15;97542;50121;47421
092;  Niederbayern;Insgesamt;15 bis unter 18;36020;18640;17380
092;  Niederbayern;Insgesamt;18 bis unter 25;101027;53768;47259
092;  Niederbayern;Insgesamt;25 bis unter 30;78609;42226;36383
092;  Niederbayern;Insgesamt;30 bis unter 40;152716;79690;73026
092;  Niederbayern;Insgesamt;40 bis unter 50;162335;83081;79254
092;  Niederbayern;Insgesamt;50 bis unter 65;290789;146609;144180
092;  Niederbayern;Insgesamt;65 oder älter;252905;112554;140351
092;  Niederbayern;Insgesamt;Insgesamt;1238528;620809;617719
092;  Niederbayern;Deutsche;unter 6;58461;29979;28482
092;  Niederbayern;Deutsche;6 bis unter 15;88280;45373;42907
092;  Niederbayern;Deutsche;15 bis unter 18;33227;17081;16146
092;  Niederbayern;Deutsche;18 bis unter 25;86095;44459;41636
092;  Niederbayern;Deutsche;25 bis unter 30;63774;33363;30411
092;  Niederbayern;Deutsche;30 bis unter 40;125117;63819;61298
092;  Niederbayern;Deutsche;40 bis unter 50;137879;69217;68662
092;  Niederbayern;Deutsche;50 bis unter 65;273026;136531;136495
092;  Niederbayern;Deutsche;65 oder älter;245712;109065;136647
092;  Niederbayern;Deutsche;Insgesamt;1111571;548887;562684
092;  Niederbayern;Ausländer;unter 6;8124;4141;3983
092;  Niederbayern;Ausländer;6 bis unter 15;9262;4748;4514
092;  Niederbayern;Ausländer;15 bis unter 18;2793;1559;1234
092;  Niederbayern;Ausländer;18 bis unter 25;14932;9309;5623
092;  Niederbayern;Ausländer;25 bis unter 30;14835;8863;5972
092;  Niederbayern;Ausländer;30 bis unter 40;27599;15871;11728
092;  Niederbayern;Ausländer;40 bis unter 50;24456;13864;10592
092;  Niederbayern;Ausländer;50 bis unter 65;17763;10078;7685
092;  Niederbayern;Ausländer;65 oder älter;7193;3489;3704
092;  Niederbayern;Ausländer;Insgesamt;126957;71922;55035
09361;      Amberg (Krfr.St);Insgesamt;unter 6;2077;1022;1055
09361;      Amberg (Krfr.St);Insgesamt;6 bis unter 15;3077;1635;1442
09361;      Amberg (Krfr.St);Insgesamt;15 bis unter 18;1139;567;572
09361;      Amberg (Krfr.St);Insgesamt;18 bis unter 25;3207;1728;1479
09361;      Amberg (Krfr.St);Insgesamt;25 bis unter 30;2804;1560;1244
09361;      Amberg (Krfr.St);Insgesamt;30 bis unter 40;5189;2832;2357
09361;      Amberg (Krfr.St);Insgesamt;40 bis unter 50;4991;2546;2445
09361;      Amberg (Krfr.St);Insgesamt;50 bis unter 65;9649;4713;4936
09361;      Amberg (Krfr.St);Insgesamt;65 oder älter;9837;4070;5767
09361;      Amberg (Krfr.St);Insgesamt;Insgesamt;41970;20673;21297
09361;      Amberg (Krfr.St);Deutsche;unter 6;1768;863;905
09361;      Amberg (Krfr.St);Deutsche;6 bis unter 15;2664;1398;1266
09361;      Amberg (Krfr.St);Deutsche;15 bis unter 18;1013;496;517
09361;      Amberg (Krfr.St);Deutsche;18 bis unter 25;2685;1386;1299
09361;      Amberg (Krfr.St);Deutsche;25 bis unter 30;2284;1256;1028
09361;      Amberg (Krfr.St);Deutsche;30 bis unter 40;4262;2300;1962
09361;      Amberg (Krfr.St);Deutsche;40 bis unter 50;4208;2105;2103
09361;      Amberg (Krfr.St);Deutsche;50 bis unter 65;8985;4352;4633
09361;      Amberg (Krfr.St);Deutsche;65 oder älter;9532;3941;5591
09361;      Amberg (Krfr.St);Deutsche;Insgesamt;37401;18097;19304
09361;      Amberg (Krfr.St);Ausländer;unter 6;309;159;150
09361;      Amberg (Krfr.St);Ausländer;6 bis unter 15;413;237;176
09361;      Amberg (Krfr.St);Ausländer;15 bis unter 18;126;71;55
09361;      Amberg (Krfr.St);Ausländer;18 bis unter 25;522;342;180
09361;      Amberg (Krfr.St);Ausländer;25 bis unter 30;520;304;216
09361;      Amberg (Krfr.St);Ausländer;30 bis unter 40;927;532;395
09361;      Amberg (Krfr.St);Ausländer;40 bis unter 50;783;441;342
09361;      Amberg (Krfr.St);Ausländer;50 bis unter 65;664;361;303
09361;      Amberg (Krfr.St);Ausländer;65 oder älter;305;129;176
09361;      Amberg (Krfr.St);Ausländer;Insgesamt;4569;2576;1993
09362;      Regensburg (Krfr.St);Insgesamt;unter 6;8257;4232;4025
09362;      Regensburg (Krfr.St);Insgesamt;6 bis unter 15;10403;5335;5068
09362;      Regensburg (Krfr.St);Insgesamt;15 bis unter 18;3272;1687;1585
09362;      Regensburg (Krfr.St);Insgesamt;18 bis unter 25;15557;7365;8192
09362;      Regensburg (Krfr.St);Insgesamt;25 bis unter 30;16780;8469;8311
09362;      Regensburg (Krfr.St);Insgesamt;30 bis unter 40;25605;13346;12259
09362;      Regensburg (Krfr.St);Insgesamt;40 bis unter 50;18745;9370;9375
09362;      Regensburg (Krfr.St);Insgesamt;50 bis unter 65;27869;13584;14285
09362;      Regensburg (Krfr.St);Insgesamt;65 oder älter;26122;10837;15285
09362;      Regensburg (Krfr.St);Insgesamt;Insgesamt;152610;74225;78385
09362;      Regensburg (Krfr.St);Deutsche;unter 6;6762;3455;3307
09362;      Regensburg (Krfr.St);Deutsche;6 bis unter 15;8862;4528;4334
09362;      Regensburg (Krfr.St);Deutsche;15 bis unter 18;2743;1396;1347
09362;      Regensburg (Krfr.St);Deutsche;18 bis unter 25;11963;5414;6549
09362;      Regensburg (Krfr.St);Deutsche;25 bis unter 30;12996;6415;6581
09362;      Regensburg (Krfr.St);Deutsche;30 bis unter 40;19886;10214;9672
09362;      Regensburg (Krfr.St);Deutsche;40 bis unter 50;14476;7206;7270
09362;      Regensburg (Krfr.St);Deutsche;50 bis unter 65;24623;11863;12760
09362;      Regensburg (Krfr.St);Deutsche;65 oder älter;24708;10198;14510
09362;      Regensburg (Krfr.St);Deutsche;Insgesamt;127019;60689;66330
09362;      Regensburg (Krfr.St);Ausländer;unter 6;1495;777;718
09362;      Regensburg (Krfr.St);Ausländer;6 bis unter 15;1541;807;734
09362;      Regensburg (Krfr.St);Ausländer;15 bis unter 18;529;291;238
09362;      Regensburg (Krfr.St);Ausländer;18 bis unter 25;3594;1951;1643
09362;      Regensburg (Krfr.St);Ausländer;25 bis unter 30;3784;2054;1730
09362;      Regensburg (Krfr.St);Ausländer;30 bis unter 40;5719;3132;2587
09362;      Regensburg (Krfr.St);Ausländer;40 bis unter 50;4269;2164;2105
09362;      Regensburg (Krfr.St);Ausländer;50 bis unter 65;3246;1721;1525
09362;      Regensburg (Krfr.St);Ausländer;65 oder älter;1414;639;775
09362;      Regensburg (Krfr.St);Ausländer;Insgesamt;25591;13536;12055
09363;      Weiden i.d.OPf. (Krfr.St);Insgesamt;unter 6;2144;1075;1069
09363;      Weiden i.d.OPf. (Krfr.St);Insgesamt;6 bis unter 15;2994;1524;1470
09363;      Weiden i.d.OPf. (Krfr.St);Insgesamt;15 bis unter 18;1169;587;582
09363;      Weiden i.d.OPf. (Krfr.St);Insgesamt;18 bis unter 25;3553;1896;1657
09363;      Weiden i.d.OPf. (Krfr.St);Insgesamt;25 bis unter 30;2904;1529;1375
09363;      Weiden i.d.OPf. (Krfr.St);Insgesamt;30 bis unter 40;5117;2627;2490
09363;      Weiden i.d.OPf. (Krfr.St);Insgesamt;40 bis unter 50;5100;2469;2631
09363;      Weiden i.d.OPf. (Krfr.St);Insgesamt;50 bis unter 65;9675;4745;4930
09363;      Weiden i.d.OPf. (Krfr.St);Insgesamt;65 oder älter;9864;4090;5774
09363;      Weiden i.d.OPf. (Krfr.St);Insgesamt;Insgesamt;42520;20542;21978
09363;      Weiden i.d.OPf. (Krfr.St);Deutsche;unter 6;1731;864;867
09363;      Weiden i.d.OPf. (Krfr.St);Deutsche;6 bis unter 15;2570;1310;1260
09363;      Weiden i.d.OPf. (Krfr.St);Deutsche;15 bis unter 18;1019;503;516
09363;      Weiden i.d.OPf. (Krfr.St);Deutsche;18 bis unter 25;2921;1458;1463
09363;      Weiden i.d.OPf. (Krfr.St);Deutsche;25 bis unter 30;2308;1143;1165
09363;      Weiden i.d.OPf. (Krfr.St);Deutsche;30 bis unter 40;4129;2071;2058
09363;      Weiden i.d.OPf. (Krfr.St);Deutsche;40 bis unter 50;4324;2035;2289
09363;      Weiden i.d.OPf. (Krfr.St);Deutsche;50 bis unter 65;8992;4369;4623
09363;      Weiden i.d.OPf. (Krfr.St);Deutsche;65 oder älter;9503;3940;5563
09363;      Weiden i.d.OPf. (Krfr.St);Deutsche;Insgesamt;37497;17693;19804
09363;      Weiden i.d.OPf. (Krfr.St);Ausländer;unter 6;413;211;202
09363;      Weiden i.d.OPf. (Krfr.St);Ausländer;6 bis unter 15;424;214;210
09363;      Weiden i.d.OPf. (Krfr.St);Ausländer;15 bis unter 18;150;84;66
09363;      Weiden i.d.OPf. (Krfr.St);Ausländer;18 bis unter 25;632;438;194
09363;      Weiden i.d.OPf. (Krfr.St);Ausländer;25 bis unter 30;596;386;210
09363;      Weiden i.d.OPf. (Krfr.St);Ausländer;30 bis unter 40;988;556;432
09363;      Weiden i.d.OPf. (Krfr.St);Ausländer;40 bis unter 50;776;434;342
09363;      Weiden i.d.OPf. (Krfr.St);Ausländer;50 bis unter 65;683;376;307
09363;      Weiden i.d.OPf. (Krfr.St);Ausländer;65 oder älter;361;150;211
09363;      Weiden i.d.OPf. (Krfr.St);Ausländer;Insgesamt;5023;2849;2174
KS093;    Kreisfreie Städte Oberpfalz;Insgesamt;unter 6;12478;6329;6149
KS093;    Kreisfreie Städte Oberpfalz;Insgesamt;6 bis unter 15;16474;8494;7980
KS093;    Kreisfreie Städte Oberpfalz;Insgesamt;15 bis unter 18;5580;2841;2739
KS093;    Kreisfreie Städte Oberpfalz;Insgesamt;18 bis unter 25;22317;10989;11328
KS093;    Kreisfreie Städte Oberpfalz;Insgesamt;25 bis unter 30;22488;11558;10930
KS093;    Kreisfreie Städte Oberpfalz;Insgesamt;30 bis unter 40;35911;18805;17106
KS093;    Kreisfreie Städte Oberpfalz;Insgesamt;40 bis unter 50;28836;14385;14451
KS093;    Kreisfreie Städte Oberpfalz;Insgesamt;50 bis unter 65;47193;23042;24151
KS093;    Kreisfreie Städte Oberpfalz;Insgesamt;65 oder älter;45823;18997;26826
KS093;    Kreisfreie Städte Oberpfalz;Insgesamt;Insgesamt;237100;115440;121660
KS093;    Kreisfreie Städte Oberpfalz;Deutsche;unter 6;10261;5182;5079
KS093;    Kreisfreie Städte Oberpfalz;Deutsche;6 bis unter 15;14096;7236;6860
KS093;    Kreisfreie Städte Oberpfalz;Deutsche;15 bis unter 18;4775;2395;2380
KS093;    Kreisfreie Städte Oberpfalz;Deutsche;18 bis unter 25;17569;8258;9311
KS093;    Kreisfreie Städte Oberpfalz;Deutsche;25 bis unter 30;17588;8814;8774
KS093;    Kreisfreie Städte Oberpfalz;Deutsche;30 bis unter 40;28277;14585;13692
KS093;    Kreisfreie Städte Oberpfalz;Deutsche;40 bis unter 50;23008;11346;11662
KS093;    Kreisfreie Städte Oberpfalz;Deutsche;50 bis unter 65;42600;20584;22016
KS093;    Kreisfreie Städte Oberpfalz;Deutsche;65 oder älter;43743;18079;25664
KS093;    Kreisfreie Städte Oberpfalz;Deutsche;Insgesamt;201917;96479;105438
KS093;    Kreisfreie Städte Oberpfalz;Ausländer;unter 6;2217;1147;1070
KS093;    Kreisfreie Städte Oberpfalz;Ausländer;6 bis unter 15;2378;1258;1120
KS093;    Kreisfreie Städte Oberpfalz;Ausländer;15 bis unter 18;805;446;359
KS093;    Kreisfreie Städte Oberpfalz;Ausländer;18 bis unter 25;4748;2731;2017
KS093;    Kreisfreie Städte Oberpfalz;Ausländer;25 bis unter 30;4900;2744;2156
KS093;    Kreisfreie Städte Oberpfalz;Ausländer;30 bis unter 40;7634;4220;3414
KS093;    Kreisfreie Städte Oberpfalz;Ausländer;40 bis unter 50;5828;3039;2789
KS093;    Kreisfreie Städte Oberpfalz;Ausländer;50 bis unter 65;4593;2458;2135
KS093;    Kreisfreie Städte Oberpfalz;Ausländer;65 oder älter;2080;918;1162
KS093;    Kreisfreie Städte Oberpfalz;Ausländer;Insgesamt;35183;18961;16222
09371;      Amberg-Sulzbach (Lkr);Insgesamt;unter 6;5322;2697;2625
09371;      Amberg-Sulzbach (Lkr);Insgesamt;6 bis unter 15;7933;4104;3829
09371;      Amberg-Sulzbach (Lkr);Insgesamt;15 bis unter 18;3106;1591;1515
09371;      Amberg-Sulzbach (Lkr);Insgesamt;18 bis unter 25;8051;4301;3750
09371;      Amberg-Sulzbach (Lkr);Insgesamt;25 bis unter 30;5858;3120;2738
09371;      Amberg-Sulzbach (Lkr);Insgesamt;30 bis unter 40;11804;6108;5696
09371;      Amberg-Sulzbach (Lkr);Insgesamt;40 bis unter 50;12985;6529;6456
09371;      Amberg-Sulzbach (Lkr);Insgesamt;50 bis unter 65;26370;13464;12906
09371;      Amberg-Sulzbach (Lkr);Insgesamt;65 oder älter;21680;9751;11929
09371;      Amberg-Sulzbach (Lkr);Insgesamt;Insgesamt;103109;51665;51444
09371;      Amberg-Sulzbach (Lkr);Deutsche;unter 6;4754;2402;2352
09371;      Amberg-Sulzbach (Lkr);Deutsche;6 bis unter 15;7381;3810;3571
09371;      Amberg-Sulzbach (Lkr);Deutsche;15 bis unter 18;2962;1525;1437
09371;      Amberg-Sulzbach (Lkr);Deutsche;18 bis unter 25;7407;3879;3528
09371;      Amberg-Sulzbach (Lkr);Deutsche;25 bis unter 30;5279;2757;2522
09371;      Amberg-Sulzbach (Lkr);Deutsche;30 bis unter 40;10612;5423;5189
09371;      Amberg-Sulzbach (Lkr);Deutsche;40 bis unter 50;11827;5887;5940
09371;      Amberg-Sulzbach (Lkr);Deutsche;50 bis unter 65;25339;12844;12495
09371;      Amberg-Sulzbach (Lkr);Deutsche;65 oder älter;21310;9588;11722
09371;      Amberg-Sulzbach (Lkr);Deutsche;Insgesamt;96871;48115;48756
09371;      Amberg-Sulzbach (Lkr);Ausländer;unter 6;568;295;273
09371;      Amberg-Sulzbach (Lkr);Ausländer;6 bis unter 15;552;294;258
09371;      Amberg-Sulzbach (Lkr);Ausländer;15 bis unter 18;144;66;78
09371;      Amberg-Sulzbach (Lkr);Ausländer;18 bis unter 25;644;422;222
09371;      Amberg-Sulzbach (Lkr);Ausländer;25 bis unter 30;579;363;216
09371;      Amberg-Sulzbach (Lkr);Ausländer;30 bis unter 40;1192;685;507
09371;      Amberg-Sulzbach (Lkr);Ausländer;40 bis unter 50;1158;642;516
09371;      Amberg-Sulzbach (Lkr);Ausländer;50 bis unter 65;1031;620;411
09371;      Amberg-Sulzbach (Lkr);Ausländer;65 oder älter;370;163;207
09371;      Amberg-Sulzbach (Lkr);Ausländer;Insgesamt;6238;3550;2688
09372;      Cham (Lkr);Insgesamt;unter 6;6803;3545;3258
09372;      Cham (Lkr);Insgesamt;6 bis unter 15;9858;5014;4844
09372;      Cham (Lkr);Insgesamt;15 bis unter 18;3599;1775;1824
09372;      Cham (Lkr);Insgesamt;18 bis unter 25;9992;5341;4651
09372;      Cham (Lkr);Insgesamt;25 bis unter 30;7564;4035;3529
09372;      Cham (Lkr);Insgesamt;30 bis unter 40;15308;7939;7369
09372;      Cham (Lkr);Insgesamt;40 bis unter 50;16541;8402;8139
09372;      Cham (Lkr);Insgesamt;50 bis unter 65;31093;15901;15192
09372;      Cham (Lkr);Insgesamt;65 oder älter;27124;12296;14828
09372;      Cham (Lkr);Insgesamt;Insgesamt;127882;64248;63634
09372;      Cham (Lkr);Deutsche;unter 6;6228;3242;2986
09372;      Cham (Lkr);Deutsche;6 bis unter 15;9201;4670;4531
09372;      Cham (Lkr);Deutsche;15 bis unter 18;3432;1691;1741
09372;      Cham (Lkr);Deutsche;18 bis unter 25;9102;4741;4361
09372;      Cham (Lkr);Deutsche;25 bis unter 30;6675;3490;3185
09372;      Cham (Lkr);Deutsche;30 bis unter 40;13654;7017;6637
09372;      Cham (Lkr);Deutsche;40 bis unter 50;15116;7641;7475
09372;      Cham (Lkr);Deutsche;50 bis unter 65;30080;15331;14749
09372;      Cham (Lkr);Deutsche;65 oder älter;26790;12129;14661
09372;      Cham (Lkr);Deutsche;Insgesamt;120278;59952;60326
09372;      Cham (Lkr);Ausländer;unter 6;575;303;272
09372;      Cham (Lkr);Ausländer;6 bis unter 15;657;344;313
09372;      Cham (Lkr);Ausländer;15 bis unter 18;167;84;83
09372;      Cham (Lkr);Ausländer;18 bis unter 25;890;600;290
09372;      Cham (Lkr);Ausländer;25 bis unter 30;889;545;344
09372;      Cham (Lkr);Ausländer;30 bis unter 40;1654;922;732
09372;      Cham (Lkr);Ausländer;40 bis unter 50;1425;761;664
09372;      Cham (Lkr);Ausländer;50 bis unter 65;1013;570;443
09372;      Cham (Lkr);Ausländer;65 oder älter;334;167;167
09372;      Cham (Lkr);Ausländer;Insgesamt;7604;4296;3308
09373;      Neumarkt i.d.OPf. (Lkr);Insgesamt;unter 6;7713;3981;3732
09373;      Neumarkt i.d.OPf. (Lkr);Insgesamt;6 bis unter 15;10870;5552;5318
09373;      Neumarkt i.d.OPf. (Lkr);Insgesamt;15 bis unter 18;4047;2078;1969
09373;      Neumarkt i.d.OPf. (Lkr);Insgesamt;18 bis unter 25;10970;5925;5045
09373;      Neumarkt i.d.OPf. (Lkr);Insgesamt;25 bis unter 30;8288;4444;3844
09373;      Neumarkt i.d.OPf. (Lkr);Insgesamt;30 bis unter 40;16490;8598;7892
09373;      Neumarkt i.d.OPf. (Lkr);Insgesamt;40 bis unter 50;17644;9063;8581
09373;      Neumarkt i.d.OPf. (Lkr);Insgesamt;50 bis unter 65;32128;16399;15729
09373;      Neumarkt i.d.OPf. (Lkr);Insgesamt;65 oder älter;25411;11459;13952
09373;      Neumarkt i.d.OPf. (Lkr);Insgesamt;Insgesamt;133561;67499;66062
09373;      Neumarkt i.d.OPf. (Lkr);Deutsche;unter 6;7040;3621;3419
09373;      Neumarkt i.d.OPf. (Lkr);Deutsche;6 bis unter 15;10078;5125;4953
09373;      Neumarkt i.d.OPf. (Lkr);Deutsche;15 bis unter 18;3810;1965;1845
09373;      Neumarkt i.d.OPf. (Lkr);Deutsche;18 bis unter 25;9773;5138;4635
09373;      Neumarkt i.d.OPf. (Lkr);Deutsche;25 bis unter 30;7025;3666;3359
09373;      Neumarkt i.d.OPf. (Lkr);Deutsche;30 bis unter 40;13899;7063;6836
09373;      Neumarkt i.d.OPf. (Lkr);Deutsche;40 bis unter 50;15178;7605;7573
09373;      Neumarkt i.d.OPf. (Lkr);Deutsche;50 bis unter 65;30324;15271;15053
09373;      Neumarkt i.d.OPf. (Lkr);Deutsche;65 oder älter;24792;11135;13657
09373;      Neumarkt i.d.OPf. (Lkr);Deutsche;Insgesamt;121919;60589;61330
09373;      Neumarkt i.d.OPf. (Lkr);Ausländer;unter 6;673;360;313
09373;      Neumarkt i.d.OPf. (Lkr);Ausländer;6 bis unter 15;792;427;365
09373;      Neumarkt i.d.OPf. (Lkr);Ausländer;15 bis unter 18;237;113;124
09373;      Neumarkt i.d.OPf. (Lkr);Ausländer;18 bis unter 25;1197;787;410
09373;      Neumarkt i.d.OPf. (Lkr);Ausländer;25 bis unter 30;1263;778;485
09373;      Neumarkt i.d.OPf. (Lkr);Ausländer;30 bis unter 40;2591;1535;1056
09373;      Neumarkt i.d.OPf. (Lkr);Ausländer;40 bis unter 50;2466;1458;1008
09373;      Neumarkt i.d.OPf. (Lkr);Ausländer;50 bis unter 65;1804;1128;676
09373;      Neumarkt i.d.OPf. (Lkr);Ausländer;65 oder älter;619;324;295
09373;      Neumarkt i.d.OPf. (Lkr);Ausländer;Insgesamt;11642;6910;4732
09374;      Neustadt a.d.Waldnaab (Lkr);Insgesamt;unter 6;4912;2504;2408
09374;      Neustadt a.d.Waldnaab (Lkr);Insgesamt;6 bis unter 15;7317;3756;3561
09374;      Neustadt a.d.Waldnaab (Lkr);Insgesamt;15 bis unter 18;2865;1451;1414
09374;      Neustadt a.d.Waldnaab (Lkr);Insgesamt;18 bis unter 25;7373;3891;3482
09374;      Neustadt a.d.Waldnaab (Lkr);Insgesamt;25 bis unter 30;5390;2822;2568
09374;      Neustadt a.d.Waldnaab (Lkr);Insgesamt;30 bis unter 40;11076;5671;5405
09374;      Neustadt a.d.Waldnaab (Lkr);Insgesamt;40 bis unter 50;11971;5918;6053
09374;      Neustadt a.d.Waldnaab (Lkr);Insgesamt;50 bis unter 65;23687;12079;11608
09374;      Neustadt a.d.Waldnaab (Lkr);Insgesamt;65 oder älter;19761;8851;10910
09374;      Neustadt a.d.Waldnaab (Lkr);Insgesamt;Insgesamt;94352;46943;47409
09374;      Neustadt a.d.Waldnaab (Lkr);Deutsche;unter 6;4419;2241;2178
09374;      Neustadt a.d.Waldnaab (Lkr);Deutsche;6 bis unter 15;6948;3564;3384
09374;      Neustadt a.d.Waldnaab (Lkr);Deutsche;15 bis unter 18;2771;1391;1380
09374;      Neustadt a.d.Waldnaab (Lkr);Deutsche;18 bis unter 25;6891;3580;3311
09374;      Neustadt a.d.Waldnaab (Lkr);Deutsche;25 bis unter 30;4968;2580;2388
09374;      Neustadt a.d.Waldnaab (Lkr);Deutsche;30 bis unter 40;10268;5234;5034
09374;      Neustadt a.d.Waldnaab (Lkr);Deutsche;40 bis unter 50;11126;5496;5630
09374;      Neustadt a.d.Waldnaab (Lkr);Deutsche;50 bis unter 65;22992;11686;11306
09374;      Neustadt a.d.Waldnaab (Lkr);Deutsche;65 oder älter;19482;8702;10780
09374;      Neustadt a.d.Waldnaab (Lkr);Deutsche;Insgesamt;89865;44474;45391
09374;      Neustadt a.d.Waldnaab (Lkr);Ausländer;unter 6;493;263;230
09374;      Neustadt a.d.Waldnaab (Lkr);Ausländer;6 bis unter 15;369;192;177
09374;      Neustadt a.d.Waldnaab (Lkr);Ausländer;15 bis unter 18;94;60;34
09374;      Neustadt a.d.Waldnaab (Lkr);Ausländer;18 bis unter 25;482;311;171
09374;      Neustadt a.d.Waldnaab (Lkr);Ausländer;25 bis unter 30;422;242;180
09374;      Neustadt a.d.Waldnaab (Lkr);Ausländer;30 bis unter 40;808;437;371
09374;      Neustadt a.d.Waldnaab (Lkr);Ausländer;40 bis unter 50;845;422;423
09374;      Neustadt a.d.Waldnaab (Lkr);Ausländer;50 bis unter 65;695;393;302
09374;      Neustadt a.d.Waldnaab (Lkr);Ausländer;65 oder älter;279;149;130
09374;      Neustadt a.d.Waldnaab (Lkr);Ausländer;Insgesamt;4487;2469;2018
09375;      Regensburg (Lkr);Insgesamt;unter 6;11327;5766;5561
09375;      Regensburg (Lkr);Insgesamt;6 bis unter 15;16181;8372;7809
09375;      Regensburg (Lkr);Insgesamt;15 bis unter 18;5789;3005;2784
09375;      Regensburg (Lkr);Insgesamt;18 bis unter 25;14916;7970;6946
09375;      Regensburg (Lkr);Insgesamt;25 bis unter 30;10812;5794;5018
09375;      Regensburg (Lkr);Insgesamt;30 bis unter 40;24022;12209;11813
09375;      Regensburg (Lkr);Insgesamt;40 bis unter 50;26473;13425;13048
09375;      Regensburg (Lkr);Insgesamt;50 bis unter 65;46692;23471;23221
09375;      Regensburg (Lkr);Insgesamt;65 oder älter;37360;17069;20291
09375;      Regensburg (Lkr);Insgesamt;Insgesamt;193572;97081;96491
09375;      Regensburg (Lkr);Deutsche;unter 6;10197;5200;4997
09375;      Regensburg (Lkr);Deutsche;6 bis unter 15;14986;7750;7236
09375;      Regensburg (Lkr);Deutsche;15 bis unter 18;5390;2798;2592
09375;      Regensburg (Lkr);Deutsche;18 bis unter 25;13005;6784;6221
09375;      Regensburg (Lkr);Deutsche;25 bis unter 30;8998;4737;4261
09375;      Regensburg (Lkr);Deutsche;30 bis unter 40;20264;10100;10164
09375;      Regensburg (Lkr);Deutsche;40 bis unter 50;23106;11615;11491
09375;      Regensburg (Lkr);Deutsche;50 bis unter 65;44404;22206;22198
09375;      Regensburg (Lkr);Deutsche;65 oder älter;36528;16678;19850
09375;      Regensburg (Lkr);Deutsche;Insgesamt;176878;87868;89010
09375;      Regensburg (Lkr);Ausländer;unter 6;1130;566;564
09375;      Regensburg (Lkr);Ausländer;6 bis unter 15;1195;622;573
09375;      Regensburg (Lkr);Ausländer;15 bis unter 18;399;207;192
09375;      Regensburg (Lkr);Ausländer;18 bis unter 25;1911;1186;725
09375;      Regensburg (Lkr);Ausländer;25 bis unter 30;1814;1057;757
09375;      Regensburg (Lkr);Ausländer;30 bis unter 40;3758;2109;1649
09375;      Regensburg (Lkr);Ausländer;40 bis unter 50;3367;1810;1557
09375;      Regensburg (Lkr);Ausländer;50 bis unter 65;2288;1265;1023
09375;      Regensburg (Lkr);Ausländer;65 oder älter;832;391;441
09375;      Regensburg (Lkr);Ausländer;Insgesamt;16694;9213;7481
09376;      Schwandorf (Lkr);Insgesamt;unter 6;7832;4038;3794
09376;      Schwandorf (Lkr);Insgesamt;6 bis unter 15;11394;5808;5586
09376;      Schwandorf (Lkr);Insgesamt;15 bis unter 18;4315;2236;2079
09376;      Schwandorf (Lkr);Insgesamt;18 bis unter 25;11633;6184;5449
09376;      Schwandorf (Lkr);Insgesamt;25 bis unter 30;8949;4802;4147
09376;      Schwandorf (Lkr);Insgesamt;30 bis unter 40;18027;9347;8680
09376;      Schwandorf (Lkr);Insgesamt;40 bis unter 50;19533;10092;9441
09376;      Schwandorf (Lkr);Insgesamt;50 bis unter 65;35286;18075;17211
09376;      Schwandorf (Lkr);Insgesamt;65 oder älter;30220;13382;16838
09376;      Schwandorf (Lkr);Insgesamt;Insgesamt;147189;73964;73225
09376;      Schwandorf (Lkr);Deutsche;unter 6;6902;3574;3328
09376;      Schwandorf (Lkr);Deutsche;6 bis unter 15;10379;5280;5099
09376;      Schwandorf (Lkr);Deutsche;15 bis unter 18;4030;2068;1962
09376;      Schwandorf (Lkr);Deutsche;18 bis unter 25;10245;5331;4914
09376;      Schwandorf (Lkr);Deutsche;25 bis unter 30;7535;3970;3565
09376;      Schwandorf (Lkr);Deutsche;30 bis unter 40;15296;7797;7499
09376;      Schwandorf (Lkr);Deutsche;40 bis unter 50;17254;8814;8440
09376;      Schwandorf (Lkr);Deutsche;50 bis unter 65;33751;17219;16532
09376;      Schwandorf (Lkr);Deutsche;65 oder älter;29757;13147;16610
09376;      Schwandorf (Lkr);Deutsche;Insgesamt;135149;67200;67949
09376;      Schwandorf (Lkr);Ausländer;unter 6;930;464;466
09376;      Schwandorf (Lkr);Ausländer;6 bis unter 15;1015;528;487
09376;      Schwandorf (Lkr);Ausländer;15 bis unter 18;285;168;117
09376;      Schwandorf (Lkr);Ausländer;18 bis unter 25;1388;853;535
09376;      Schwandorf (Lkr);Ausländer;25 bis unter 30;1414;832;582
09376;      Schwandorf (Lkr);Ausländer;30 bis unter 40;2731;1550;1181
09376;      Schwandorf (Lkr);Ausländer;40 bis unter 50;2279;1278;1001
09376;      Schwandorf (Lkr);Ausländer;50 bis unter 65;1535;856;679
09376;      Schwandorf (Lkr);Ausländer;65 oder älter;463;235;228
09376;      Schwandorf (Lkr);Ausländer;Insgesamt;12040;6764;5276
09377;      Tirschenreuth (Lkr);Insgesamt;unter 6;3652;1860;1792
09377;      Tirschenreuth (Lkr);Insgesamt;6 bis unter 15;5326;2711;2615
09377;      Tirschenreuth (Lkr);Insgesamt;15 bis unter 18;2073;1071;1002
09377;      Tirschenreuth (Lkr);Insgesamt;18 bis unter 25;5427;2898;2529
09377;      Tirschenreuth (Lkr);Insgesamt;25 bis unter 30;4197;2248;1949
09377;      Tirschenreuth (Lkr);Insgesamt;30 bis unter 40;7989;4133;3856
09377;      Tirschenreuth (Lkr);Insgesamt;40 bis unter 50;9127;4662;4465
09377;      Tirschenreuth (Lkr);Insgesamt;50 bis unter 65;18263;9231;9032
09377;      Tirschenreuth (Lkr);Insgesamt;65 oder älter;16450;7307;9143
09377;      Tirschenreuth (Lkr);Insgesamt;Insgesamt;72504;36121;36383
09377;      Tirschenreuth (Lkr);Deutsche;unter 6;3396;1722;1674
09377;      Tirschenreuth (Lkr);Deutsche;6 bis unter 15;5041;2563;2478
09377;      Tirschenreuth (Lkr);Deutsche;15 bis unter 18;1983;1021;962
09377;      Tirschenreuth (Lkr);Deutsche;18 bis unter 25;5109;2702;2407
09377;      Tirschenreuth (Lkr);Deutsche;25 bis unter 30;3903;2070;1833
09377;      Tirschenreuth (Lkr);Deutsche;30 bis unter 40;7357;3795;3562
09377;      Tirschenreuth (Lkr);Deutsche;40 bis unter 50;8518;4355;4163
09377;      Tirschenreuth (Lkr);Deutsche;50 bis unter 65;17783;8981;8802
09377;      Tirschenreuth (Lkr);Deutsche;65 oder älter;16227;7208;9019
09377;      Tirschenreuth (Lkr);Deutsche;Insgesamt;69317;34417;34900
09377;      Tirschenreuth (Lkr);Ausländer;unter 6;256;138;118
09377;      Tirschenreuth (Lkr);Ausländer;6 bis unter 15;285;148;137
09377;      Tirschenreuth (Lkr);Ausländer;15 bis unter 18;90;50;40
09377;      Tirschenreuth (Lkr);Ausländer;18 bis unter 25;318;196;122
09377;      Tirschenreuth (Lkr);Ausländer;25 bis unter 30;294;178;116
09377;      Tirschenreuth (Lkr);Ausländer;30 bis unter 40;632;338;294
09377;      Tirschenreuth (Lkr);Ausländer;40 bis unter 50;609;307;302
09377;      Tirschenreuth (Lkr);Ausländer;50 bis unter 65;480;250;230
09377;      Tirschenreuth (Lkr);Ausländer;65 oder älter;223;99;124
09377;      Tirschenreuth (Lkr);Ausländer;Insgesamt;3187;1704;1483
LK093;    Landkreise Oberpfalz;Insgesamt;unter 6;47561;24391;23170
LK093;    Landkreise Oberpfalz;Insgesamt;6 bis unter 15;68879;35317;33562
LK093;    Landkreise Oberpfalz;Insgesamt;15 bis unter 18;25794;13207;12587
LK093;    Landkreise Oberpfalz;Insgesamt;18 bis unter 25;68362;36510;31852
LK093;    Landkreise Oberpfalz;Insgesamt;25 bis unter 30;51058;27265;23793
LK093;    Landkreise Oberpfalz;Insgesamt;30 bis unter 40;104716;54005;50711
LK093;    Landkreise Oberpfalz;Insgesamt;40 bis unter 50;114274;58091;56183
LK093;    Landkreise Oberpfalz;Insgesamt;50 bis unter 65;213519;108620;104899
LK093;    Landkreise Oberpfalz;Insgesamt;65 oder älter;178006;80115;97891
LK093;    Landkreise Oberpfalz;Insgesamt;Insgesamt;872169;437521;434648
LK093;    Landkreise Oberpfalz;Deutsche;unter 6;42936;22002;20934
LK093;    Landkreise Oberpfalz;Deutsche;6 bis unter 15;64014;32762;31252
LK093;    Landkreise Oberpfalz;Deutsche;15 bis unter 18;24378;12459;11919
LK093;    Landkreise Oberpfalz;Deutsche;18 bis unter 25;61532;32155;29377
LK093;    Landkreise Oberpfalz;Deutsche;25 bis unter 30;44383;23270;21113
LK093;    Landkreise Oberpfalz;Deutsche;30 bis unter 40;91350;46429;44921
LK093;    Landkreise Oberpfalz;Deutsche;40 bis unter 50;102125;51413;50712
LK093;    Landkreise Oberpfalz;Deutsche;50 bis unter 65;204673;103538;101135
LK093;    Landkreise Oberpfalz;Deutsche;65 oder älter;174886;78587;96299
LK093;    Landkreise Oberpfalz;Deutsche;Insgesamt;810277;402615;407662
LK093;    Landkreise Oberpfalz;Ausländer;unter 6;4625;2389;2236
LK093;    Landkreise Oberpfalz;Ausländer;6 bis unter 15;4865;2555;2310
LK093;    Landkreise Oberpfalz;Ausländer;15 bis unter 18;1416;748;668
LK093;    Landkreise Oberpfalz;Ausländer;18 bis unter 25;6830;4355;2475
LK093;    Landkreise Oberpfalz;Ausländer;25 bis unter 30;6675;3995;2680
LK093;    Landkreise Oberpfalz;Ausländer;30 bis unter 40;13366;7576;5790
LK093;    Landkreise Oberpfalz;Ausländer;40 bis unter 50;12149;6678;5471
LK093;    Landkreise Oberpfalz;Ausländer;50 bis unter 65;8846;5082;3764
LK093;    Landkreise Oberpfalz;Ausländer;65 oder älter;3120;1528;1592
LK093;    Landkreise Oberpfalz;Ausländer;Insgesamt;61892;34906;26986
093;  Oberpfalz;Insgesamt;unter 6;60039;30720;29319
093;  Oberpfalz;Insgesamt;6 bis unter 15;85353;43811;41542
093;  Oberpfalz;Insgesamt;15 bis unter 18;31374;16048;15326
093;  Oberpfalz;Insgesamt;18 bis unter 25;90679;47499;43180
093;  Oberpfalz;Insgesamt;25 bis unter 30;73546;38823;34723
093;  Oberpfalz;Insgesamt;30 bis unter 40;140627;72810;67817
093;  Oberpfalz;Insgesamt;40 bis unter 50;143110;72476;70634
093;  Oberpfalz;Insgesamt;50 bis unter 65;260712;131662;129050
093;  Oberpfalz;Insgesamt;65 oder älter;223829;99112;124717
093;  Oberpfalz;Insgesamt;Insgesamt;1109269;552961;556308
093;  Oberpfalz;Deutsche;unter 6;53197;27184;26013
093;  Oberpfalz;Deutsche;6 bis unter 15;78110;39998;38112
093;  Oberpfalz;Deutsche;15 bis unter 18;29153;14854;14299
093;  Oberpfalz;Deutsche;18 bis unter 25;79101;40413;38688
093;  Oberpfalz;Deutsche;25 bis unter 30;61971;32084;29887
093;  Oberpfalz;Deutsche;30 bis unter 40;119627;61014;58613
093;  Oberpfalz;Deutsche;40 bis unter 50;125133;62759;62374
093;  Oberpfalz;Deutsche;50 bis unter 65;247273;124122;123151
093;  Oberpfalz;Deutsche;65 oder älter;218629;96666;121963
093;  Oberpfalz;Deutsche;Insgesamt;1012194;499094;513100
093;  Oberpfalz;Ausländer;unter 6;6842;3536;3306
093;  Oberpfalz;Ausländer;6 bis unter 15;7243;3813;3430
093;  Oberpfalz;Ausländer;15 bis unter 18;2221;1194;1027
093;  Oberpfalz;Ausländer;18 bis unter 25;11578;7086;4492
093;  Oberpfalz;Ausländer;25 bis unter 30;11575;6739;4836
093;  Oberpfalz;Ausländer;30 bis unter 40;21000;11796;9204
093;  Oberpfalz;Ausländer;40 bis unter 50;17977;9717;8260
093;  Oberpfalz;Ausländer;50 bis unter 65;13439;7540;5899
093;  Oberpfalz;Ausländer;65 oder älter;5200;2446;2754
093;  Oberpfalz;Ausländer;Insgesamt;97075;53867;43208
09461;      Bamberg (Krfr.St);Insgesamt;unter 6;4340;2241;2099
09461;      Bamberg (Krfr.St);Insgesamt;6 bis unter 15;5195;2652;2543
09461;      Bamberg (Krfr.St);Insgesamt;15 bis unter 18;1718;898;820
09461;      Bamberg (Krfr.St);Insgesamt;18 bis unter 25;7754;3622;4132
09461;      Bamberg (Krfr.St);Insgesamt;25 bis unter 30;7769;3845;3924
09461;      Bamberg (Krfr.St);Insgesamt;30 bis unter 40;11850;6239;5611
09461;      Bamberg (Krfr.St);Insgesamt;40 bis unter 50;8883;4450;4433
09461;      Bamberg (Krfr.St);Insgesamt;50 bis unter 65;15236;7413;7823
09461;      Bamberg (Krfr.St);Insgesamt;65 oder älter;14847;6104;8743
09461;      Bamberg (Krfr.St);Insgesamt;Insgesamt;77592;37464;40128
09461;      Bamberg (Krfr.St);Deutsche;unter 6;3464;1791;1673
09461;      Bamberg (Krfr.St);Deutsche;6 bis unter 15;4430;2238;2192
09461;      Bamberg (Krfr.St);Deutsche;15 bis unter 18;1481;755;726
09461;      Bamberg (Krfr.St);Deutsche;18 bis unter 25;5903;2609;3294
09461;      Bamberg (Krfr.St);Deutsche;25 bis unter 30;6079;2945;3134
09461;      Bamberg (Krfr.St);Deutsche;30 bis unter 40;9408;4893;4515
09461;      Bamberg (Krfr.St);Deutsche;40 bis unter 50;7233;3583;3650
09461;      Bamberg (Krfr.St);Deutsche;50 bis unter 65;13914;6702;7212
09461;      Bamberg (Krfr.St);Deutsche;65 oder älter;14130;5742;8388
09461;      Bamberg (Krfr.St);Deutsche;Insgesamt;66042;31258;34784
09461;      Bamberg (Krfr.St);Ausländer;unter 6;876;450;426
09461;      Bamberg (Krfr.St);Ausländer;6 bis unter 15;765;414;351
09461;      Bamberg (Krfr.St);Ausländer;15 bis unter 18;237;143;94
09461;      Bamberg (Krfr.St);Ausländer;18 bis unter 25;1851;1013;838
09461;      Bamberg (Krfr.St);Ausländer;25 bis unter 30;1690;900;790
09461;      Bamberg (Krfr.St);Ausländer;30 bis unter 40;2442;1346;1096
09461;      Bamberg (Krfr.St);Ausländer;40 bis unter 50;1650;867;783
09461;      Bamberg (Krfr.St);Ausländer;50 bis unter 65;1322;711;611
09461;      Bamberg (Krfr.St);Ausländer;65 oder älter;717;362;355
09461;      Bamberg (Krfr.St);Ausländer;Insgesamt;11550;6206;5344
09462;      Bayreuth (Krfr.St);Insgesamt;unter 6;3321;1716;1605
09462;      Bayreuth (Krfr.St);Insgesamt;6 bis unter 15;4635;2360;2275
09462;      Bayreuth (Krfr.St);Insgesamt;15 bis unter 18;1614;829;785
09462;      Bayreuth (Krfr.St);Insgesamt;18 bis unter 25;10381;5350;5031
09462;      Bayreuth (Krfr.St);Insgesamt;25 bis unter 30;6763;3625;3138
09462;      Bayreuth (Krfr.St);Insgesamt;30 bis unter 40;9162;4853;4309
09462;      Bayreuth (Krfr.St);Insgesamt;40 bis unter 50;8189;4082;4107
09462;      Bayreuth (Krfr.St);Insgesamt;50 bis unter 65;14595;7005;7590
09462;      Bayreuth (Krfr.St);Insgesamt;65 oder älter;15997;6649;9348
09462;      Bayreuth (Krfr.St);Insgesamt;Insgesamt;74657;36469;38188
09462;      Bayreuth (Krfr.St);Deutsche;unter 6;2888;1494;1394
09462;      Bayreuth (Krfr.St);Deutsche;6 bis unter 15;4135;2088;2047
09462;      Bayreuth (Krfr.St);Deutsche;15 bis unter 18;1445;744;701
09462;      Bayreuth (Krfr.St);Deutsche;18 bis unter 25;8890;4620;4270
09462;      Bayreuth (Krfr.St);Deutsche;25 bis unter 30;5472;2943;2529
09462;      Bayreuth (Krfr.St);Deutsche;30 bis unter 40;7227;3755;3472
09462;      Bayreuth (Krfr.St);Deutsche;40 bis unter 50;6764;3321;3443
09462;      Bayreuth (Krfr.St);Deutsche;50 bis unter 65;13469;6407;7062
09462;      Bayreuth (Krfr.St);Deutsche;65 oder älter;15326;6315;9011
09462;      Bayreuth (Krfr.St);Deutsche;Insgesamt;65616;31687;33929
09462;      Bayreuth (Krfr.St);Ausländer;unter 6;433;222;211
09462;      Bayreuth (Krfr.St);Ausländer;6 bis unter 15;500;272;228
09462;      Bayreuth (Krfr.St);Ausländer;15 bis unter 18;169;85;84
09462;      Bayreuth (Krfr.St);Ausländer;18 bis unter 25;1491;730;761
09462;      Bayreuth (Krfr.St);Ausländer;25 bis unter 30;1291;682;609
09462;      Bayreuth (Krfr.St);Ausländer;30 bis unter 40;1935;1098;837
09462;      Bayreuth (Krfr.St);Ausländer;40 bis unter 50;1425;761;664
09462;      Bayreuth (Krfr.St);Ausländer;50 bis unter 65;1126;598;528
09462;      Bayreuth (Krfr.St);Ausländer;65 oder älter;671;334;337
09462;      Bayreuth (Krfr.St);Ausländer;Insgesamt;9041;4782;4259
09463;      Coburg (Krfr.St);Insgesamt;unter 6;1989;1006;983
09463;      Coburg (Krfr.St);Insgesamt;6 bis unter 15;2836;1443;1393
09463;      Coburg (Krfr.St);Insgesamt;15 bis unter 18;995;525;470
09463;      Coburg (Krfr.St);Insgesamt;18 bis unter 25;3531;1881;1650
09463;      Coburg (Krfr.St);Insgesamt;25 bis unter 30;2985;1607;1378
09463;      Coburg (Krfr.St);Insgesamt;30 bis unter 40;5262;2846;2416
09463;      Coburg (Krfr.St);Insgesamt;40 bis unter 50;4661;2225;2436
09463;      Coburg (Krfr.St);Insgesamt;50 bis unter 65;9307;4540;4767
09463;      Coburg (Krfr.St);Insgesamt;65 oder älter;9683;4089;5594
09463;      Coburg (Krfr.St);Insgesamt;Insgesamt;41249;20162;21087
09463;      Coburg (Krfr.St);Deutsche;unter 6;1695;868;827
09463;      Coburg (Krfr.St);Deutsche;6 bis unter 15;2509;1268;1241
09463;      Coburg (Krfr.St);Deutsche;15 bis unter 18;896;465;431
09463;      Coburg (Krfr.St);Deutsche;18 bis unter 25;2787;1409;1378
09463;      Coburg (Krfr.St);Deutsche;25 bis unter 30;2439;1267;1172
09463;      Coburg (Krfr.St);Deutsche;30 bis unter 40;4336;2328;2008
09463;      Coburg (Krfr.St);Deutsche;40 bis unter 50;3977;1898;2079
09463;      Coburg (Krfr.St);Deutsche;50 bis unter 65;8647;4192;4455
09463;      Coburg (Krfr.St);Deutsche;65 oder älter;9367;3940;5427
09463;      Coburg (Krfr.St);Deutsche;Insgesamt;36653;17635;19018
09463;      Coburg (Krfr.St);Ausländer;unter 6;294;138;156
09463;      Coburg (Krfr.St);Ausländer;6 bis unter 15;327;175;152
09463;      Coburg (Krfr.St);Ausländer;15 bis unter 18;99;60;39
09463;      Coburg (Krfr.St);Ausländer;18 bis unter 25;744;472;272
09463;      Coburg (Krfr.St);Ausländer;25 bis unter 30;546;340;206
09463;      Coburg (Krfr.St);Ausländer;30 bis unter 40;926;518;408
09463;      Coburg (Krfr.St);Ausländer;40 bis unter 50;684;327;357
09463;      Coburg (Krfr.St);Ausländer;50 bis unter 65;660;348;312
09463;      Coburg (Krfr.St);Ausländer;65 oder älter;316;149;167
09463;      Coburg (Krfr.St);Ausländer;Insgesamt;4596;2527;2069
09464;      Hof (Krfr.St);Insgesamt;unter 6;2613;1336;1277
09464;      Hof (Krfr.St);Insgesamt;6 bis unter 15;3354;1671;1683
09464;      Hof (Krfr.St);Insgesamt;15 bis unter 18;1229;656;573
09464;      Hof (Krfr.St);Insgesamt;18 bis unter 25;3779;2019;1760
09464;      Hof (Krfr.St);Insgesamt;25 bis unter 30;3008;1544;1464
09464;      Hof (Krfr.St);Insgesamt;30 bis unter 40;5401;2781;2620
09464;      Hof (Krfr.St);Insgesamt;40 bis unter 50;5383;2657;2726
09464;      Hof (Krfr.St);Insgesamt;50 bis unter 65;10162;5004;5158
09464;      Hof (Krfr.St);Insgesamt;65 oder älter;11001;4430;6571
09464;      Hof (Krfr.St);Insgesamt;Insgesamt;45930;22098;23832
09464;      Hof (Krfr.St);Deutsche;unter 6;1884;953;931
09464;      Hof (Krfr.St);Deutsche;6 bis unter 15;2618;1310;1308
09464;      Hof (Krfr.St);Deutsche;15 bis unter 18;992;508;484
09464;      Hof (Krfr.St);Deutsche;18 bis unter 25;2776;1401;1375
09464;      Hof (Krfr.St);Deutsche;25 bis unter 30;2176;1081;1095
09464;      Hof (Krfr.St);Deutsche;30 bis unter 40;4010;2012;1998
09464;      Hof (Krfr.St);Deutsche;40 bis unter 50;4211;2040;2171
09464;      Hof (Krfr.St);Deutsche;50 bis unter 65;9123;4451;4672
09464;      Hof (Krfr.St);Deutsche;65 oder älter;10157;4032;6125
09464;      Hof (Krfr.St);Deutsche;Insgesamt;37947;17788;20159
09464;      Hof (Krfr.St);Ausländer;unter 6;729;383;346
09464;      Hof (Krfr.St);Ausländer;6 bis unter 15;736;361;375
09464;      Hof (Krfr.St);Ausländer;15 bis unter 18;237;148;89
09464;      Hof (Krfr.St);Ausländer;18 bis unter 25;1003;618;385
09464;      Hof (Krfr.St);Ausländer;25 bis unter 30;832;463;369
09464;      Hof (Krfr.St);Ausländer;30 bis unter 40;1391;769;622
09464;      Hof (Krfr.St);Ausländer;40 bis unter 50;1172;617;555
09464;      Hof (Krfr.St);Ausländer;50 bis unter 65;1039;553;486
09464;      Hof (Krfr.St);Ausländer;65 oder älter;844;398;446
09464;      Hof (Krfr.St);Ausländer;Insgesamt;7983;4310;3673
KS094;    Kreisfreie Städte Oberfranken;Insgesamt;unter 6;12263;6299;5964
KS094;    Kreisfreie Städte Oberfranken;Insgesamt;6 bis unter 15;16020;8126;7894
KS094;    Kreisfreie Städte Oberfranken;Insgesamt;15 bis unter 18;5556;2908;2648
KS094;    Kreisfreie Städte Oberfranken;Insgesamt;18 bis unter 25;25445;12872;12573
KS094;    Kreisfreie Städte Oberfranken;Insgesamt;25 bis unter 30;20525;10621;9904
KS094;    Kreisfreie Städte Oberfranken;Insgesamt;30 bis unter 40;31675;16719;14956
KS094;    Kreisfreie Städte Oberfranken;Insgesamt;40 bis unter 50;27116;13414;13702
KS094;    Kreisfreie Städte Oberfranken;Insgesamt;50 bis unter 65;49300;23962;25338
KS094;    Kreisfreie Städte Oberfranken;Insgesamt;65 oder älter;51528;21272;30256
KS094;    Kreisfreie Städte Oberfranken;Insgesamt;Insgesamt;239428;116193;123235
KS094;    Kreisfreie Städte Oberfranken;Deutsche;unter 6;9931;5106;4825
KS094;    Kreisfreie Städte Oberfranken;Deutsche;6 bis unter 15;13692;6904;6788
KS094;    Kreisfreie Städte Oberfranken;Deutsche;15 bis unter 18;4814;2472;2342
KS094;    Kreisfreie Städte Oberfranken;Deutsche;18 bis unter 25;20356;10039;10317
KS094;    Kreisfreie Städte Oberfranken;Deutsche;25 bis unter 30;16166;8236;7930
KS094;    Kreisfreie Städte Oberfranken;Deutsche;30 bis unter 40;24981;12988;11993
KS094;    Kreisfreie Städte Oberfranken;Deutsche;40 bis unter 50;22185;10842;11343
KS094;    Kreisfreie Städte Oberfranken;Deutsche;50 bis unter 65;45153;21752;23401
KS094;    Kreisfreie Städte Oberfranken;Deutsche;65 oder älter;48980;20029;28951
KS094;    Kreisfreie Städte Oberfranken;Deutsche;Insgesamt;206258;98368;107890
KS094;    Kreisfreie Städte Oberfranken;Ausländer;unter 6;2332;1193;1139
KS094;    Kreisfreie Städte Oberfranken;Ausländer;6 bis unter 15;2328;1222;1106
KS094;    Kreisfreie Städte Oberfranken;Ausländer;15 bis unter 18;742;436;306
KS094;    Kreisfreie Städte Oberfranken;Ausländer;18 bis unter 25;5089;2833;2256
KS094;    Kreisfreie Städte Oberfranken;Ausländer;25 bis unter 30;4359;2385;1974
KS094;    Kreisfreie Städte Oberfranken;Ausländer;30 bis unter 40;6694;3731;2963
KS094;    Kreisfreie Städte Oberfranken;Ausländer;40 bis unter 50;4931;2572;2359
KS094;    Kreisfreie Städte Oberfranken;Ausländer;50 bis unter 65;4147;2210;1937
KS094;    Kreisfreie Städte Oberfranken;Ausländer;65 oder älter;2548;1243;1305
KS094;    Kreisfreie Städte Oberfranken;Ausländer;Insgesamt;33170;17825;15345
09471;      Bamberg (Lkr);Insgesamt;unter 6;8514;4291;4223
09471;      Bamberg (Lkr);Insgesamt;6 bis unter 15;12036;6158;5878
09471;      Bamberg (Lkr);Insgesamt;15 bis unter 18;4491;2304;2187
09471;      Bamberg (Lkr);Insgesamt;18 bis unter 25;10939;5941;4998
09471;      Bamberg (Lkr);Insgesamt;25 bis unter 30;8571;4552;4019
09471;      Bamberg (Lkr);Insgesamt;30 bis unter 40;18329;9216;9113
09471;      Bamberg (Lkr);Insgesamt;40 bis unter 50;19635;9947;9688
09471;      Bamberg (Lkr);Insgesamt;50 bis unter 65;36588;18559;18029
09471;      Bamberg (Lkr);Insgesamt;65 oder älter;27983;12757;15226
09471;      Bamberg (Lkr);Insgesamt;Insgesamt;147086;73725;73361
09471;      Bamberg (Lkr);Deutsche;unter 6;8093;4073;4020
09471;      Bamberg (Lkr);Deutsche;6 bis unter 15;11501;5874;5627
09471;      Bamberg (Lkr);Deutsche;15 bis unter 18;4304;2190;2114
09471;      Bamberg (Lkr);Deutsche;18 bis unter 25;10082;5382;4700
09471;      Bamberg (Lkr);Deutsche;25 bis unter 30;7805;4090;3715
09471;      Bamberg (Lkr);Deutsche;30 bis unter 40;16796;8364;8432
09471;      Bamberg (Lkr);Deutsche;40 bis unter 50;18215;9154;9061
09471;      Bamberg (Lkr);Deutsche;50 bis unter 65;35388;17855;17533
09471;      Bamberg (Lkr);Deutsche;65 oder älter;27482;12485;14997
09471;      Bamberg (Lkr);Deutsche;Insgesamt;139666;69467;70199
09471;      Bamberg (Lkr);Ausländer;unter 6;421;218;203
09471;      Bamberg (Lkr);Ausländer;6 bis unter 15;535;284;251
09471;      Bamberg (Lkr);Ausländer;15 bis unter 18;187;114;73
09471;      Bamberg (Lkr);Ausländer;18 bis unter 25;857;559;298
09471;      Bamberg (Lkr);Ausländer;25 bis unter 30;766;462;304
09471;      Bamberg (Lkr);Ausländer;30 bis unter 40;1533;852;681
09471;      Bamberg (Lkr);Ausländer;40 bis unter 50;1420;793;627
09471;      Bamberg (Lkr);Ausländer;50 bis unter 65;1200;704;496
09471;      Bamberg (Lkr);Ausländer;65 oder älter;501;272;229
09471;      Bamberg (Lkr);Ausländer;Insgesamt;7420;4258;3162
09472;      Bayreuth (Lkr);Insgesamt;unter 6;5207;2668;2539
09472;      Bayreuth (Lkr);Insgesamt;6 bis unter 15;8130;4173;3957
09472;      Bayreuth (Lkr);Insgesamt;15 bis unter 18;3091;1610;1481
09472;      Bayreuth (Lkr);Insgesamt;18 bis unter 25;7299;3883;3416
09472;      Bayreuth (Lkr);Insgesamt;25 bis unter 30;5277;2746;2531
09472;      Bayreuth (Lkr);Insgesamt;30 bis unter 40;11694;5842;5852
09472;      Bayreuth (Lkr);Insgesamt;40 bis unter 50;13603;6771;6832
09472;      Bayreuth (Lkr);Insgesamt;50 bis unter 65;26144;13255;12889
09472;      Bayreuth (Lkr);Insgesamt;65 oder älter;23211;10362;12849
09472;      Bayreuth (Lkr);Insgesamt;Insgesamt;103656;51310;52346
09472;      Bayreuth (Lkr);Deutsche;unter 6;4963;2551;2412
09472;      Bayreuth (Lkr);Deutsche;6 bis unter 15;7814;4005;3809
09472;      Bayreuth (Lkr);Deutsche;15 bis unter 18;2994;1548;1446
09472;      Bayreuth (Lkr);Deutsche;18 bis unter 25;6934;3650;3284
09472;      Bayreuth (Lkr);Deutsche;25 bis unter 30;4932;2550;2382
09472;      Bayreuth (Lkr);Deutsche;30 bis unter 40;10922;5418;5504
09472;      Bayreuth (Lkr);Deutsche;40 bis unter 50;12770;6344;6426
09472;      Bayreuth (Lkr);Deutsche;50 bis unter 65;25474;12902;12572
09472;      Bayreuth (Lkr);Deutsche;65 oder älter;22915;10210;12705
09472;      Bayreuth (Lkr);Deutsche;Insgesamt;99718;49178;50540
09472;      Bayreuth (Lkr);Ausländer;unter 6;244;117;127
09472;      Bayreuth (Lkr);Ausländer;6 bis unter 15;316;168;148
09472;      Bayreuth (Lkr);Ausländer;15 bis unter 18;97;62;35
09472;      Bayreuth (Lkr);Ausländer;18 bis unter 25;365;233;132
09472;      Bayreuth (Lkr);Ausländer;25 bis unter 30;345;196;149
09472;      Bayreuth (Lkr);Ausländer;30 bis unter 40;772;424;348
09472;      Bayreuth (Lkr);Ausländer;40 bis unter 50;833;427;406
09472;      Bayreuth (Lkr);Ausländer;50 bis unter 65;670;353;317
09472;      Bayreuth (Lkr);Ausländer;65 oder älter;296;152;144
09472;      Bayreuth (Lkr);Ausländer;Insgesamt;3938;2132;1806
09473;      Coburg (Lkr);Insgesamt;unter 6;4523;2304;2219
09473;      Coburg (Lkr);Insgesamt;6 bis unter 15;6531;3381;3150
09473;      Coburg (Lkr);Insgesamt;15 bis unter 18;2439;1283;1156
09473;      Coburg (Lkr);Insgesamt;18 bis unter 25;5992;3199;2793
09473;      Coburg (Lkr);Insgesamt;25 bis unter 30;4576;2458;2118
09473;      Coburg (Lkr);Insgesamt;30 bis unter 40;10087;5107;4980
09473;      Coburg (Lkr);Insgesamt;40 bis unter 50;10845;5345;5500
09473;      Coburg (Lkr);Insgesamt;50 bis unter 65;21877;10995;10882
09473;      Coburg (Lkr);Insgesamt;65 oder älter;20036;8840;11196
09473;      Coburg (Lkr);Insgesamt;Insgesamt;86906;42912;43994
09473;      Coburg (Lkr);Deutsche;unter 6;4205;2146;2059
09473;      Coburg (Lkr);Deutsche;6 bis unter 15;6118;3155;2963
09473;      Coburg (Lkr);Deutsche;15 bis unter 18;2334;1222;1112
09473;      Coburg (Lkr);Deutsche;18 bis unter 25;5501;2908;2593
09473;      Coburg (Lkr);Deutsche;25 bis unter 30;4129;2215;1914
09473;      Coburg (Lkr);Deutsche;30 bis unter 40;9167;4608;4559
09473;      Coburg (Lkr);Deutsche;40 bis unter 50;9949;4849;5100
09473;      Coburg (Lkr);Deutsche;50 bis unter 65;21109;10576;10533
09473;      Coburg (Lkr);Deutsche;65 oder älter;19622;8634;10988
09473;      Coburg (Lkr);Deutsche;Insgesamt;82134;40313;41821
09473;      Coburg (Lkr);Ausländer;unter 6;318;158;160
09473;      Coburg (Lkr);Ausländer;6 bis unter 15;413;226;187
09473;      Coburg (Lkr);Ausländer;15 bis unter 18;105;61;44
09473;      Coburg (Lkr);Ausländer;18 bis unter 25;491;291;200
09473;      Coburg (Lkr);Ausländer;25 bis unter 30;447;243;204
09473;      Coburg (Lkr);Ausländer;30 bis unter 40;920;499;421
09473;      Coburg (Lkr);Ausländer;40 bis unter 50;896;496;400
09473;      Coburg (Lkr);Ausländer;50 bis unter 65;768;419;349
09473;      Coburg (Lkr);Ausländer;65 oder älter;414;206;208
09473;      Coburg (Lkr);Ausländer;Insgesamt;4772;2599;2173
09474;      Forchheim (Lkr);Insgesamt;unter 6;6567;3317;3250
09474;      Forchheim (Lkr);Insgesamt;6 bis unter 15;9402;4735;4667
09474;      Forchheim (Lkr);Insgesamt;15 bis unter 18;3511;1816;1695
09474;      Forchheim (Lkr);Insgesamt;18 bis unter 25;8711;4649;4062
09474;      Forchheim (Lkr);Insgesamt;25 bis unter 30;6538;3457;3081
09474;      Forchheim (Lkr);Insgesamt;30 bis unter 40;13985;7043;6942
09474;      Forchheim (Lkr);Insgesamt;40 bis unter 50;14776;7387;7389
09474;      Forchheim (Lkr);Insgesamt;50 bis unter 65;29126;14684;14442
09474;      Forchheim (Lkr);Insgesamt;65 oder älter;23483;10615;12868
09474;      Forchheim (Lkr);Insgesamt;Insgesamt;116099;57703;58396
09474;      Forchheim (Lkr);Deutsche;unter 6;6089;3065;3024
09474;      Forchheim (Lkr);Deutsche;6 bis unter 15;8817;4410;4407
09474;      Forchheim (Lkr);Deutsche;15 bis unter 18;3320;1708;1612
09474;      Forchheim (Lkr);Deutsche;18 bis unter 25;7902;4150;3752
09474;      Forchheim (Lkr);Deutsche;25 bis unter 30;5808;3033;2775
09474;      Forchheim (Lkr);Deutsche;30 bis unter 40;12410;6252;6158
09474;      Forchheim (Lkr);Deutsche;40 bis unter 50;13262;6627;6635
09474;      Forchheim (Lkr);Deutsche;50 bis unter 65;27866;14048;13818
09474;      Forchheim (Lkr);Deutsche;65 oder älter;22768;10270;12498
09474;      Forchheim (Lkr);Deutsche;Insgesamt;108242;53563;54679
09474;      Forchheim (Lkr);Ausländer;unter 6;478;252;226
09474;      Forchheim (Lkr);Ausländer;6 bis unter 15;585;325;260
09474;      Forchheim (Lkr);Ausländer;15 bis unter 18;191;108;83
09474;      Forchheim (Lkr);Ausländer;18 bis unter 25;809;499;310
09474;      Forchheim (Lkr);Ausländer;25 bis unter 30;730;424;306
09474;      Forchheim (Lkr);Ausländer;30 bis unter 40;1575;791;784
09474;      Forchheim (Lkr);Ausländer;40 bis unter 50;1514;760;754
09474;      Forchheim (Lkr);Ausländer;50 bis unter 65;1260;636;624
09474;      Forchheim (Lkr);Ausländer;65 oder älter;715;345;370
09474;      Forchheim (Lkr);Ausländer;Insgesamt;7857;4140;3717
09475;      Hof (Lkr);Insgesamt;unter 6;4342;2183;2159
09475;      Hof (Lkr);Insgesamt;6 bis unter 15;6766;3444;3322
09475;      Hof (Lkr);Insgesamt;15 bis unter 18;2696;1380;1316
09475;      Hof (Lkr);Insgesamt;18 bis unter 25;6457;3457;3000
09475;      Hof (Lkr);Insgesamt;25 bis unter 30;4826;2553;2273
09475;      Hof (Lkr);Insgesamt;30 bis unter 40;9719;4939;4780
09475;      Hof (Lkr);Insgesamt;40 bis unter 50;11735;5750;5985
09475;      Hof (Lkr);Insgesamt;50 bis unter 65;24257;12270;11987
09475;      Hof (Lkr);Insgesamt;65 oder älter;24513;10670;13843
09475;      Hof (Lkr);Insgesamt;Insgesamt;95311;46646;48665
09475;      Hof (Lkr);Deutsche;unter 6;3939;1990;1949
09475;      Hof (Lkr);Deutsche;6 bis unter 15;6310;3207;3103
09475;      Hof (Lkr);Deutsche;15 bis unter 18;2575;1315;1260
09475;      Hof (Lkr);Deutsche;18 bis unter 25;5860;3073;2787
09475;      Hof (Lkr);Deutsche;25 bis unter 30;4327;2263;2064
09475;      Hof (Lkr);Deutsche;30 bis unter 40;8672;4381;4291
09475;      Hof (Lkr);Deutsche;40 bis unter 50;10786;5263;5523
09475;      Hof (Lkr);Deutsche;50 bis unter 65;23305;11758;11547
09475;      Hof (Lkr);Deutsche;65 oder älter;23913;10386;13527
09475;      Hof (Lkr);Deutsche;Insgesamt;89687;43636;46051
09475;      Hof (Lkr);Ausländer;unter 6;403;193;210
09475;      Hof (Lkr);Ausländer;6 bis unter 15;456;237;219
09475;      Hof (Lkr);Ausländer;15 bis unter 18;121;65;56
09475;      Hof (Lkr);Ausländer;18 bis unter 25;597;384;213
09475;      Hof (Lkr);Ausländer;25 bis unter 30;499;290;209
09475;      Hof (Lkr);Ausländer;30 bis unter 40;1047;558;489
09475;      Hof (Lkr);Ausländer;40 bis unter 50;949;487;462
09475;      Hof (Lkr);Ausländer;50 bis unter 65;952;512;440
09475;      Hof (Lkr);Ausländer;65 oder älter;600;284;316
09475;      Hof (Lkr);Ausländer;Insgesamt;5624;3010;2614
09476;      Kronach (Lkr);Insgesamt;unter 6;2882;1455;1427
09476;      Kronach (Lkr);Insgesamt;6 bis unter 15;4672;2350;2322
09476;      Kronach (Lkr);Insgesamt;15 bis unter 18;1885;959;926
09476;      Kronach (Lkr);Insgesamt;18 bis unter 25;4503;2410;2093
09476;      Kronach (Lkr);Insgesamt;25 bis unter 30;3480;1855;1625
09476;      Kronach (Lkr);Insgesamt;30 bis unter 40;7223;3775;3448
09476;      Kronach (Lkr);Insgesamt;40 bis unter 50;8642;4347;4295
09476;      Kronach (Lkr);Insgesamt;50 bis unter 65;17619;8952;8667
09476;      Kronach (Lkr);Insgesamt;65 oder älter;16229;7081;9148
09476;      Kronach (Lkr);Insgesamt;Insgesamt;67135;33184;33951
09476;      Kronach (Lkr);Deutsche;unter 6;2683;1349;1334
09476;      Kronach (Lkr);Deutsche;6 bis unter 15;4425;2228;2197
09476;      Kronach (Lkr);Deutsche;15 bis unter 18;1805;905;900
09476;      Kronach (Lkr);Deutsche;18 bis unter 25;4127;2179;1948
09476;      Kronach (Lkr);Deutsche;25 bis unter 30;3133;1660;1473
09476;      Kronach (Lkr);Deutsche;30 bis unter 40;6607;3438;3169
09476;      Kronach (Lkr);Deutsche;40 bis unter 50;8010;4012;3998
09476;      Kronach (Lkr);Deutsche;50 bis unter 65;17056;8642;8414
09476;      Kronach (Lkr);Deutsche;65 oder älter;15992;6956;9036
09476;      Kronach (Lkr);Deutsche;Insgesamt;63838;31369;32469
09476;      Kronach (Lkr);Ausländer;unter 6;199;106;93
09476;      Kronach (Lkr);Ausländer;6 bis unter 15;247;122;125
09476;      Kronach (Lkr);Ausländer;15 bis unter 18;80;54;26
09476;      Kronach (Lkr);Ausländer;18 bis unter 25;376;231;145
09476;      Kronach (Lkr);Ausländer;25 bis unter 30;347;195;152
09476;      Kronach (Lkr);Ausländer;30 bis unter 40;616;337;279
09476;      Kronach (Lkr);Ausländer;40 bis unter 50;632;335;297
09476;      Kronach (Lkr);Ausländer;50 bis unter 65;563;310;253
09476;      Kronach (Lkr);Ausländer;65 oder älter;237;125;112
09476;      Kronach (Lkr);Ausländer;Insgesamt;3297;1815;1482
09477;      Kulmbach (Lkr);Insgesamt;unter 6;3202;1632;1570
09477;      Kulmbach (Lkr);Insgesamt;6 bis unter 15;5196;2675;2521
09477;      Kulmbach (Lkr);Insgesamt;15 bis unter 18;2068;1056;1012
09477;      Kulmbach (Lkr);Insgesamt;18 bis unter 25;5050;2759;2291
09477;      Kulmbach (Lkr);Insgesamt;25 bis unter 30;3706;2015;1691
09477;      Kulmbach (Lkr);Insgesamt;30 bis unter 40;7672;3929;3743
09477;      Kulmbach (Lkr);Insgesamt;40 bis unter 50;9237;4527;4710
09477;      Kulmbach (Lkr);Insgesamt;50 bis unter 65;18419;9234;9185
09477;      Kulmbach (Lkr);Insgesamt;65 oder älter;17295;7518;9777
09477;      Kulmbach (Lkr);Insgesamt;Insgesamt;71845;35345;36500
09477;      Kulmbach (Lkr);Deutsche;unter 6;2978;1524;1454
09477;      Kulmbach (Lkr);Deutsche;6 bis unter 15;4886;2519;2367
09477;      Kulmbach (Lkr);Deutsche;15 bis unter 18;1982;1012;970
09477;      Kulmbach (Lkr);Deutsche;18 bis unter 25;4647;2499;2148
09477;      Kulmbach (Lkr);Deutsche;25 bis unter 30;3398;1820;1578
09477;      Kulmbach (Lkr);Deutsche;30 bis unter 40;6958;3542;3416
09477;      Kulmbach (Lkr);Deutsche;40 bis unter 50;8608;4204;4404
09477;      Kulmbach (Lkr);Deutsche;50 bis unter 65;17814;8910;8904
09477;      Kulmbach (Lkr);Deutsche;65 oder älter;17016;7366;9650
09477;      Kulmbach (Lkr);Deutsche;Insgesamt;68287;33396;34891
09477;      Kulmbach (Lkr);Ausländer;unter 6;224;108;116
09477;      Kulmbach (Lkr);Ausländer;6 bis unter 15;310;156;154
09477;      Kulmbach (Lkr);Ausländer;15 bis unter 18;86;44;42
09477;      Kulmbach (Lkr);Ausländer;18 bis unter 25;403;260;143
09477;      Kulmbach (Lkr);Ausländer;25 bis unter 30;308;195;113
09477;      Kulmbach (Lkr);Ausländer;30 bis unter 40;714;387;327
09477;      Kulmbach (Lkr);Ausländer;40 bis unter 50;629;323;306
09477;      Kulmbach (Lkr);Ausländer;50 bis unter 65;605;324;281
09477;      Kulmbach (Lkr);Ausländer;65 oder älter;279;152;127
09477;      Kulmbach (Lkr);Ausländer;Insgesamt;3558;1949;1609
09478;      Lichtenfels (Lkr);Insgesamt;unter 6;3371;1727;1644
09478;      Lichtenfels (Lkr);Insgesamt;6 bis unter 15;5000;2499;2501
09478;      Lichtenfels (Lkr);Insgesamt;15 bis unter 18;1849;970;879
09478;      Lichtenfels (Lkr);Insgesamt;18 bis unter 25;4877;2588;2289
09478;      Lichtenfels (Lkr);Insgesamt;25 bis unter 30;3775;2006;1769
09478;      Lichtenfels (Lkr);Insgesamt;30 bis unter 40;7569;3848;3721
09478;      Lichtenfels (Lkr);Insgesamt;40 bis unter 50;8545;4269;4276
09478;      Lichtenfels (Lkr);Insgesamt;50 bis unter 65;16767;8428;8339
09478;      Lichtenfels (Lkr);Insgesamt;65 oder älter;15085;6692;8393
09478;      Lichtenfels (Lkr);Insgesamt;Insgesamt;66838;33027;33811
09478;      Lichtenfels (Lkr);Deutsche;unter 6;3105;1582;1523
09478;      Lichtenfels (Lkr);Deutsche;6 bis unter 15;4725;2352;2373
09478;      Lichtenfels (Lkr);Deutsche;15 bis unter 18;1748;913;835
09478;      Lichtenfels (Lkr);Deutsche;18 bis unter 25;4376;2294;2082
09478;      Lichtenfels (Lkr);Deutsche;25 bis unter 30;3356;1785;1571
09478;      Lichtenfels (Lkr);Deutsche;30 bis unter 40;6792;3425;3367
09478;      Lichtenfels (Lkr);Deutsche;40 bis unter 50;7804;3905;3899
09478;      Lichtenfels (Lkr);Deutsche;50 bis unter 65;16195;8130;8065
09478;      Lichtenfels (Lkr);Deutsche;65 oder älter;14850;6569;8281
09478;      Lichtenfels (Lkr);Deutsche;Insgesamt;62951;30955;31996
09478;      Lichtenfels (Lkr);Ausländer;unter 6;266;145;121
09478;      Lichtenfels (Lkr);Ausländer;6 bis unter 15;275;147;128
09478;      Lichtenfels (Lkr);Ausländer;15 bis unter 18;101;57;44
09478;      Lichtenfels (Lkr);Ausländer;18 bis unter 25;501;294;207
09478;      Lichtenfels (Lkr);Ausländer;25 bis unter 30;419;221;198
09478;      Lichtenfels (Lkr);Ausländer;30 bis unter 40;777;423;354
09478;      Lichtenfels (Lkr);Ausländer;40 bis unter 50;741;364;377
09478;      Lichtenfels (Lkr);Ausländer;50 bis unter 65;572;298;274
09478;      Lichtenfels (Lkr);Ausländer;65 oder älter;235;123;112
09478;      Lichtenfels (Lkr);Ausländer;Insgesamt;3887;2072;1815
09479;      Wunsiedel i.Fichtelgebirge (Lkr);Insgesamt;unter 6;3446;1800;1646
09479;      Wunsiedel i.Fichtelgebirge (Lkr);Insgesamt;6 bis unter 15;5137;2629;2508
09479;      Wunsiedel i.Fichtelgebirge (Lkr);Insgesamt;15 bis unter 18;2030;1055;975
09479;      Wunsiedel i.Fichtelgebirge (Lkr);Insgesamt;18 bis unter 25;5079;2728;2351
09479;      Wunsiedel i.Fichtelgebirge (Lkr);Insgesamt;25 bis unter 30;3726;1971;1755
09479;      Wunsiedel i.Fichtelgebirge (Lkr);Insgesamt;30 bis unter 40;7514;3861;3653
09479;      Wunsiedel i.Fichtelgebirge (Lkr);Insgesamt;40 bis unter 50;8593;4261;4332
09479;      Wunsiedel i.Fichtelgebirge (Lkr);Insgesamt;50 bis unter 65;18360;9192;9168
09479;      Wunsiedel i.Fichtelgebirge (Lkr);Insgesamt;65 oder älter;19293;8221;11072
09479;      Wunsiedel i.Fichtelgebirge (Lkr);Insgesamt;Insgesamt;73178;35718;37460
09479;      Wunsiedel i.Fichtelgebirge (Lkr);Deutsche;unter 6;2960;1547;1413
09479;      Wunsiedel i.Fichtelgebirge (Lkr);Deutsche;6 bis unter 15;4535;2314;2221
09479;      Wunsiedel i.Fichtelgebirge (Lkr);Deutsche;15 bis unter 18;1863;957;906
09479;      Wunsiedel i.Fichtelgebirge (Lkr);Deutsche;18 bis unter 25;4369;2301;2068
09479;      Wunsiedel i.Fichtelgebirge (Lkr);Deutsche;25 bis unter 30;3224;1683;1541
09479;      Wunsiedel i.Fichtelgebirge (Lkr);Deutsche;30 bis unter 40;6414;3275;3139
09479;      Wunsiedel i.Fichtelgebirge (Lkr);Deutsche;40 bis unter 50;7552;3745;3807
09479;      Wunsiedel i.Fichtelgebirge (Lkr);Deutsche;50 bis unter 65;17326;8617;8709
09479;      Wunsiedel i.Fichtelgebirge (Lkr);Deutsche;65 oder älter;18617;7906;10711
09479;      Wunsiedel i.Fichtelgebirge (Lkr);Deutsche;Insgesamt;66860;32345;34515
09479;      Wunsiedel i.Fichtelgebirge (Lkr);Ausländer;unter 6;486;253;233
09479;      Wunsiedel i.Fichtelgebirge (Lkr);Ausländer;6 bis unter 15;602;315;287
09479;      Wunsiedel i.Fichtelgebirge (Lkr);Ausländer;15 bis unter 18;167;98;69
09479;      Wunsiedel i.Fichtelgebirge (Lkr);Ausländer;18 bis unter 25;710;427;283
09479;      Wunsiedel i.Fichtelgebirge (Lkr);Ausländer;25 bis unter 30;502;288;214
09479;      Wunsiedel i.Fichtelgebirge (Lkr);Ausländer;30 bis unter 40;1100;586;514
09479;      Wunsiedel i.Fichtelgebirge (Lkr);Ausländer;40 bis unter 50;1041;516;525
09479;      Wunsiedel i.Fichtelgebirge (Lkr);Ausländer;50 bis unter 65;1034;575;459
09479;      Wunsiedel i.Fichtelgebirge (Lkr);Ausländer;65 oder älter;676;315;361
09479;      Wunsiedel i.Fichtelgebirge (Lkr);Ausländer;Insgesamt;6318;3373;2945
LK094;    Landkreise Oberfranken;Insgesamt;unter 6;42054;21377;20677
LK094;    Landkreise Oberfranken;Insgesamt;6 bis unter 15;62870;32044;30826
LK094;    Landkreise Oberfranken;Insgesamt;15 bis unter 18;24060;12433;11627
LK094;    Landkreise Oberfranken;Insgesamt;18 bis unter 25;58907;31614;27293
LK094;    Landkreise Oberfranken;Insgesamt;25 bis unter 30;44475;23613;20862
LK094;    Landkreise Oberfranken;Insgesamt;30 bis unter 40;93792;47560;46232
LK094;    Landkreise Oberfranken;Insgesamt;40 bis unter 50;105611;52604;53007
LK094;    Landkreise Oberfranken;Insgesamt;50 bis unter 65;209157;105569;103588
LK094;    Landkreise Oberfranken;Insgesamt;65 oder älter;187128;82756;104372
LK094;    Landkreise Oberfranken;Insgesamt;Insgesamt;828054;409570;418484
LK094;    Landkreise Oberfranken;Deutsche;unter 6;39015;19827;19188
LK094;    Landkreise Oberfranken;Deutsche;6 bis unter 15;59131;30064;29067
LK094;    Landkreise Oberfranken;Deutsche;15 bis unter 18;22925;11770;11155
LK094;    Landkreise Oberfranken;Deutsche;18 bis unter 25;53798;28436;25362
LK094;    Landkreise Oberfranken;Deutsche;25 bis unter 30;40112;21099;19013
LK094;    Landkreise Oberfranken;Deutsche;30 bis unter 40;84738;42703;42035
LK094;    Landkreise Oberfranken;Deutsche;40 bis unter 50;96956;48103;48853
LK094;    Landkreise Oberfranken;Deutsche;50 bis unter 65;201533;101438;100095
LK094;    Landkreise Oberfranken;Deutsche;65 oder älter;183175;80782;102393
LK094;    Landkreise Oberfranken;Deutsche;Insgesamt;781383;384222;397161
LK094;    Landkreise Oberfranken;Ausländer;unter 6;3039;1550;1489
LK094;    Landkreise Oberfranken;Ausländer;6 bis unter 15;3739;1980;1759
LK094;    Landkreise Oberfranken;Ausländer;15 bis unter 18;1135;663;472
LK094;    Landkreise Oberfranken;Ausländer;18 bis unter 25;5109;3178;1931
LK094;    Landkreise Oberfranken;Ausländer;25 bis unter 30;4363;2514;1849
LK094;    Landkreise Oberfranken;Ausländer;30 bis unter 40;9054;4857;4197
LK094;    Landkreise Oberfranken;Ausländer;40 bis unter 50;8655;4501;4154
LK094;    Landkreise Oberfranken;Ausländer;50 bis unter 65;7624;4131;3493
LK094;    Landkreise Oberfranken;Ausländer;65 oder älter;3953;1974;1979
LK094;    Landkreise Oberfranken;Ausländer;Insgesamt;46671;25348;21323
094;  Oberfranken;Insgesamt;unter 6;54317;27676;26641
094;  Oberfranken;Insgesamt;6 bis unter 15;78890;40170;38720
094;  Oberfranken;Insgesamt;15 bis unter 18;29616;15341;14275
094;  Oberfranken;Insgesamt;18 bis unter 25;84352;44486;39866
094;  Oberfranken;Insgesamt;25 bis unter 30;65000;34234;30766
094;  Oberfranken;Insgesamt;30 bis unter 40;125467;64279;61188
094;  Oberfranken;Insgesamt;40 bis unter 50;132727;66018;66709
094;  Oberfranken;Insgesamt;50 bis unter 65;258457;129531;128926
094;  Oberfranken;Insgesamt;65 oder älter;238656;104028;134628
094;  Oberfranken;Insgesamt;Insgesamt;1067482;525763;541719
094;  Oberfranken;Deutsche;unter 6;48946;24933;24013
094;  Oberfranken;Deutsche;6 bis unter 15;72823;36968;35855
094;  Oberfranken;Deutsche;15 bis unter 18;27739;14242;13497
094;  Oberfranken;Deutsche;18 bis unter 25;74154;38475;35679
094;  Oberfranken;Deutsche;25 bis unter 30;56278;29335;26943
094;  Oberfranken;Deutsche;30 bis unter 40;109719;55691;54028
094;  Oberfranken;Deutsche;40 bis unter 50;119141;58945;60196
094;  Oberfranken;Deutsche;50 bis unter 65;246686;123190;123496
094;  Oberfranken;Deutsche;65 oder älter;232155;100811;131344
094;  Oberfranken;Deutsche;Insgesamt;987641;482590;505051
094;  Oberfranken;Ausländer;unter 6;5371;2743;2628
094;  Oberfranken;Ausländer;6 bis unter 15;6067;3202;2865
094;  Oberfranken;Ausländer;15 bis unter 18;1877;1099;778
094;  Oberfranken;Ausländer;18 bis unter 25;10198;6011;4187
094;  Oberfranken;Ausländer;25 bis unter 30;8722;4899;3823
094;  Oberfranken;Ausländer;30 bis unter 40;15748;8588;7160
094;  Oberfranken;Ausländer;40 bis unter 50;13586;7073;6513
094;  Oberfranken;Ausländer;50 bis unter 65;11771;6341;5430
094;  Oberfranken;Ausländer;65 oder älter;6501;3217;3284
094;  Oberfranken;Ausländer;Insgesamt;79841;43173;36668
09561;      Ansbach (Krfr.St);Insgesamt;unter 6;2471;1243;1228
09561;      Ansbach (Krfr.St);Insgesamt;6 bis unter 15;3267;1650;1617
09561;      Ansbach (Krfr.St);Insgesamt;15 bis unter 18;1153;598;555
09561;      Ansbach (Krfr.St);Insgesamt;18 bis unter 25;3487;1788;1699
09561;      Ansbach (Krfr.St);Insgesamt;25 bis unter 30;2927;1454;1473
09561;      Ansbach (Krfr.St);Insgesamt;30 bis unter 40;5248;2670;2578
09561;      Ansbach (Krfr.St);Insgesamt;40 bis unter 50;5092;2445;2647
09561;      Ansbach (Krfr.St);Insgesamt;50 bis unter 65;9317;4485;4832
09561;      Ansbach (Krfr.St);Insgesamt;65 oder älter;8885;3715;5170
09561;      Ansbach (Krfr.St);Insgesamt;Insgesamt;41847;20048;21799
09561;      Ansbach (Krfr.St);Deutsche;unter 6;1900;963;937
09561;      Ansbach (Krfr.St);Deutsche;6 bis unter 15;2731;1359;1372
09561;      Ansbach (Krfr.St);Deutsche;15 bis unter 18;999;517;482
09561;      Ansbach (Krfr.St);Deutsche;18 bis unter 25;2763;1388;1375
09561;      Ansbach (Krfr.St);Deutsche;25 bis unter 30;2287;1104;1183
09561;      Ansbach (Krfr.St);Deutsche;30 bis unter 40;4175;2107;2068
09561;      Ansbach (Krfr.St);Deutsche;40 bis unter 50;4092;1972;2120
09561;      Ansbach (Krfr.St);Deutsche;50 bis unter 65;8441;4048;4393
09561;      Ansbach (Krfr.St);Deutsche;65 oder älter;8530;3566;4964
09561;      Ansbach (Krfr.St);Deutsche;Insgesamt;35918;17024;18894
09561;      Ansbach (Krfr.St);Ausländer;unter 6;571;280;291
09561;      Ansbach (Krfr.St);Ausländer;6 bis unter 15;536;291;245
09561;      Ansbach (Krfr.St);Ausländer;15 bis unter 18;154;81;73
09561;      Ansbach (Krfr.St);Ausländer;18 bis unter 25;724;400;324
09561;      Ansbach (Krfr.St);Ausländer;25 bis unter 30;640;350;290
09561;      Ansbach (Krfr.St);Ausländer;30 bis unter 40;1073;563;510
09561;      Ansbach (Krfr.St);Ausländer;40 bis unter 50;1000;473;527
09561;      Ansbach (Krfr.St);Ausländer;50 bis unter 65;876;437;439
09561;      Ansbach (Krfr.St);Ausländer;65 oder älter;355;149;206
09561;      Ansbach (Krfr.St);Ausländer;Insgesamt;5929;3024;2905
09562;      Erlangen (Krfr.St);Insgesamt;unter 6;6500;3315;3185
09562;      Erlangen (Krfr.St);Insgesamt;6 bis unter 15;8393;4374;4019
09562;      Erlangen (Krfr.St);Insgesamt;15 bis unter 18;2784;1451;1333
09562;      Erlangen (Krfr.St);Insgesamt;18 bis unter 25;11809;5948;5861
09562;      Erlangen (Krfr.St);Insgesamt;25 bis unter 30;11303;6108;5195
09562;      Erlangen (Krfr.St);Insgesamt;30 bis unter 40;16994;9003;7991
09562;      Erlangen (Krfr.St);Insgesamt;40 bis unter 50;13080;6594;6486
09562;      Erlangen (Krfr.St);Insgesamt;50 bis unter 65;21314;10614;10700
09562;      Erlangen (Krfr.St);Insgesamt;65 oder älter;19785;8457;11328
09562;      Erlangen (Krfr.St);Insgesamt;Insgesamt;111962;55864;56098
09562;      Erlangen (Krfr.St);Deutsche;unter 6;5308;2683;2625
09562;      Erlangen (Krfr.St);Deutsche;6 bis unter 15;7027;3624;3403
09562;      Erlangen (Krfr.St);Deutsche;15 bis unter 18;2432;1254;1178
09562;      Erlangen (Krfr.St);Deutsche;18 bis unter 25;8997;4419;4578
09562;      Erlangen (Krfr.St);Deutsche;25 bis unter 30;8065;4292;3773
09562;      Erlangen (Krfr.St);Deutsche;30 bis unter 40;12569;6770;5799
09562;      Erlangen (Krfr.St);Deutsche;40 bis unter 50;10082;5139;4943
09562;      Erlangen (Krfr.St);Deutsche;50 bis unter 65;18870;9359;9511
09562;      Erlangen (Krfr.St);Deutsche;65 oder älter;18310;7735;10575
09562;      Erlangen (Krfr.St);Deutsche;Insgesamt;91660;45275;46385
09562;      Erlangen (Krfr.St);Ausländer;unter 6;1192;632;560
09562;      Erlangen (Krfr.St);Ausländer;6 bis unter 15;1366;750;616
09562;      Erlangen (Krfr.St);Ausländer;15 bis unter 18;352;197;155
09562;      Erlangen (Krfr.St);Ausländer;18 bis unter 25;2812;1529;1283
09562;      Erlangen (Krfr.St);Ausländer;25 bis unter 30;3238;1816;1422
09562;      Erlangen (Krfr.St);Ausländer;30 bis unter 40;4425;2233;2192
09562;      Erlangen (Krfr.St);Ausländer;40 bis unter 50;2998;1455;1543
09562;      Erlangen (Krfr.St);Ausländer;50 bis unter 65;2444;1255;1189
09562;      Erlangen (Krfr.St);Ausländer;65 oder älter;1475;722;753
09562;      Erlangen (Krfr.St);Ausländer;Insgesamt;20302;10589;9713
09563;      Fürth (Krfr.St);Insgesamt;unter 6;7732;3963;3769
09563;      Fürth (Krfr.St);Insgesamt;6 bis unter 15;9523;5005;4518
09563;      Fürth (Krfr.St);Insgesamt;15 bis unter 18;3358;1765;1593
09563;      Fürth (Krfr.St);Insgesamt;18 bis unter 25;10120;5265;4855
09563;      Fürth (Krfr.St);Insgesamt;25 bis unter 30;9017;4676;4341
09563;      Fürth (Krfr.St);Insgesamt;30 bis unter 40;18838;9471;9367
09563;      Fürth (Krfr.St);Insgesamt;40 bis unter 50;17424;8575;8849
09563;      Fürth (Krfr.St);Insgesamt;50 bis unter 65;28350;14050;14300
09563;      Fürth (Krfr.St);Insgesamt;65 oder älter;23386;9833;13553
09563;      Fürth (Krfr.St);Insgesamt;Insgesamt;127748;62603;65145
09563;      Fürth (Krfr.St);Deutsche;unter 6;6504;3320;3184
09563;      Fürth (Krfr.St);Deutsche;6 bis unter 15;8043;4233;3810
09563;      Fürth (Krfr.St);Deutsche;15 bis unter 18;2725;1443;1282
09563;      Fürth (Krfr.St);Deutsche;18 bis unter 25;7355;3734;3621
09563;      Fürth (Krfr.St);Deutsche;25 bis unter 30;6577;3300;3277
09563;      Fürth (Krfr.St);Deutsche;30 bis unter 40;13825;6847;6978
09563;      Fürth (Krfr.St);Deutsche;40 bis unter 50;12762;6300;6462
09563;      Fürth (Krfr.St);Deutsche;50 bis unter 65;24123;11781;12342
09563;      Fürth (Krfr.St);Deutsche;65 oder älter;21200;8862;12338
09563;      Fürth (Krfr.St);Deutsche;Insgesamt;103114;49820;53294
09563;      Fürth (Krfr.St);Ausländer;unter 6;1228;643;585
09563;      Fürth (Krfr.St);Ausländer;6 bis unter 15;1480;772;708
09563;      Fürth (Krfr.St);Ausländer;15 bis unter 18;633;322;311
09563;      Fürth (Krfr.St);Ausländer;18 bis unter 25;2765;1531;1234
09563;      Fürth (Krfr.St);Ausländer;25 bis unter 30;2440;1376;1064
09563;      Fürth (Krfr.St);Ausländer;30 bis unter 40;5013;2624;2389
09563;      Fürth (Krfr.St);Ausländer;40 bis unter 50;4662;2275;2387
09563;      Fürth (Krfr.St);Ausländer;50 bis unter 65;4227;2269;1958
09563;      Fürth (Krfr.St);Ausländer;65 oder älter;2186;971;1215
09563;      Fürth (Krfr.St);Ausländer;Insgesamt;24634;12783;11851
09564;      Nürnberg (Krfr.St);Insgesamt;unter 6;30410;15649;14761
09564;      Nürnberg (Krfr.St);Insgesamt;6 bis unter 15;39165;20129;19036
09564;      Nürnberg (Krfr.St);Insgesamt;15 bis unter 18;12924;6765;6159
09564;      Nürnberg (Krfr.St);Insgesamt;18 bis unter 25;42685;21607;21078
09564;      Nürnberg (Krfr.St);Insgesamt;25 bis unter 30;41736;21060;20676
09564;      Nürnberg (Krfr.St);Insgesamt;30 bis unter 40;76763;39048;37715
09564;      Nürnberg (Krfr.St);Insgesamt;40 bis unter 50;67110;33438;33672
09564;      Nürnberg (Krfr.St);Insgesamt;50 bis unter 65;103519;51462;52057
09564;      Nürnberg (Krfr.St);Insgesamt;65 oder älter;104053;43649;60404
09564;      Nürnberg (Krfr.St);Insgesamt;Insgesamt;518365;252807;265558
09564;      Nürnberg (Krfr.St);Deutsche;unter 6;24099;12380;11719
09564;      Nürnberg (Krfr.St);Deutsche;6 bis unter 15;31302;16025;15277
09564;      Nürnberg (Krfr.St);Deutsche;15 bis unter 18;10413;5408;5005
09564;      Nürnberg (Krfr.St);Deutsche;18 bis unter 25;30256;14754;15502
09564;      Nürnberg (Krfr.St);Deutsche;25 bis unter 30;29152;14454;14698
09564;      Nürnberg (Krfr.St);Deutsche;30 bis unter 40;52743;26675;26068
09564;      Nürnberg (Krfr.St);Deutsche;40 bis unter 50;46036;23005;23031
09564;      Nürnberg (Krfr.St);Deutsche;50 bis unter 65;84608;41887;42721
09564;      Nürnberg (Krfr.St);Deutsche;65 oder älter;91921;38027;53894
09564;      Nürnberg (Krfr.St);Deutsche;Insgesamt;400530;192615;207915
09564;      Nürnberg (Krfr.St);Ausländer;unter 6;6311;3269;3042
09564;      Nürnberg (Krfr.St);Ausländer;6 bis unter 15;7863;4104;3759
09564;      Nürnberg (Krfr.St);Ausländer;15 bis unter 18;2511;1357;1154
09564;      Nürnberg (Krfr.St);Ausländer;18 bis unter 25;12429;6853;5576
09564;      Nürnberg (Krfr.St);Ausländer;25 bis unter 30;12584;6606;5978
09564;      Nürnberg (Krfr.St);Ausländer;30 bis unter 40;24020;12373;11647
09564;      Nürnberg (Krfr.St);Ausländer;40 bis unter 50;21074;10433;10641
09564;      Nürnberg (Krfr.St);Ausländer;50 bis unter 65;18911;9575;9336
09564;      Nürnberg (Krfr.St);Ausländer;65 oder älter;12132;5622;6510
09564;      Nürnberg (Krfr.St);Ausländer;Insgesamt;117835;60192;57643
09565;      Schwabach (Krfr.St);Insgesamt;unter 6;2387;1209;1178
09565;      Schwabach (Krfr.St);Insgesamt;6 bis unter 15;3363;1721;1642
09565;      Schwabach (Krfr.St);Insgesamt;15 bis unter 18;1163;600;563
09565;      Schwabach (Krfr.St);Insgesamt;18 bis unter 25;2997;1642;1355
09565;      Schwabach (Krfr.St);Insgesamt;25 bis unter 30;2313;1132;1181
09565;      Schwabach (Krfr.St);Insgesamt;30 bis unter 40;4912;2461;2451
09565;      Schwabach (Krfr.St);Insgesamt;40 bis unter 50;5280;2584;2696
09565;      Schwabach (Krfr.St);Insgesamt;50 bis unter 65;9479;4764;4715
09565;      Schwabach (Krfr.St);Insgesamt;65 oder älter;8898;3782;5116
09565;      Schwabach (Krfr.St);Insgesamt;Insgesamt;40792;19895;20897
09565;      Schwabach (Krfr.St);Deutsche;unter 6;2069;1045;1024
09565;      Schwabach (Krfr.St);Deutsche;6 bis unter 15;2974;1524;1450
09565;      Schwabach (Krfr.St);Deutsche;15 bis unter 18;1042;535;507
09565;      Schwabach (Krfr.St);Deutsche;18 bis unter 25;2494;1340;1154
09565;      Schwabach (Krfr.St);Deutsche;25 bis unter 30;1811;877;934
09565;      Schwabach (Krfr.St);Deutsche;30 bis unter 40;3881;1900;1981
09565;      Schwabach (Krfr.St);Deutsche;40 bis unter 50;4324;2096;2228
09565;      Schwabach (Krfr.St);Deutsche;50 bis unter 65;8608;4294;4314
09565;      Schwabach (Krfr.St);Deutsche;65 oder älter;8489;3583;4906
09565;      Schwabach (Krfr.St);Deutsche;Insgesamt;35692;17194;18498
09565;      Schwabach (Krfr.St);Ausländer;unter 6;318;164;154
09565;      Schwabach (Krfr.St);Ausländer;6 bis unter 15;389;197;192
09565;      Schwabach (Krfr.St);Ausländer;15 bis unter 18;121;65;56
09565;      Schwabach (Krfr.St);Ausländer;18 bis unter 25;503;302;201
09565;      Schwabach (Krfr.St);Ausländer;25 bis unter 30;502;255;247
09565;      Schwabach (Krfr.St);Ausländer;30 bis unter 40;1031;561;470
09565;      Schwabach (Krfr.St);Ausländer;40 bis unter 50;956;488;468
09565;      Schwabach (Krfr.St);Ausländer;50 bis unter 65;871;470;401
09565;      Schwabach (Krfr.St);Ausländer;65 oder älter;409;199;210
09565;      Schwabach (Krfr.St);Ausländer;Insgesamt;5100;2701;2399
KS095;    Kreisfreie Städte Mittelfranken;Insgesamt;unter 6;49500;25379;24121
KS095;    Kreisfreie Städte Mittelfranken;Insgesamt;6 bis unter 15;63711;32879;30832
KS095;    Kreisfreie Städte Mittelfranken;Insgesamt;15 bis unter 18;21382;11179;10203
KS095;    Kreisfreie Städte Mittelfranken;Insgesamt;18 bis unter 25;71098;36250;34848
KS095;    Kreisfreie Städte Mittelfranken;Insgesamt;25 bis unter 30;67296;34430;32866
KS095;    Kreisfreie Städte Mittelfranken;Insgesamt;30 bis unter 40;122755;62653;60102
KS095;    Kreisfreie Städte Mittelfranken;Insgesamt;40 bis unter 50;107986;53636;54350
KS095;    Kreisfreie Städte Mittelfranken;Insgesamt;50 bis unter 65;171979;85375;86604
KS095;    Kreisfreie Städte Mittelfranken;Insgesamt;65 oder älter;165007;69436;95571
KS095;    Kreisfreie Städte Mittelfranken;Insgesamt;Insgesamt;840714;411217;429497
KS095;    Kreisfreie Städte Mittelfranken;Deutsche;unter 6;39880;20391;19489
KS095;    Kreisfreie Städte Mittelfranken;Deutsche;6 bis unter 15;52077;26765;25312
KS095;    Kreisfreie Städte Mittelfranken;Deutsche;15 bis unter 18;17611;9157;8454
KS095;    Kreisfreie Städte Mittelfranken;Deutsche;18 bis unter 25;51865;25635;26230
KS095;    Kreisfreie Städte Mittelfranken;Deutsche;25 bis unter 30;47892;24027;23865
KS095;    Kreisfreie Städte Mittelfranken;Deutsche;30 bis unter 40;87193;44299;42894
KS095;    Kreisfreie Städte Mittelfranken;Deutsche;40 bis unter 50;77296;38512;38784
KS095;    Kreisfreie Städte Mittelfranken;Deutsche;50 bis unter 65;144650;71369;73281
KS095;    Kreisfreie Städte Mittelfranken;Deutsche;65 oder älter;148450;61773;86677
KS095;    Kreisfreie Städte Mittelfranken;Deutsche;Insgesamt;666914;321928;344986
KS095;    Kreisfreie Städte Mittelfranken;Ausländer;unter 6;9620;4988;4632
KS095;    Kreisfreie Städte Mittelfranken;Ausländer;6 bis unter 15;11634;6114;5520
KS095;    Kreisfreie Städte Mittelfranken;Ausländer;15 bis unter 18;3771;2022;1749
KS095;    Kreisfreie Städte Mittelfranken;Ausländer;18 bis unter 25;19233;10615;8618
KS095;    Kreisfreie Städte Mittelfranken;Ausländer;25 bis unter 30;19404;10403;9001
KS095;    Kreisfreie Städte Mittelfranken;Ausländer;30 bis unter 40;35562;18354;17208
KS095;    Kreisfreie Städte Mittelfranken;Ausländer;40 bis unter 50;30690;15124;15566
KS095;    Kreisfreie Städte Mittelfranken;Ausländer;50 bis unter 65;27329;14006;13323
KS095;    Kreisfreie Städte Mittelfranken;Ausländer;65 oder älter;16557;7663;8894
KS095;    Kreisfreie Städte Mittelfranken;Ausländer;Insgesamt;173800;89289;84511
09571;      Ansbach (Lkr);Insgesamt;unter 6;10454;5363;5091
09571;      Ansbach (Lkr);Insgesamt;6 bis unter 15;15253;7891;7362
09571;      Ansbach (Lkr);Insgesamt;15 bis unter 18;5584;2924;2660
09571;      Ansbach (Lkr);Insgesamt;18 bis unter 25;14783;7981;6802
09571;      Ansbach (Lkr);Insgesamt;25 bis unter 30;10932;5814;5118
09571;      Ansbach (Lkr);Insgesamt;30 bis unter 40;22286;11509;10777
09571;      Ansbach (Lkr);Insgesamt;40 bis unter 50;23622;11948;11674
09571;      Ansbach (Lkr);Insgesamt;50 bis unter 65;44186;22386;21800
09571;      Ansbach (Lkr);Insgesamt;65 oder älter;36849;16634;20215
09571;      Ansbach (Lkr);Insgesamt;Insgesamt;183949;92450;91499
09571;      Ansbach (Lkr);Deutsche;unter 6;9512;4888;4624
09571;      Ansbach (Lkr);Deutsche;6 bis unter 15;13931;7187;6744
09571;      Ansbach (Lkr);Deutsche;15 bis unter 18;5185;2698;2487
09571;      Ansbach (Lkr);Deutsche;18 bis unter 25;12969;6866;6103
09571;      Ansbach (Lkr);Deutsche;25 bis unter 30;9300;4850;4450
09571;      Ansbach (Lkr);Deutsche;30 bis unter 40;19082;9652;9430
09571;      Ansbach (Lkr);Deutsche;40 bis unter 50;20517;10208;10309
09571;      Ansbach (Lkr);Deutsche;50 bis unter 65;41773;20990;20783
09571;      Ansbach (Lkr);Deutsche;65 oder älter;36018;16236;19782
09571;      Ansbach (Lkr);Deutsche;Insgesamt;168287;83575;84712
09571;      Ansbach (Lkr);Ausländer;unter 6;942;475;467
09571;      Ansbach (Lkr);Ausländer;6 bis unter 15;1322;704;618
09571;      Ansbach (Lkr);Ausländer;15 bis unter 18;399;226;173
09571;      Ansbach (Lkr);Ausländer;18 bis unter 25;1814;1115;699
09571;      Ansbach (Lkr);Ausländer;25 bis unter 30;1632;964;668
09571;      Ansbach (Lkr);Ausländer;30 bis unter 40;3204;1857;1347
09571;      Ansbach (Lkr);Ausländer;40 bis unter 50;3105;1740;1365
09571;      Ansbach (Lkr);Ausländer;50 bis unter 65;2413;1396;1017
09571;      Ansbach (Lkr);Ausländer;65 oder älter;831;398;433
09571;      Ansbach (Lkr);Ausländer;Insgesamt;15662;8875;6787
09572;      Erlangen-Höchstadt (Lkr);Insgesamt;unter 6;8252;4262;3990
09572;      Erlangen-Höchstadt (Lkr);Insgesamt;6 bis unter 15;11731;6048;5683
09572;      Erlangen-Höchstadt (Lkr);Insgesamt;15 bis unter 18;4032;2043;1989
09572;      Erlangen-Höchstadt (Lkr);Insgesamt;18 bis unter 25;9697;5156;4541
09572;      Erlangen-Höchstadt (Lkr);Insgesamt;25 bis unter 30;7045;3685;3360
09572;      Erlangen-Höchstadt (Lkr);Insgesamt;30 bis unter 40;17100;8480;8620
09572;      Erlangen-Höchstadt (Lkr);Insgesamt;40 bis unter 50;18013;8978;9035
09572;      Erlangen-Höchstadt (Lkr);Insgesamt;50 bis unter 65;32615;16244;16371
09572;      Erlangen-Höchstadt (Lkr);Insgesamt;65 oder älter;27786;12867;14919
09572;      Erlangen-Höchstadt (Lkr);Insgesamt;Insgesamt;136271;67763;68508
09572;      Erlangen-Höchstadt (Lkr);Deutsche;unter 6;7442;3826;3616
09572;      Erlangen-Höchstadt (Lkr);Deutsche;6 bis unter 15;10763;5562;5201
09572;      Erlangen-Höchstadt (Lkr);Deutsche;15 bis unter 18;3787;1926;1861
09572;      Erlangen-Höchstadt (Lkr);Deutsche;18 bis unter 25;8644;4515;4129
09572;      Erlangen-Höchstadt (Lkr);Deutsche;25 bis unter 30;6034;3118;2916
09572;      Erlangen-Höchstadt (Lkr);Deutsche;30 bis unter 40;14384;7087;7297
09572;      Erlangen-Höchstadt (Lkr);Deutsche;40 bis unter 50;15632;7817;7815
09572;      Erlangen-Höchstadt (Lkr);Deutsche;50 bis unter 65;30861;15291;15570
09572;      Erlangen-Höchstadt (Lkr);Deutsche;65 oder älter;26767;12336;14431
09572;      Erlangen-Höchstadt (Lkr);Deutsche;Insgesamt;124314;61478;62836
09572;      Erlangen-Höchstadt (Lkr);Ausländer;unter 6;810;436;374
09572;      Erlangen-Höchstadt (Lkr);Ausländer;6 bis unter 15;968;486;482
09572;      Erlangen-Höchstadt (Lkr);Ausländer;15 bis unter 18;245;117;128
09572;      Erlangen-Höchstadt (Lkr);Ausländer;18 bis unter 25;1053;641;412
09572;      Erlangen-Höchstadt (Lkr);Ausländer;25 bis unter 30;1011;567;444
09572;      Erlangen-Höchstadt (Lkr);Ausländer;30 bis unter 40;2716;1393;1323
09572;      Erlangen-Höchstadt (Lkr);Ausländer;40 bis unter 50;2381;1161;1220
09572;      Erlangen-Höchstadt (Lkr);Ausländer;50 bis unter 65;1754;953;801
09572;      Erlangen-Höchstadt (Lkr);Ausländer;65 oder älter;1019;531;488
09572;      Erlangen-Höchstadt (Lkr);Ausländer;Insgesamt;11957;6285;5672
09573;      Fürth (Lkr);Insgesamt;unter 6;6779;3455;3324
09573;      Fürth (Lkr);Insgesamt;6 bis unter 15;9261;4716;4545
09573;      Fürth (Lkr);Insgesamt;15 bis unter 18;3166;1594;1572
09573;      Fürth (Lkr);Insgesamt;18 bis unter 25;8009;4203;3806
09573;      Fürth (Lkr);Insgesamt;25 bis unter 30;5880;3001;2879
09573;      Fürth (Lkr);Insgesamt;30 bis unter 40;13836;6717;7119
09573;      Fürth (Lkr);Insgesamt;40 bis unter 50;15245;7490;7755
09573;      Fürth (Lkr);Insgesamt;50 bis unter 65;28431;14048;14383
09573;      Fürth (Lkr);Insgesamt;65 oder älter;26780;11840;14940
09573;      Fürth (Lkr);Insgesamt;Insgesamt;117387;57064;60323
09573;      Fürth (Lkr);Deutsche;unter 6;6304;3177;3127
09573;      Fürth (Lkr);Deutsche;6 bis unter 15;8811;4493;4318
09573;      Fürth (Lkr);Deutsche;15 bis unter 18;3048;1534;1514
09573;      Fürth (Lkr);Deutsche;18 bis unter 25;7251;3771;3480
09573;      Fürth (Lkr);Deutsche;25 bis unter 30;5113;2566;2547
09573;      Fürth (Lkr);Deutsche;30 bis unter 40;12201;5875;6326
09573;      Fürth (Lkr);Deutsche;40 bis unter 50;13437;6567;6870
09573;      Fürth (Lkr);Deutsche;50 bis unter 65;26828;13224;13604
09573;      Fürth (Lkr);Deutsche;65 oder älter;25900;11423;14477
09573;      Fürth (Lkr);Deutsche;Insgesamt;108893;52630;56263
09573;      Fürth (Lkr);Ausländer;unter 6;475;278;197
09573;      Fürth (Lkr);Ausländer;6 bis unter 15;450;223;227
09573;      Fürth (Lkr);Ausländer;15 bis unter 18;118;60;58
09573;      Fürth (Lkr);Ausländer;18 bis unter 25;758;432;326
09573;      Fürth (Lkr);Ausländer;25 bis unter 30;767;435;332
09573;      Fürth (Lkr);Ausländer;30 bis unter 40;1635;842;793
09573;      Fürth (Lkr);Ausländer;40 bis unter 50;1808;923;885
09573;      Fürth (Lkr);Ausländer;50 bis unter 65;1603;824;779
09573;      Fürth (Lkr);Ausländer;65 oder älter;880;417;463
09573;      Fürth (Lkr);Ausländer;Insgesamt;8494;4434;4060
09574;      Nürnberger Land (Lkr);Insgesamt;unter 6;9458;4809;4649
09574;      Nürnberger Land (Lkr);Insgesamt;6 bis unter 15;13544;7113;6431
09574;      Nürnberger Land (Lkr);Insgesamt;15 bis unter 18;4888;2539;2349
09574;      Nürnberger Land (Lkr);Insgesamt;18 bis unter 25;12101;6484;5617
09574;      Nürnberger Land (Lkr);Insgesamt;25 bis unter 30;8852;4606;4246
09574;      Nürnberger Land (Lkr);Insgesamt;30 bis unter 40;20254;9998;10256
09574;      Nürnberger Land (Lkr);Insgesamt;40 bis unter 50;22193;11024;11169
09574;      Nürnberger Land (Lkr);Insgesamt;50 bis unter 65;41160;20532;20628
09574;      Nürnberger Land (Lkr);Insgesamt;65 oder älter;37915;16841;21074
09574;      Nürnberger Land (Lkr);Insgesamt;Insgesamt;170365;83946;86419
09574;      Nürnberger Land (Lkr);Deutsche;unter 6;8644;4374;4270
09574;      Nürnberger Land (Lkr);Deutsche;6 bis unter 15;12540;6588;5952
09574;      Nürnberger Land (Lkr);Deutsche;15 bis unter 18;4532;2334;2198
09574;      Nürnberger Land (Lkr);Deutsche;18 bis unter 25;10521;5564;4957
09574;      Nürnberger Land (Lkr);Deutsche;25 bis unter 30;7525;3858;3667
09574;      Nürnberger Land (Lkr);Deutsche;30 bis unter 40;17236;8421;8815
09574;      Nürnberger Land (Lkr);Deutsche;40 bis unter 50;19204;9514;9690
09574;      Nürnberger Land (Lkr);Deutsche;50 bis unter 65;38539;19152;19387
09574;      Nürnberger Land (Lkr);Deutsche;65 oder älter;36343;16113;20230
09574;      Nürnberger Land (Lkr);Deutsche;Insgesamt;155084;75918;79166
09574;      Nürnberger Land (Lkr);Ausländer;unter 6;814;435;379
09574;      Nürnberger Land (Lkr);Ausländer;6 bis unter 15;1004;525;479
09574;      Nürnberger Land (Lkr);Ausländer;15 bis unter 18;356;205;151
09574;      Nürnberger Land (Lkr);Ausländer;18 bis unter 25;1580;920;660
09574;      Nürnberger Land (Lkr);Ausländer;25 bis unter 30;1327;748;579
09574;      Nürnberger Land (Lkr);Ausländer;30 bis unter 40;3018;1577;1441
09574;      Nürnberger Land (Lkr);Ausländer;40 bis unter 50;2989;1510;1479
09574;      Nürnberger Land (Lkr);Ausländer;50 bis unter 65;2621;1380;1241
09574;      Nürnberger Land (Lkr);Ausländer;65 oder älter;1572;728;844
09574;      Nürnberger Land (Lkr);Ausländer;Insgesamt;15281;8028;7253
09575;      Neustadt a.d.Aisch-Bad Windsheim (Lkr);Insgesamt;unter 6;5632;2887;2745
09575;      Neustadt a.d.Aisch-Bad Windsheim (Lkr);Insgesamt;6 bis unter 15;8035;4153;3882
09575;      Neustadt a.d.Aisch-Bad Windsheim (Lkr);Insgesamt;15 bis unter 18;3087;1656;1431
09575;      Neustadt a.d.Aisch-Bad Windsheim (Lkr);Insgesamt;18 bis unter 25;7729;4169;3560
09575;      Neustadt a.d.Aisch-Bad Windsheim (Lkr);Insgesamt;25 bis unter 30;5695;3002;2693
09575;      Neustadt a.d.Aisch-Bad Windsheim (Lkr);Insgesamt;30 bis unter 40;12113;6266;5847
09575;      Neustadt a.d.Aisch-Bad Windsheim (Lkr);Insgesamt;40 bis unter 50;12602;6336;6266
09575;      Neustadt a.d.Aisch-Bad Windsheim (Lkr);Insgesamt;50 bis unter 65;24554;12346;12208
09575;      Neustadt a.d.Aisch-Bad Windsheim (Lkr);Insgesamt;65 oder älter;20917;9516;11401
09575;      Neustadt a.d.Aisch-Bad Windsheim (Lkr);Insgesamt;Insgesamt;100364;50331;50033
09575;      Neustadt a.d.Aisch-Bad Windsheim (Lkr);Deutsche;unter 6;4968;2532;2436
09575;      Neustadt a.d.Aisch-Bad Windsheim (Lkr);Deutsche;6 bis unter 15;7376;3803;3573
09575;      Neustadt a.d.Aisch-Bad Windsheim (Lkr);Deutsche;15 bis unter 18;2891;1538;1353
09575;      Neustadt a.d.Aisch-Bad Windsheim (Lkr);Deutsche;18 bis unter 25;6794;3578;3216
09575;      Neustadt a.d.Aisch-Bad Windsheim (Lkr);Deutsche;25 bis unter 30;4847;2540;2307
09575;      Neustadt a.d.Aisch-Bad Windsheim (Lkr);Deutsche;30 bis unter 40;10467;5334;5133
09575;      Neustadt a.d.Aisch-Bad Windsheim (Lkr);Deutsche;40 bis unter 50;11066;5454;5612
09575;      Neustadt a.d.Aisch-Bad Windsheim (Lkr);Deutsche;50 bis unter 65;23312;11646;11666
09575;      Neustadt a.d.Aisch-Bad Windsheim (Lkr);Deutsche;65 oder älter;20446;9273;11173
09575;      Neustadt a.d.Aisch-Bad Windsheim (Lkr);Deutsche;Insgesamt;92167;45698;46469
09575;      Neustadt a.d.Aisch-Bad Windsheim (Lkr);Ausländer;unter 6;664;355;309
09575;      Neustadt a.d.Aisch-Bad Windsheim (Lkr);Ausländer;6 bis unter 15;659;350;309
09575;      Neustadt a.d.Aisch-Bad Windsheim (Lkr);Ausländer;15 bis unter 18;196;118;78
09575;      Neustadt a.d.Aisch-Bad Windsheim (Lkr);Ausländer;18 bis unter 25;935;591;344
09575;      Neustadt a.d.Aisch-Bad Windsheim (Lkr);Ausländer;25 bis unter 30;848;462;386
09575;      Neustadt a.d.Aisch-Bad Windsheim (Lkr);Ausländer;30 bis unter 40;1646;932;714
09575;      Neustadt a.d.Aisch-Bad Windsheim (Lkr);Ausländer;40 bis unter 50;1536;882;654
09575;      Neustadt a.d.Aisch-Bad Windsheim (Lkr);Ausländer;50 bis unter 65;1242;700;542
09575;      Neustadt a.d.Aisch-Bad Windsheim (Lkr);Ausländer;65 oder älter;471;243;228
09575;      Neustadt a.d.Aisch-Bad Windsheim (Lkr);Ausländer;Insgesamt;8197;4633;3564
09576;      Roth (Lkr);Insgesamt;unter 6;7282;3802;3480
09576;      Roth (Lkr);Insgesamt;6 bis unter 15;10129;5187;4942
09576;      Roth (Lkr);Insgesamt;15 bis unter 18;3868;2001;1867
09576;      Roth (Lkr);Insgesamt;18 bis unter 25;9694;5149;4545
09576;      Roth (Lkr);Insgesamt;25 bis unter 30;6989;3708;3281
09576;      Roth (Lkr);Insgesamt;30 bis unter 40;15046;7616;7430
09576;      Roth (Lkr);Insgesamt;40 bis unter 50;16480;8204;8276
09576;      Roth (Lkr);Insgesamt;50 bis unter 65;31082;15677;15405
09576;      Roth (Lkr);Insgesamt;65 oder älter;26388;11862;14526
09576;      Roth (Lkr);Insgesamt;Insgesamt;126958;63206;63752
09576;      Roth (Lkr);Deutsche;unter 6;6699;3478;3221
09576;      Roth (Lkr);Deutsche;6 bis unter 15;9494;4872;4622
09576;      Roth (Lkr);Deutsche;15 bis unter 18;3673;1894;1779
09576;      Roth (Lkr);Deutsche;18 bis unter 25;8684;4548;4136
09576;      Roth (Lkr);Deutsche;25 bis unter 30;6049;3150;2899
09576;      Roth (Lkr);Deutsche;30 bis unter 40;13140;6521;6619
09576;      Roth (Lkr);Deutsche;40 bis unter 50;14609;7190;7419
09576;      Roth (Lkr);Deutsche;50 bis unter 65;29628;14877;14751
09576;      Roth (Lkr);Deutsche;65 oder älter;25738;11511;14227
09576;      Roth (Lkr);Deutsche;Insgesamt;117714;58041;59673
09576;      Roth (Lkr);Ausländer;unter 6;583;324;259
09576;      Roth (Lkr);Ausländer;6 bis unter 15;635;315;320
09576;      Roth (Lkr);Ausländer;15 bis unter 18;195;107;88
09576;      Roth (Lkr);Ausländer;18 bis unter 25;1010;601;409
09576;      Roth (Lkr);Ausländer;25 bis unter 30;940;558;382
09576;      Roth (Lkr);Ausländer;30 bis unter 40;1906;1095;811
09576;      Roth (Lkr);Ausländer;40 bis unter 50;1871;1014;857
09576;      Roth (Lkr);Ausländer;50 bis unter 65;1454;800;654
09576;      Roth (Lkr);Ausländer;65 oder älter;650;351;299
09576;      Roth (Lkr);Ausländer;Insgesamt;9244;5165;4079
09577;      Weißenburg-Gunzenhausen (Lkr);Insgesamt;unter 6;5258;2650;2608
09577;      Weißenburg-Gunzenhausen (Lkr);Insgesamt;6 bis unter 15;7579;3961;3618
09577;      Weißenburg-Gunzenhausen (Lkr);Insgesamt;15 bis unter 18;2952;1489;1463
09577;      Weißenburg-Gunzenhausen (Lkr);Insgesamt;18 bis unter 25;7111;3832;3279
09577;      Weißenburg-Gunzenhausen (Lkr);Insgesamt;25 bis unter 30;5406;2850;2556
09577;      Weißenburg-Gunzenhausen (Lkr);Insgesamt;30 bis unter 40;11166;5721;5445
09577;      Weißenburg-Gunzenhausen (Lkr);Insgesamt;40 bis unter 50;11589;5956;5633
09577;      Weißenburg-Gunzenhausen (Lkr);Insgesamt;50 bis unter 65;22795;11561;11234
09577;      Weißenburg-Gunzenhausen (Lkr);Insgesamt;65 oder älter;20537;9073;11464
09577;      Weißenburg-Gunzenhausen (Lkr);Insgesamt;Insgesamt;94393;47093;47300
09577;      Weißenburg-Gunzenhausen (Lkr);Deutsche;unter 6;4659;2370;2289
09577;      Weißenburg-Gunzenhausen (Lkr);Deutsche;6 bis unter 15;6733;3492;3241
09577;      Weißenburg-Gunzenhausen (Lkr);Deutsche;15 bis unter 18;2735;1365;1370
09577;      Weißenburg-Gunzenhausen (Lkr);Deutsche;18 bis unter 25;6234;3314;2920
09577;      Weißenburg-Gunzenhausen (Lkr);Deutsche;25 bis unter 30;4545;2364;2181
09577;      Weißenburg-Gunzenhausen (Lkr);Deutsche;30 bis unter 40;9335;4730;4605
09577;      Weißenburg-Gunzenhausen (Lkr);Deutsche;40 bis unter 50;9913;5050;4863
09577;      Weißenburg-Gunzenhausen (Lkr);Deutsche;50 bis unter 65;21542;10864;10678
09577;      Weißenburg-Gunzenhausen (Lkr);Deutsche;65 oder älter;19938;8775;11163
09577;      Weißenburg-Gunzenhausen (Lkr);Deutsche;Insgesamt;85634;42324;43310
09577;      Weißenburg-Gunzenhausen (Lkr);Ausländer;unter 6;599;280;319
09577;      Weißenburg-Gunzenhausen (Lkr);Ausländer;6 bis unter 15;846;469;377
09577;      Weißenburg-Gunzenhausen (Lkr);Ausländer;15 bis unter 18;217;124;93
09577;      Weißenburg-Gunzenhausen (Lkr);Ausländer;18 bis unter 25;877;518;359
09577;      Weißenburg-Gunzenhausen (Lkr);Ausländer;25 bis unter 30;861;486;375
09577;      Weißenburg-Gunzenhausen (Lkr);Ausländer;30 bis unter 40;1831;991;840
09577;      Weißenburg-Gunzenhausen (Lkr);Ausländer;40 bis unter 50;1676;906;770
09577;      Weißenburg-Gunzenhausen (Lkr);Ausländer;50 bis unter 65;1253;697;556
09577;      Weißenburg-Gunzenhausen (Lkr);Ausländer;65 oder älter;599;298;301
09577;      Weißenburg-Gunzenhausen (Lkr);Ausländer;Insgesamt;8759;4769;3990
LK095;    Landkreise Mittelfranken;Insgesamt;unter 6;53115;27228;25887
LK095;    Landkreise Mittelfranken;Insgesamt;6 bis unter 15;75532;39069;36463
LK095;    Landkreise Mittelfranken;Insgesamt;15 bis unter 18;27577;14246;13331
LK095;    Landkreise Mittelfranken;Insgesamt;18 bis unter 25;69124;36974;32150
LK095;    Landkreise Mittelfranken;Insgesamt;25 bis unter 30;50799;26666;24133
LK095;    Landkreise Mittelfranken;Insgesamt;30 bis unter 40;111801;56307;55494
LK095;    Landkreise Mittelfranken;Insgesamt;40 bis unter 50;119744;59936;59808
LK095;    Landkreise Mittelfranken;Insgesamt;50 bis unter 65;224823;112794;112029
LK095;    Landkreise Mittelfranken;Insgesamt;65 oder älter;197172;88633;108539
LK095;    Landkreise Mittelfranken;Insgesamt;Insgesamt;929687;461853;467834
LK095;    Landkreise Mittelfranken;Deutsche;unter 6;48228;24645;23583
LK095;    Landkreise Mittelfranken;Deutsche;6 bis unter 15;69648;35997;33651
LK095;    Landkreise Mittelfranken;Deutsche;15 bis unter 18;25851;13289;12562
LK095;    Landkreise Mittelfranken;Deutsche;18 bis unter 25;61097;32156;28941
LK095;    Landkreise Mittelfranken;Deutsche;25 bis unter 30;43413;22446;20967
LK095;    Landkreise Mittelfranken;Deutsche;30 bis unter 40;95845;47620;48225
LK095;    Landkreise Mittelfranken;Deutsche;40 bis unter 50;104378;51800;52578
LK095;    Landkreise Mittelfranken;Deutsche;50 bis unter 65;212483;106044;106439
LK095;    Landkreise Mittelfranken;Deutsche;65 oder älter;191150;85667;105483
LK095;    Landkreise Mittelfranken;Deutsche;Insgesamt;852093;419664;432429
LK095;    Landkreise Mittelfranken;Ausländer;unter 6;4887;2583;2304
LK095;    Landkreise Mittelfranken;Ausländer;6 bis unter 15;5884;3072;2812
LK095;    Landkreise Mittelfranken;Ausländer;15 bis unter 18;1726;957;769
LK095;    Landkreise Mittelfranken;Ausländer;18 bis unter 25;8027;4818;3209
LK095;    Landkreise Mittelfranken;Ausländer;25 bis unter 30;7386;4220;3166
LK095;    Landkreise Mittelfranken;Ausländer;30 bis unter 40;15956;8687;7269
LK095;    Landkreise Mittelfranken;Ausländer;40 bis unter 50;15366;8136;7230
LK095;    Landkreise Mittelfranken;Ausländer;50 bis unter 65;12340;6750;5590
LK095;    Landkreise Mittelfranken;Ausländer;65 oder älter;6022;2966;3056
LK095;    Landkreise Mittelfranken;Ausländer;Insgesamt;77594;42189;35405
095;  Mittelfranken;Insgesamt;unter 6;102615;52607;50008
095;  Mittelfranken;Insgesamt;6 bis unter 15;139243;71948;67295
095;  Mittelfranken;Insgesamt;15 bis unter 18;48959;25425;23534
095;  Mittelfranken;Insgesamt;18 bis unter 25;140222;73224;66998
095;  Mittelfranken;Insgesamt;25 bis unter 30;118095;61096;56999
095;  Mittelfranken;Insgesamt;30 bis unter 40;234556;118960;115596
095;  Mittelfranken;Insgesamt;40 bis unter 50;227730;113572;114158
095;  Mittelfranken;Insgesamt;50 bis unter 65;396802;198169;198633
095;  Mittelfranken;Insgesamt;65 oder älter;362179;158069;204110
095;  Mittelfranken;Insgesamt;Insgesamt;1770401;873070;897331
095;  Mittelfranken;Deutsche;unter 6;88108;45036;43072
095;  Mittelfranken;Deutsche;6 bis unter 15;121725;62762;58963
095;  Mittelfranken;Deutsche;15 bis unter 18;43462;22446;21016
095;  Mittelfranken;Deutsche;18 bis unter 25;112962;57791;55171
095;  Mittelfranken;Deutsche;25 bis unter 30;91305;46473;44832
095;  Mittelfranken;Deutsche;30 bis unter 40;183038;91919;91119
095;  Mittelfranken;Deutsche;40 bis unter 50;181674;90312;91362
095;  Mittelfranken;Deutsche;50 bis unter 65;357133;177413;179720
095;  Mittelfranken;Deutsche;65 oder älter;339600;147440;192160
095;  Mittelfranken;Deutsche;Insgesamt;1519007;741592;777415
095;  Mittelfranken;Ausländer;unter 6;14507;7571;6936
095;  Mittelfranken;Ausländer;6 bis unter 15;17518;9186;8332
095;  Mittelfranken;Ausländer;15 bis unter 18;5497;2979;2518
095;  Mittelfranken;Ausländer;18 bis unter 25;27260;15433;11827
095;  Mittelfranken;Ausländer;25 bis unter 30;26790;14623;12167
095;  Mittelfranken;Ausländer;30 bis unter 40;51518;27041;24477
095;  Mittelfranken;Ausländer;40 bis unter 50;46056;23260;22796
095;  Mittelfranken;Ausländer;50 bis unter 65;39669;20756;18913
095;  Mittelfranken;Ausländer;65 oder älter;22579;10629;11950
095;  Mittelfranken;Ausländer;Insgesamt;251394;131478;119916
09661;      Aschaffenburg (Krfr.St);Insgesamt;unter 6;3905;2004;1901
09661;      Aschaffenburg (Krfr.St);Insgesamt;6 bis unter 15;5430;2778;2652
09661;      Aschaffenburg (Krfr.St);Insgesamt;15 bis unter 18;1851;945;906
09661;      Aschaffenburg (Krfr.St);Insgesamt;18 bis unter 25;5347;2814;2533
09661;      Aschaffenburg (Krfr.St);Insgesamt;25 bis unter 30;4939;2556;2383
09661;      Aschaffenburg (Krfr.St);Insgesamt;30 bis unter 40;9767;4904;4863
09661;      Aschaffenburg (Krfr.St);Insgesamt;40 bis unter 50;8932;4444;4488
09661;      Aschaffenburg (Krfr.St);Insgesamt;50 bis unter 65;15684;7683;8001
09661;      Aschaffenburg (Krfr.St);Insgesamt;65 oder älter;14672;6188;8484
09661;      Aschaffenburg (Krfr.St);Insgesamt;Insgesamt;70527;34316;36211
09661;      Aschaffenburg (Krfr.St);Deutsche;unter 6;3222;1637;1585
09661;      Aschaffenburg (Krfr.St);Deutsche;6 bis unter 15;4613;2361;2252
09661;      Aschaffenburg (Krfr.St);Deutsche;15 bis unter 18;1577;787;790
09661;      Aschaffenburg (Krfr.St);Deutsche;18 bis unter 25;3986;1998;1988
09661;      Aschaffenburg (Krfr.St);Deutsche;25 bis unter 30;3677;1843;1834
09661;      Aschaffenburg (Krfr.St);Deutsche;30 bis unter 40;7403;3674;3729
09661;      Aschaffenburg (Krfr.St);Deutsche;40 bis unter 50;6837;3418;3419
09661;      Aschaffenburg (Krfr.St);Deutsche;50 bis unter 65;13688;6674;7014
09661;      Aschaffenburg (Krfr.St);Deutsche;65 oder älter;13712;5713;7999
09661;      Aschaffenburg (Krfr.St);Deutsche;Insgesamt;58715;28105;30610
09661;      Aschaffenburg (Krfr.St);Ausländer;unter 6;683;367;316
09661;      Aschaffenburg (Krfr.St);Ausländer;6 bis unter 15;817;417;400
09661;      Aschaffenburg (Krfr.St);Ausländer;15 bis unter 18;274;158;116
09661;      Aschaffenburg (Krfr.St);Ausländer;18 bis unter 25;1361;816;545
09661;      Aschaffenburg (Krfr.St);Ausländer;25 bis unter 30;1262;713;549
09661;      Aschaffenburg (Krfr.St);Ausländer;30 bis unter 40;2364;1230;1134
09661;      Aschaffenburg (Krfr.St);Ausländer;40 bis unter 50;2095;1026;1069
09661;      Aschaffenburg (Krfr.St);Ausländer;50 bis unter 65;1996;1009;987
09661;      Aschaffenburg (Krfr.St);Ausländer;65 oder älter;960;475;485
09661;      Aschaffenburg (Krfr.St);Ausländer;Insgesamt;11812;6211;5601
09662;      Schweinfurt (Krfr.St);Insgesamt;unter 6;3163;1637;1526
09662;      Schweinfurt (Krfr.St);Insgesamt;6 bis unter 15;4208;2160;2048
09662;      Schweinfurt (Krfr.St);Insgesamt;15 bis unter 18;1377;725;652
09662;      Schweinfurt (Krfr.St);Insgesamt;18 bis unter 25;4751;2608;2143
09662;      Schweinfurt (Krfr.St);Insgesamt;25 bis unter 30;3789;2073;1716
09662;      Schweinfurt (Krfr.St);Insgesamt;30 bis unter 40;6857;3670;3187
09662;      Schweinfurt (Krfr.St);Insgesamt;40 bis unter 50;5991;2936;3055
09662;      Schweinfurt (Krfr.St);Insgesamt;50 bis unter 65;11219;5499;5720
09662;      Schweinfurt (Krfr.St);Insgesamt;65 oder älter;12677;5245;7432
09662;      Schweinfurt (Krfr.St);Insgesamt;Insgesamt;54032;26553;27479
09662;      Schweinfurt (Krfr.St);Deutsche;unter 6;2349;1232;1117
09662;      Schweinfurt (Krfr.St);Deutsche;6 bis unter 15;3368;1737;1631
09662;      Schweinfurt (Krfr.St);Deutsche;15 bis unter 18;1142;594;548
09662;      Schweinfurt (Krfr.St);Deutsche;18 bis unter 25;3006;1494;1512
09662;      Schweinfurt (Krfr.St);Deutsche;25 bis unter 30;2677;1419;1258
09662;      Schweinfurt (Krfr.St);Deutsche;30 bis unter 40;4897;2615;2282
09662;      Schweinfurt (Krfr.St);Deutsche;40 bis unter 50;4329;2104;2225
09662;      Schweinfurt (Krfr.St);Deutsche;50 bis unter 65;9847;4763;5084
09662;      Schweinfurt (Krfr.St);Deutsche;65 oder älter;11943;4855;7088
09662;      Schweinfurt (Krfr.St);Deutsche;Insgesamt;43558;20813;22745
09662;      Schweinfurt (Krfr.St);Ausländer;unter 6;814;405;409
09662;      Schweinfurt (Krfr.St);Ausländer;6 bis unter 15;840;423;417
09662;      Schweinfurt (Krfr.St);Ausländer;15 bis unter 18;235;131;104
09662;      Schweinfurt (Krfr.St);Ausländer;18 bis unter 25;1745;1114;631
09662;      Schweinfurt (Krfr.St);Ausländer;25 bis unter 30;1112;654;458
09662;      Schweinfurt (Krfr.St);Ausländer;30 bis unter 40;1960;1055;905
09662;      Schweinfurt (Krfr.St);Ausländer;40 bis unter 50;1662;832;830
09662;      Schweinfurt (Krfr.St);Ausländer;50 bis unter 65;1372;736;636
09662;      Schweinfurt (Krfr.St);Ausländer;65 oder älter;734;390;344
09662;      Schweinfurt (Krfr.St);Ausländer;Insgesamt;10474;5740;4734
09663;      Würzburg (Krfr.St);Insgesamt;unter 6;6320;3173;3147
09663;      Würzburg (Krfr.St);Insgesamt;6 bis unter 15;7232;3698;3534
09663;      Würzburg (Krfr.St);Insgesamt;15 bis unter 18;2453;1262;1191
09663;      Würzburg (Krfr.St);Insgesamt;18 bis unter 25;16237;7069;9168
09663;      Würzburg (Krfr.St);Insgesamt;25 bis unter 30;14272;7143;7129
09663;      Würzburg (Krfr.St);Insgesamt;30 bis unter 40;19133;10440;8693
09663;      Würzburg (Krfr.St);Insgesamt;40 bis unter 50;13181;6731;6450
09663;      Würzburg (Krfr.St);Insgesamt;50 bis unter 65;23539;11292;12247
09663;      Würzburg (Krfr.St);Insgesamt;65 oder älter;25513;10343;15170
09663;      Würzburg (Krfr.St);Insgesamt;Insgesamt;127880;61151;66729
09663;      Würzburg (Krfr.St);Deutsche;unter 6;5538;2760;2778
09663;      Würzburg (Krfr.St);Deutsche;6 bis unter 15;6361;3222;3139
09663;      Würzburg (Krfr.St);Deutsche;15 bis unter 18;2132;1072;1060
09663;      Würzburg (Krfr.St);Deutsche;18 bis unter 25;13582;5722;7860
09663;      Würzburg (Krfr.St);Deutsche;25 bis unter 30;11998;5952;6046
09663;      Würzburg (Krfr.St);Deutsche;30 bis unter 40;16167;8867;7300
09663;      Würzburg (Krfr.St);Deutsche;40 bis unter 50;10989;5586;5403
09663;      Würzburg (Krfr.St);Deutsche;50 bis unter 65;21593;10321;11272
09663;      Würzburg (Krfr.St);Deutsche;65 oder älter;24291;9851;14440
09663;      Würzburg (Krfr.St);Deutsche;Insgesamt;112651;53353;59298
09663;      Würzburg (Krfr.St);Ausländer;unter 6;782;413;369
09663;      Würzburg (Krfr.St);Ausländer;6 bis unter 15;871;476;395
09663;      Würzburg (Krfr.St);Ausländer;15 bis unter 18;321;190;131
09663;      Würzburg (Krfr.St);Ausländer;18 bis unter 25;2655;1347;1308
09663;      Würzburg (Krfr.St);Ausländer;25 bis unter 30;2274;1191;1083
09663;      Würzburg (Krfr.St);Ausländer;30 bis unter 40;2966;1573;1393
09663;      Würzburg (Krfr.St);Ausländer;40 bis unter 50;2192;1145;1047
09663;      Würzburg (Krfr.St);Ausländer;50 bis unter 65;1946;971;975
09663;      Würzburg (Krfr.St);Ausländer;65 oder älter;1222;492;730
09663;      Würzburg (Krfr.St);Ausländer;Insgesamt;15229;7798;7431
KS096;    Kreisfreie Städte Unterfranken;Insgesamt;unter 6;13388;6814;6574
KS096;    Kreisfreie Städte Unterfranken;Insgesamt;6 bis unter 15;16870;8636;8234
KS096;    Kreisfreie Städte Unterfranken;Insgesamt;15 bis unter 18;5681;2932;2749
KS096;    Kreisfreie Städte Unterfranken;Insgesamt;18 bis unter 25;26335;12491;13844
KS096;    Kreisfreie Städte Unterfranken;Insgesamt;25 bis unter 30;23000;11772;11228
KS096;    Kreisfreie Städte Unterfranken;Insgesamt;30 bis unter 40;35757;19014;16743
KS096;    Kreisfreie Städte Unterfranken;Insgesamt;40 bis unter 50;28104;14111;13993
KS096;    Kreisfreie Städte Unterfranken;Insgesamt;50 bis unter 65;50442;24474;25968
KS096;    Kreisfreie Städte Unterfranken;Insgesamt;65 oder älter;52862;21776;31086
KS096;    Kreisfreie Städte Unterfranken;Insgesamt;Insgesamt;252439;122020;130419
KS096;    Kreisfreie Städte Unterfranken;Deutsche;unter 6;11109;5629;5480
KS096;    Kreisfreie Städte Unterfranken;Deutsche;6 bis unter 15;14342;7320;7022
KS096;    Kreisfreie Städte Unterfranken;Deutsche;15 bis unter 18;4851;2453;2398
KS096;    Kreisfreie Städte Unterfranken;Deutsche;18 bis unter 25;20574;9214;11360
KS096;    Kreisfreie Städte Unterfranken;Deutsche;25 bis unter 30;18352;9214;9138
KS096;    Kreisfreie Städte Unterfranken;Deutsche;30 bis unter 40;28467;15156;13311
KS096;    Kreisfreie Städte Unterfranken;Deutsche;40 bis unter 50;22155;11108;11047
KS096;    Kreisfreie Städte Unterfranken;Deutsche;50 bis unter 65;45128;21758;23370
KS096;    Kreisfreie Städte Unterfranken;Deutsche;65 oder älter;49946;20419;29527
KS096;    Kreisfreie Städte Unterfranken;Deutsche;Insgesamt;214924;102271;112653
KS096;    Kreisfreie Städte Unterfranken;Ausländer;unter 6;2279;1185;1094
KS096;    Kreisfreie Städte Unterfranken;Ausländer;6 bis unter 15;2528;1316;1212
KS096;    Kreisfreie Städte Unterfranken;Ausländer;15 bis unter 18;830;479;351
KS096;    Kreisfreie Städte Unterfranken;Ausländer;18 bis unter 25;5761;3277;2484
KS096;    Kreisfreie Städte Unterfranken;Ausländer;25 bis unter 30;4648;2558;2090
KS096;    Kreisfreie Städte Unterfranken;Ausländer;30 bis unter 40;7290;3858;3432
KS096;    Kreisfreie Städte Unterfranken;Ausländer;40 bis unter 50;5949;3003;2946
KS096;    Kreisfreie Städte Unterfranken;Ausländer;50 bis unter 65;5314;2716;2598
KS096;    Kreisfreie Städte Unterfranken;Ausländer;65 oder älter;2916;1357;1559
KS096;    Kreisfreie Städte Unterfranken;Ausländer;Insgesamt;37515;19749;17766
09671;      Aschaffenburg (Lkr);Insgesamt;unter 6;9362;4848;4514
09671;      Aschaffenburg (Lkr);Insgesamt;6 bis unter 15;13801;7059;6742
09671;      Aschaffenburg (Lkr);Insgesamt;15 bis unter 18;5055;2554;2501
09671;      Aschaffenburg (Lkr);Insgesamt;18 bis unter 25;12550;6772;5778
09671;      Aschaffenburg (Lkr);Insgesamt;25 bis unter 30;9623;5013;4610
09671;      Aschaffenburg (Lkr);Insgesamt;30 bis unter 40;20483;10403;10080
09671;      Aschaffenburg (Lkr);Insgesamt;40 bis unter 50;22129;10835;11294
09671;      Aschaffenburg (Lkr);Insgesamt;50 bis unter 65;43824;21967;21857
09671;      Aschaffenburg (Lkr);Insgesamt;65 oder älter;37381;17119;20262
09671;      Aschaffenburg (Lkr);Insgesamt;Insgesamt;174208;86570;87638
09671;      Aschaffenburg (Lkr);Deutsche;unter 6;8500;4389;4111
09671;      Aschaffenburg (Lkr);Deutsche;6 bis unter 15;12702;6493;6209
09671;      Aschaffenburg (Lkr);Deutsche;15 bis unter 18;4731;2382;2349
09671;      Aschaffenburg (Lkr);Deutsche;18 bis unter 25;10988;5848;5140
09671;      Aschaffenburg (Lkr);Deutsche;25 bis unter 30;8148;4208;3940
09671;      Aschaffenburg (Lkr);Deutsche;30 bis unter 40;17353;8734;8619
09671;      Aschaffenburg (Lkr);Deutsche;40 bis unter 50;19000;9253;9747
09671;      Aschaffenburg (Lkr);Deutsche;50 bis unter 65;40756;20375;20381
09671;      Aschaffenburg (Lkr);Deutsche;65 oder älter;35734;16286;19448
09671;      Aschaffenburg (Lkr);Deutsche;Insgesamt;157912;77968;79944
09671;      Aschaffenburg (Lkr);Ausländer;unter 6;862;459;403
09671;      Aschaffenburg (Lkr);Ausländer;6 bis unter 15;1099;566;533
09671;      Aschaffenburg (Lkr);Ausländer;15 bis unter 18;324;172;152
09671;      Aschaffenburg (Lkr);Ausländer;18 bis unter 25;1562;924;638
09671;      Aschaffenburg (Lkr);Ausländer;25 bis unter 30;1475;805;670
09671;      Aschaffenburg (Lkr);Ausländer;30 bis unter 40;3130;1669;1461
09671;      Aschaffenburg (Lkr);Ausländer;40 bis unter 50;3129;1582;1547
09671;      Aschaffenburg (Lkr);Ausländer;50 bis unter 65;3068;1592;1476
09671;      Aschaffenburg (Lkr);Ausländer;65 oder älter;1647;833;814
09671;      Aschaffenburg (Lkr);Ausländer;Insgesamt;16296;8602;7694
09672;      Bad Kissingen (Lkr);Insgesamt;unter 6;5187;2665;2522
09672;      Bad Kissingen (Lkr);Insgesamt;6 bis unter 15;7664;3829;3835
09672;      Bad Kissingen (Lkr);Insgesamt;15 bis unter 18;2973;1504;1469
09672;      Bad Kissingen (Lkr);Insgesamt;18 bis unter 25;7281;3816;3465
09672;      Bad Kissingen (Lkr);Insgesamt;25 bis unter 30;5446;2856;2590
09672;      Bad Kissingen (Lkr);Insgesamt;30 bis unter 40;11306;5864;5442
09672;      Bad Kissingen (Lkr);Insgesamt;40 bis unter 50;12353;6161;6192
09672;      Bad Kissingen (Lkr);Insgesamt;50 bis unter 65;25816;12931;12885
09672;      Bad Kissingen (Lkr);Insgesamt;65 oder älter;25192;11239;13953
09672;      Bad Kissingen (Lkr);Insgesamt;Insgesamt;103218;50865;52353
09672;      Bad Kissingen (Lkr);Deutsche;unter 6;4763;2435;2328
09672;      Bad Kissingen (Lkr);Deutsche;6 bis unter 15;7174;3586;3588
09672;      Bad Kissingen (Lkr);Deutsche;15 bis unter 18;2785;1381;1404
09672;      Bad Kissingen (Lkr);Deutsche;18 bis unter 25;6653;3421;3232
09672;      Bad Kissingen (Lkr);Deutsche;25 bis unter 30;4922;2541;2381
09672;      Bad Kissingen (Lkr);Deutsche;30 bis unter 40;10167;5257;4910
09672;      Bad Kissingen (Lkr);Deutsche;40 bis unter 50;11298;5606;5692
09672;      Bad Kissingen (Lkr);Deutsche;50 bis unter 65;24822;12384;12438
09672;      Bad Kissingen (Lkr);Deutsche;65 oder älter;24808;11050;13758
09672;      Bad Kissingen (Lkr);Deutsche;Insgesamt;97392;47661;49731
09672;      Bad Kissingen (Lkr);Ausländer;unter 6;424;230;194
09672;      Bad Kissingen (Lkr);Ausländer;6 bis unter 15;490;243;247
09672;      Bad Kissingen (Lkr);Ausländer;15 bis unter 18;188;123;65
09672;      Bad Kissingen (Lkr);Ausländer;18 bis unter 25;628;395;233
09672;      Bad Kissingen (Lkr);Ausländer;25 bis unter 30;524;315;209
09672;      Bad Kissingen (Lkr);Ausländer;30 bis unter 40;1139;607;532
09672;      Bad Kissingen (Lkr);Ausländer;40 bis unter 50;1055;555;500
09672;      Bad Kissingen (Lkr);Ausländer;50 bis unter 65;994;547;447
09672;      Bad Kissingen (Lkr);Ausländer;65 oder älter;384;189;195
09672;      Bad Kissingen (Lkr);Ausländer;Insgesamt;5826;3204;2622
09673;      Rhön-Grabfeld (Lkr);Insgesamt;unter 6;4237;2164;2073
09673;      Rhön-Grabfeld (Lkr);Insgesamt;6 bis unter 15;6362;3247;3115
09673;      Rhön-Grabfeld (Lkr);Insgesamt;15 bis unter 18;2481;1253;1228
09673;      Rhön-Grabfeld (Lkr);Insgesamt;18 bis unter 25;5927;3216;2711
09673;      Rhön-Grabfeld (Lkr);Insgesamt;25 bis unter 30;4435;2308;2127
09673;      Rhön-Grabfeld (Lkr);Insgesamt;30 bis unter 40;9051;4605;4446
09673;      Rhön-Grabfeld (Lkr);Insgesamt;40 bis unter 50;9625;4759;4866
09673;      Rhön-Grabfeld (Lkr);Insgesamt;50 bis unter 65;19939;10087;9852
09673;      Rhön-Grabfeld (Lkr);Insgesamt;65 oder älter;17633;8038;9595
09673;      Rhön-Grabfeld (Lkr);Insgesamt;Insgesamt;79690;39677;40013
09673;      Rhön-Grabfeld (Lkr);Deutsche;unter 6;3929;1990;1939
09673;      Rhön-Grabfeld (Lkr);Deutsche;6 bis unter 15;6003;3053;2950
09673;      Rhön-Grabfeld (Lkr);Deutsche;15 bis unter 18;2365;1184;1181
09673;      Rhön-Grabfeld (Lkr);Deutsche;18 bis unter 25;5487;2929;2558
09673;      Rhön-Grabfeld (Lkr);Deutsche;25 bis unter 30;4036;2096;1940
09673;      Rhön-Grabfeld (Lkr);Deutsche;30 bis unter 40;8221;4176;4045
09673;      Rhön-Grabfeld (Lkr);Deutsche;40 bis unter 50;8912;4385;4527
09673;      Rhön-Grabfeld (Lkr);Deutsche;50 bis unter 65;19348;9773;9575
09673;      Rhön-Grabfeld (Lkr);Deutsche;65 oder älter;17408;7932;9476
09673;      Rhön-Grabfeld (Lkr);Deutsche;Insgesamt;75709;37518;38191
09673;      Rhön-Grabfeld (Lkr);Ausländer;unter 6;308;174;134
09673;      Rhön-Grabfeld (Lkr);Ausländer;6 bis unter 15;359;194;165
09673;      Rhön-Grabfeld (Lkr);Ausländer;15 bis unter 18;116;69;47
09673;      Rhön-Grabfeld (Lkr);Ausländer;18 bis unter 25;440;287;153
09673;      Rhön-Grabfeld (Lkr);Ausländer;25 bis unter 30;399;212;187
09673;      Rhön-Grabfeld (Lkr);Ausländer;30 bis unter 40;830;429;401
09673;      Rhön-Grabfeld (Lkr);Ausländer;40 bis unter 50;713;374;339
09673;      Rhön-Grabfeld (Lkr);Ausländer;50 bis unter 65;591;314;277
09673;      Rhön-Grabfeld (Lkr);Ausländer;65 oder älter;225;106;119
09673;      Rhön-Grabfeld (Lkr);Ausländer;Insgesamt;3981;2159;1822
09674;      Haßberge (Lkr);Insgesamt;unter 6;4661;2397;2264
09674;      Haßberge (Lkr);Insgesamt;6 bis unter 15;6666;3460;3206
09674;      Haßberge (Lkr);Insgesamt;15 bis unter 18;2553;1311;1242
09674;      Haßberge (Lkr);Insgesamt;18 bis unter 25;6393;3396;2997
09674;      Haßberge (Lkr);Insgesamt;25 bis unter 30;4779;2560;2219
09674;      Haßberge (Lkr);Insgesamt;30 bis unter 40;10019;5148;4871
09674;      Haßberge (Lkr);Insgesamt;40 bis unter 50;10436;5244;5192
09674;      Haßberge (Lkr);Insgesamt;50 bis unter 65;21542;10900;10642
09674;      Haßberge (Lkr);Insgesamt;65 oder älter;17550;8052;9498
09674;      Haßberge (Lkr);Insgesamt;Insgesamt;84599;42468;42131
09674;      Haßberge (Lkr);Deutsche;unter 6;4380;2251;2129
09674;      Haßberge (Lkr);Deutsche;6 bis unter 15;6292;3256;3036
09674;      Haßberge (Lkr);Deutsche;15 bis unter 18;2431;1242;1189
09674;      Haßberge (Lkr);Deutsche;18 bis unter 25;5909;3082;2827
09674;      Haßberge (Lkr);Deutsche;25 bis unter 30;4423;2362;2061
09674;      Haßberge (Lkr);Deutsche;30 bis unter 40;9256;4749;4507
09674;      Haßberge (Lkr);Deutsche;40 bis unter 50;9720;4897;4823
09674;      Haßberge (Lkr);Deutsche;50 bis unter 65;20905;10559;10346
09674;      Haßberge (Lkr);Deutsche;65 oder älter;17338;7943;9395
09674;      Haßberge (Lkr);Deutsche;Insgesamt;80654;40341;40313
09674;      Haßberge (Lkr);Ausländer;unter 6;281;146;135
09674;      Haßberge (Lkr);Ausländer;6 bis unter 15;374;204;170
09674;      Haßberge (Lkr);Ausländer;15 bis unter 18;122;69;53
09674;      Haßberge (Lkr);Ausländer;18 bis unter 25;484;314;170
09674;      Haßberge (Lkr);Ausländer;25 bis unter 30;356;198;158
09674;      Haßberge (Lkr);Ausländer;30 bis unter 40;763;399;364
09674;      Haßberge (Lkr);Ausländer;40 bis unter 50;716;347;369
09674;      Haßberge (Lkr);Ausländer;50 bis unter 65;637;341;296
09674;      Haßberge (Lkr);Ausländer;65 oder älter;212;109;103
09674;      Haßberge (Lkr);Ausländer;Insgesamt;3945;2127;1818
09675;      Kitzingen (Lkr);Insgesamt;unter 6;5050;2655;2395
09675;      Kitzingen (Lkr);Insgesamt;6 bis unter 15;7055;3572;3483
09675;      Kitzingen (Lkr);Insgesamt;15 bis unter 18;2723;1401;1322
09675;      Kitzingen (Lkr);Insgesamt;18 bis unter 25;7010;3818;3192
09675;      Kitzingen (Lkr);Insgesamt;25 bis unter 30;5545;2963;2582
09675;      Kitzingen (Lkr);Insgesamt;30 bis unter 40;11241;5826;5415
09675;      Kitzingen (Lkr);Insgesamt;40 bis unter 50;11509;5786;5723
09675;      Kitzingen (Lkr);Insgesamt;50 bis unter 65;22017;11120;10897
09675;      Kitzingen (Lkr);Insgesamt;65 oder älter;18759;8650;10109
09675;      Kitzingen (Lkr);Insgesamt;Insgesamt;90909;45791;45118
09675;      Kitzingen (Lkr);Deutsche;unter 6;4518;2383;2135
09675;      Kitzingen (Lkr);Deutsche;6 bis unter 15;6412;3238;3174
09675;      Kitzingen (Lkr);Deutsche;15 bis unter 18;2493;1276;1217
09675;      Kitzingen (Lkr);Deutsche;18 bis unter 25;5976;3157;2819
09675;      Kitzingen (Lkr);Deutsche;25 bis unter 30;4572;2375;2197
09675;      Kitzingen (Lkr);Deutsche;30 bis unter 40;9495;4789;4706
09675;      Kitzingen (Lkr);Deutsche;40 bis unter 50;10002;4979;5023
09675;      Kitzingen (Lkr);Deutsche;50 bis unter 65;20806;10426;10380
09675;      Kitzingen (Lkr);Deutsche;65 oder älter;18278;8398;9880
09675;      Kitzingen (Lkr);Deutsche;Insgesamt;82552;41021;41531
09675;      Kitzingen (Lkr);Ausländer;unter 6;532;272;260
09675;      Kitzingen (Lkr);Ausländer;6 bis unter 15;643;334;309
09675;      Kitzingen (Lkr);Ausländer;15 bis unter 18;230;125;105
09675;      Kitzingen (Lkr);Ausländer;18 bis unter 25;1034;661;373
09675;      Kitzingen (Lkr);Ausländer;25 bis unter 30;973;588;385
09675;      Kitzingen (Lkr);Ausländer;30 bis unter 40;1746;1037;709
09675;      Kitzingen (Lkr);Ausländer;40 bis unter 50;1507;807;700
09675;      Kitzingen (Lkr);Ausländer;50 bis unter 65;1211;694;517
09675;      Kitzingen (Lkr);Ausländer;65 oder älter;481;252;229
09675;      Kitzingen (Lkr);Ausländer;Insgesamt;8357;4770;3587
09676;      Miltenberg (Lkr);Insgesamt;unter 6;6951;3582;3369
09676;      Miltenberg (Lkr);Insgesamt;6 bis unter 15;10261;5274;4987
09676;      Miltenberg (Lkr);Insgesamt;15 bis unter 18;3914;2011;1903
09676;      Miltenberg (Lkr);Insgesamt;18 bis unter 25;9839;5298;4541
09676;      Miltenberg (Lkr);Insgesamt;25 bis unter 30;7156;3765;3391
09676;      Miltenberg (Lkr);Insgesamt;30 bis unter 40;14896;7568;7328
09676;      Miltenberg (Lkr);Insgesamt;40 bis unter 50;16869;8330;8539
09676;      Miltenberg (Lkr);Insgesamt;50 bis unter 65;31472;15880;15592
09676;      Miltenberg (Lkr);Insgesamt;65 oder älter;27398;12482;14916
09676;      Miltenberg (Lkr);Insgesamt;Insgesamt;128756;64190;64566
09676;      Miltenberg (Lkr);Deutsche;unter 6;6290;3244;3046
09676;      Miltenberg (Lkr);Deutsche;6 bis unter 15;9449;4855;4594
09676;      Miltenberg (Lkr);Deutsche;15 bis unter 18;3626;1858;1768
09676;      Miltenberg (Lkr);Deutsche;18 bis unter 25;8401;4484;3917
09676;      Miltenberg (Lkr);Deutsche;25 bis unter 30;5925;3086;2839
09676;      Miltenberg (Lkr);Deutsche;30 bis unter 40;12270;6218;6052
09676;      Miltenberg (Lkr);Deutsche;40 bis unter 50;13907;6869;7038
09676;      Miltenberg (Lkr);Deutsche;50 bis unter 65;28886;14517;14369
09676;      Miltenberg (Lkr);Deutsche;65 oder älter;25527;11579;13948
09676;      Miltenberg (Lkr);Deutsche;Insgesamt;114281;56710;57571
09676;      Miltenberg (Lkr);Ausländer;unter 6;661;338;323
09676;      Miltenberg (Lkr);Ausländer;6 bis unter 15;812;419;393
09676;      Miltenberg (Lkr);Ausländer;15 bis unter 18;288;153;135
09676;      Miltenberg (Lkr);Ausländer;18 bis unter 25;1438;814;624
09676;      Miltenberg (Lkr);Ausländer;25 bis unter 30;1231;679;552
09676;      Miltenberg (Lkr);Ausländer;30 bis unter 40;2626;1350;1276
09676;      Miltenberg (Lkr);Ausländer;40 bis unter 50;2962;1461;1501
09676;      Miltenberg (Lkr);Ausländer;50 bis unter 65;2586;1363;1223
09676;      Miltenberg (Lkr);Ausländer;65 oder älter;1871;903;968
09676;      Miltenberg (Lkr);Ausländer;Insgesamt;14475;7480;6995
09677;      Main-Spessart (Lkr);Insgesamt;unter 6;6472;3299;3173
09677;      Main-Spessart (Lkr);Insgesamt;6 bis unter 15;9414;4759;4655
09677;      Main-Spessart (Lkr);Insgesamt;15 bis unter 18;3657;1880;1777
09677;      Main-Spessart (Lkr);Insgesamt;18 bis unter 25;9057;4884;4173
09677;      Main-Spessart (Lkr);Insgesamt;25 bis unter 30;6903;3711;3192
09677;      Main-Spessart (Lkr);Insgesamt;30 bis unter 40;14177;7361;6816
09677;      Main-Spessart (Lkr);Insgesamt;40 bis unter 50;15587;7703;7884
09677;      Main-Spessart (Lkr);Insgesamt;50 bis unter 65;32194;16264;15930
09677;      Main-Spessart (Lkr);Insgesamt;65 oder älter;28904;13092;15812
09677;      Main-Spessart (Lkr);Insgesamt;Insgesamt;126365;62953;63412
09677;      Main-Spessart (Lkr);Deutsche;unter 6;5926;3054;2872
09677;      Main-Spessart (Lkr);Deutsche;6 bis unter 15;8687;4392;4295
09677;      Main-Spessart (Lkr);Deutsche;15 bis unter 18;3488;1789;1699
09677;      Main-Spessart (Lkr);Deutsche;18 bis unter 25;8144;4362;3782
09677;      Main-Spessart (Lkr);Deutsche;25 bis unter 30;6108;3266;2842
09677;      Main-Spessart (Lkr);Deutsche;30 bis unter 40;12494;6491;6003
09677;      Main-Spessart (Lkr);Deutsche;40 bis unter 50;13862;6851;7011
09677;      Main-Spessart (Lkr);Deutsche;50 bis unter 65;30679;15503;15176
09677;      Main-Spessart (Lkr);Deutsche;65 oder älter;28126;12718;15408
09677;      Main-Spessart (Lkr);Deutsche;Insgesamt;117514;58426;59088
09677;      Main-Spessart (Lkr);Ausländer;unter 6;546;245;301
09677;      Main-Spessart (Lkr);Ausländer;6 bis unter 15;727;367;360
09677;      Main-Spessart (Lkr);Ausländer;15 bis unter 18;169;91;78
09677;      Main-Spessart (Lkr);Ausländer;18 bis unter 25;913;522;391
09677;      Main-Spessart (Lkr);Ausländer;25 bis unter 30;795;445;350
09677;      Main-Spessart (Lkr);Ausländer;30 bis unter 40;1683;870;813
09677;      Main-Spessart (Lkr);Ausländer;40 bis unter 50;1725;852;873
09677;      Main-Spessart (Lkr);Ausländer;50 bis unter 65;1515;761;754
09677;      Main-Spessart (Lkr);Ausländer;65 oder älter;778;374;404
09677;      Main-Spessart (Lkr);Ausländer;Insgesamt;8851;4527;4324
09678;      Schweinfurt (Lkr);Insgesamt;unter 6;6373;3335;3038
09678;      Schweinfurt (Lkr);Insgesamt;6 bis unter 15;9024;4730;4294
09678;      Schweinfurt (Lkr);Insgesamt;15 bis unter 18;3334;1658;1676
09678;      Schweinfurt (Lkr);Insgesamt;18 bis unter 25;8394;4505;3889
09678;      Schweinfurt (Lkr);Insgesamt;25 bis unter 30;6610;3443;3167
09678;      Schweinfurt (Lkr);Insgesamt;30 bis unter 40;13809;7159;6650
09678;      Schweinfurt (Lkr);Insgesamt;40 bis unter 50;13843;6947;6896
09678;      Schweinfurt (Lkr);Insgesamt;50 bis unter 65;28743;14511;14232
09678;      Schweinfurt (Lkr);Insgesamt;65 oder älter;24976;11480;13496
09678;      Schweinfurt (Lkr);Insgesamt;Insgesamt;115106;57768;57338
09678;      Schweinfurt (Lkr);Deutsche;unter 6;5932;3091;2841
09678;      Schweinfurt (Lkr);Deutsche;6 bis unter 15;8458;4424;4034
09678;      Schweinfurt (Lkr);Deutsche;15 bis unter 18;3192;1579;1613
09678;      Schweinfurt (Lkr);Deutsche;18 bis unter 25;7635;4022;3613
09678;      Schweinfurt (Lkr);Deutsche;25 bis unter 30;5927;3051;2876
09678;      Schweinfurt (Lkr);Deutsche;30 bis unter 40;12382;6351;6031
09678;      Schweinfurt (Lkr);Deutsche;40 bis unter 50;12572;6237;6335
09678;      Schweinfurt (Lkr);Deutsche;50 bis unter 65;27672;13900;13772
09678;      Schweinfurt (Lkr);Deutsche;65 oder älter;24546;11245;13301
09678;      Schweinfurt (Lkr);Deutsche;Insgesamt;108316;53900;54416
09678;      Schweinfurt (Lkr);Ausländer;unter 6;441;244;197
09678;      Schweinfurt (Lkr);Ausländer;6 bis unter 15;566;306;260
09678;      Schweinfurt (Lkr);Ausländer;15 bis unter 18;142;79;63
09678;      Schweinfurt (Lkr);Ausländer;18 bis unter 25;759;483;276
09678;      Schweinfurt (Lkr);Ausländer;25 bis unter 30;683;392;291
09678;      Schweinfurt (Lkr);Ausländer;30 bis unter 40;1427;808;619
09678;      Schweinfurt (Lkr);Ausländer;40 bis unter 50;1271;710;561
09678;      Schweinfurt (Lkr);Ausländer;50 bis unter 65;1071;611;460
09678;      Schweinfurt (Lkr);Ausländer;65 oder älter;430;235;195
09678;      Schweinfurt (Lkr);Ausländer;Insgesamt;6790;3868;2922
09679;      Würzburg (Lkr);Insgesamt;unter 6;9275;4770;4505
09679;      Würzburg (Lkr);Insgesamt;6 bis unter 15;12927;6651;6276
09679;      Würzburg (Lkr);Insgesamt;15 bis unter 18;4740;2462;2278
09679;      Würzburg (Lkr);Insgesamt;18 bis unter 25;12048;6406;5642
09679;      Würzburg (Lkr);Insgesamt;25 bis unter 30;8940;4696;4244
09679;      Würzburg (Lkr);Insgesamt;30 bis unter 40;19587;9920;9667
09679;      Würzburg (Lkr);Insgesamt;40 bis unter 50;20534;10219;10315
09679;      Würzburg (Lkr);Insgesamt;50 bis unter 65;39372;19563;19809
09679;      Würzburg (Lkr);Insgesamt;65 oder älter;34411;15907;18504
09679;      Würzburg (Lkr);Insgesamt;Insgesamt;161834;80594;81240
09679;      Würzburg (Lkr);Deutsche;unter 6;8648;4461;4187
09679;      Würzburg (Lkr);Deutsche;6 bis unter 15;12239;6298;5941
09679;      Würzburg (Lkr);Deutsche;15 bis unter 18;4489;2319;2170
09679;      Würzburg (Lkr);Deutsche;18 bis unter 25;10874;5691;5183
09679;      Würzburg (Lkr);Deutsche;25 bis unter 30;7887;4114;3773
09679;      Würzburg (Lkr);Deutsche;30 bis unter 40;17418;8751;8667
09679;      Würzburg (Lkr);Deutsche;40 bis unter 50;18576;9171;9405
09679;      Würzburg (Lkr);Deutsche;50 bis unter 65;37728;18635;19093
09679;      Würzburg (Lkr);Deutsche;65 oder älter;33766;15556;18210
09679;      Würzburg (Lkr);Deutsche;Insgesamt;151625;74996;76629
09679;      Würzburg (Lkr);Ausländer;unter 6;627;309;318
09679;      Würzburg (Lkr);Ausländer;6 bis unter 15;688;353;335
09679;      Würzburg (Lkr);Ausländer;15 bis unter 18;251;143;108
09679;      Würzburg (Lkr);Ausländer;18 bis unter 25;1174;715;459
09679;      Würzburg (Lkr);Ausländer;25 bis unter 30;1053;582;471
09679;      Würzburg (Lkr);Ausländer;30 bis unter 40;2169;1169;1000
09679;      Würzburg (Lkr);Ausländer;40 bis unter 50;1958;1048;910
09679;      Würzburg (Lkr);Ausländer;50 bis unter 65;1644;928;716
09679;      Würzburg (Lkr);Ausländer;65 oder älter;645;351;294
09679;      Würzburg (Lkr);Ausländer;Insgesamt;10209;5598;4611
LK096;    Landkreise Unterfranken;Insgesamt;unter 6;57568;29715;27853
LK096;    Landkreise Unterfranken;Insgesamt;6 bis unter 15;83174;42581;40593
LK096;    Landkreise Unterfranken;Insgesamt;15 bis unter 18;31430;16034;15396
LK096;    Landkreise Unterfranken;Insgesamt;18 bis unter 25;78499;42111;36388
LK096;    Landkreise Unterfranken;Insgesamt;25 bis unter 30;59437;31315;28122
LK096;    Landkreise Unterfranken;Insgesamt;30 bis unter 40;124569;63854;60715
LK096;    Landkreise Unterfranken;Insgesamt;40 bis unter 50;132885;65984;66901
LK096;    Landkreise Unterfranken;Insgesamt;50 bis unter 65;264919;133223;131696
LK096;    Landkreise Unterfranken;Insgesamt;65 oder älter;232204;106059;126145
LK096;    Landkreise Unterfranken;Insgesamt;Insgesamt;1064685;530876;533809
LK096;    Landkreise Unterfranken;Deutsche;unter 6;52886;27298;25588
LK096;    Landkreise Unterfranken;Deutsche;6 bis unter 15;77416;39595;37821
LK096;    Landkreise Unterfranken;Deutsche;15 bis unter 18;29600;15010;14590
LK096;    Landkreise Unterfranken;Deutsche;18 bis unter 25;70067;36996;33071
LK096;    Landkreise Unterfranken;Deutsche;25 bis unter 30;51948;27099;24849
LK096;    Landkreise Unterfranken;Deutsche;30 bis unter 40;109056;55516;53540
LK096;    Landkreise Unterfranken;Deutsche;40 bis unter 50;117849;58248;59601
LK096;    Landkreise Unterfranken;Deutsche;50 bis unter 65;251602;126072;125530
LK096;    Landkreise Unterfranken;Deutsche;65 oder älter;225531;102707;122824
LK096;    Landkreise Unterfranken;Deutsche;Insgesamt;985955;488541;497414
LK096;    Landkreise Unterfranken;Ausländer;unter 6;4682;2417;2265
LK096;    Landkreise Unterfranken;Ausländer;6 bis unter 15;5758;2986;2772
LK096;    Landkreise Unterfranken;Ausländer;15 bis unter 18;1830;1024;806
LK096;    Landkreise Unterfranken;Ausländer;18 bis unter 25;8432;5115;3317
LK096;    Landkreise Unterfranken;Ausländer;25 bis unter 30;7489;4216;3273
LK096;    Landkreise Unterfranken;Ausländer;30 bis unter 40;15513;8338;7175
LK096;    Landkreise Unterfranken;Ausländer;40 bis unter 50;15036;7736;7300
LK096;    Landkreise Unterfranken;Ausländer;50 bis unter 65;13317;7151;6166
LK096;    Landkreise Unterfranken;Ausländer;65 oder älter;6673;3352;3321
LK096;    Landkreise Unterfranken;Ausländer;Insgesamt;78730;42335;36395
096;  Unterfranken;Insgesamt;unter 6;70956;36529;34427
096;  Unterfranken;Insgesamt;6 bis unter 15;100044;51217;48827
096;  Unterfranken;Insgesamt;15 bis unter 18;37111;18966;18145
096;  Unterfranken;Insgesamt;18 bis unter 25;104834;54602;50232
096;  Unterfranken;Insgesamt;25 bis unter 30;82437;43087;39350
096;  Unterfranken;Insgesamt;30 bis unter 40;160326;82868;77458
096;  Unterfranken;Insgesamt;40 bis unter 50;160989;80095;80894
096;  Unterfranken;Insgesamt;50 bis unter 65;315361;157697;157664
096;  Unterfranken;Insgesamt;65 oder älter;285066;127835;157231
096;  Unterfranken;Insgesamt;Insgesamt;1317124;652896;664228
096;  Unterfranken;Deutsche;unter 6;63995;32927;31068
096;  Unterfranken;Deutsche;6 bis unter 15;91758;46915;44843
096;  Unterfranken;Deutsche;15 bis unter 18;34451;17463;16988
096;  Unterfranken;Deutsche;18 bis unter 25;90641;46210;44431
096;  Unterfranken;Deutsche;25 bis unter 30;70300;36313;33987
096;  Unterfranken;Deutsche;30 bis unter 40;137523;70672;66851
096;  Unterfranken;Deutsche;40 bis unter 50;140004;69356;70648
096;  Unterfranken;Deutsche;50 bis unter 65;296730;147830;148900
096;  Unterfranken;Deutsche;65 oder älter;275477;123126;152351
096;  Unterfranken;Deutsche;Insgesamt;1200879;590812;610067
096;  Unterfranken;Ausländer;unter 6;6961;3602;3359
096;  Unterfranken;Ausländer;6 bis unter 15;8286;4302;3984
096;  Unterfranken;Ausländer;15 bis unter 18;2660;1503;1157
096;  Unterfranken;Ausländer;18 bis unter 25;14193;8392;5801
096;  Unterfranken;Ausländer;25 bis unter 30;12137;6774;5363
096;  Unterfranken;Ausländer;30 bis unter 40;22803;12196;10607
096;  Unterfranken;Ausländer;40 bis unter 50;20985;10739;10246
096;  Unterfranken;Ausländer;50 bis unter 65;18631;9867;8764
096;  Unterfranken;Ausländer;65 oder älter;9589;4709;4880
096;  Unterfranken;Ausländer;Insgesamt;116245;62084;54161
09761;      Augsburg (Krfr.St);Insgesamt;unter 6;16698;8486;8212
09761;      Augsburg (Krfr.St);Insgesamt;6 bis unter 15;21199;10934;10265
09761;      Augsburg (Krfr.St);Insgesamt;15 bis unter 18;7291;3713;3578
09761;      Augsburg (Krfr.St);Insgesamt;18 bis unter 25;27269;13552;13717
09761;      Augsburg (Krfr.St);Insgesamt;25 bis unter 30;25904;13311;12593
09761;      Augsburg (Krfr.St);Insgesamt;30 bis unter 40;45103;23842;21261
09761;      Augsburg (Krfr.St);Insgesamt;40 bis unter 50;37216;18963;18253
09761;      Augsburg (Krfr.St);Insgesamt;50 bis unter 65;57129;28463;28666
09761;      Augsburg (Krfr.St);Insgesamt;65 oder älter;57326;23894;33432
09761;      Augsburg (Krfr.St);Insgesamt;Insgesamt;295135;145158;149977
09761;      Augsburg (Krfr.St);Deutsche;unter 6;13614;6988;6626
09761;      Augsburg (Krfr.St);Deutsche;6 bis unter 15;17973;9241;8732
09761;      Augsburg (Krfr.St);Deutsche;15 bis unter 18;6032;3052;2980
09761;      Augsburg (Krfr.St);Deutsche;18 bis unter 25;20154;9654;10500
09761;      Augsburg (Krfr.St);Deutsche;25 bis unter 30;18708;9392;9316
09761;      Augsburg (Krfr.St);Deutsche;30 bis unter 40;31477;16555;14922
09761;      Augsburg (Krfr.St);Deutsche;40 bis unter 50;25475;12951;12524
09761;      Augsburg (Krfr.St);Deutsche;50 bis unter 65;47327;23352;23975
09761;      Augsburg (Krfr.St);Deutsche;65 oder älter;50433;20718;29715
09761;      Augsburg (Krfr.St);Deutsche;Insgesamt;231193;111903;119290
09761;      Augsburg (Krfr.St);Ausländer;unter 6;3084;1498;1586
09761;      Augsburg (Krfr.St);Ausländer;6 bis unter 15;3226;1693;1533
09761;      Augsburg (Krfr.St);Ausländer;15 bis unter 18;1259;661;598
09761;      Augsburg (Krfr.St);Ausländer;18 bis unter 25;7115;3898;3217
09761;      Augsburg (Krfr.St);Ausländer;25 bis unter 30;7196;3919;3277
09761;      Augsburg (Krfr.St);Ausländer;30 bis unter 40;13626;7287;6339
09761;      Augsburg (Krfr.St);Ausländer;40 bis unter 50;11741;6012;5729
09761;      Augsburg (Krfr.St);Ausländer;50 bis unter 65;9802;5111;4691
09761;      Augsburg (Krfr.St);Ausländer;65 oder älter;6893;3176;3717
09761;      Augsburg (Krfr.St);Ausländer;Insgesamt;63942;33255;30687
09762;      Kaufbeuren (Krfr.St);Insgesamt;unter 6;2488;1286;1202
09762;      Kaufbeuren (Krfr.St);Insgesamt;6 bis unter 15;3455;1751;1704
09762;      Kaufbeuren (Krfr.St);Insgesamt;15 bis unter 18;1260;650;610
09762;      Kaufbeuren (Krfr.St);Insgesamt;18 bis unter 25;3314;1753;1561
09762;      Kaufbeuren (Krfr.St);Insgesamt;25 bis unter 30;2779;1433;1346
09762;      Kaufbeuren (Krfr.St);Insgesamt;30 bis unter 40;5513;2933;2580
09762;      Kaufbeuren (Krfr.St);Insgesamt;40 bis unter 50;5204;2645;2559
09762;      Kaufbeuren (Krfr.St);Insgesamt;50 bis unter 65;9838;4804;5034
09762;      Kaufbeuren (Krfr.St);Insgesamt;65 oder älter;10042;4355;5687
09762;      Kaufbeuren (Krfr.St);Insgesamt;Insgesamt;43893;21610;22283
09762;      Kaufbeuren (Krfr.St);Deutsche;unter 6;2039;1056;983
09762;      Kaufbeuren (Krfr.St);Deutsche;6 bis unter 15;2933;1472;1461
09762;      Kaufbeuren (Krfr.St);Deutsche;15 bis unter 18;1109;562;547
09762;      Kaufbeuren (Krfr.St);Deutsche;18 bis unter 25;2549;1311;1238
09762;      Kaufbeuren (Krfr.St);Deutsche;25 bis unter 30;2067;1059;1008
09762;      Kaufbeuren (Krfr.St);Deutsche;30 bis unter 40;4174;2194;1980
09762;      Kaufbeuren (Krfr.St);Deutsche;40 bis unter 50;3928;1940;1988
09762;      Kaufbeuren (Krfr.St);Deutsche;50 bis unter 65;8806;4252;4554
09762;      Kaufbeuren (Krfr.St);Deutsche;65 oder älter;9435;4052;5383
09762;      Kaufbeuren (Krfr.St);Deutsche;Insgesamt;37040;17898;19142
09762;      Kaufbeuren (Krfr.St);Ausländer;unter 6;449;230;219
09762;      Kaufbeuren (Krfr.St);Ausländer;6 bis unter 15;522;279;243
09762;      Kaufbeuren (Krfr.St);Ausländer;15 bis unter 18;151;88;63
09762;      Kaufbeuren (Krfr.St);Ausländer;18 bis unter 25;765;442;323
09762;      Kaufbeuren (Krfr.St);Ausländer;25 bis unter 30;712;374;338
09762;      Kaufbeuren (Krfr.St);Ausländer;30 bis unter 40;1339;739;600
09762;      Kaufbeuren (Krfr.St);Ausländer;40 bis unter 50;1276;705;571
09762;      Kaufbeuren (Krfr.St);Ausländer;50 bis unter 65;1032;552;480
09762;      Kaufbeuren (Krfr.St);Ausländer;65 oder älter;607;303;304
09762;      Kaufbeuren (Krfr.St);Ausländer;Insgesamt;6853;3712;3141
09763;      Kempten (Allgäu) (Krfr.St);Insgesamt;unter 6;3854;1980;1874
09763;      Kempten (Allgäu) (Krfr.St);Insgesamt;6 bis unter 15;5033;2632;2401
09763;      Kempten (Allgäu) (Krfr.St);Insgesamt;15 bis unter 18;1823;958;865
09763;      Kempten (Allgäu) (Krfr.St);Insgesamt;18 bis unter 25;6217;3203;3014
09763;      Kempten (Allgäu) (Krfr.St);Insgesamt;25 bis unter 30;5399;2929;2470
09763;      Kempten (Allgäu) (Krfr.St);Insgesamt;30 bis unter 40;9161;4844;4317
09763;      Kempten (Allgäu) (Krfr.St);Insgesamt;40 bis unter 50;8292;4223;4069
09763;      Kempten (Allgäu) (Krfr.St);Insgesamt;50 bis unter 65;13862;6789;7073
09763;      Kempten (Allgäu) (Krfr.St);Insgesamt;65 oder älter;15266;6583;8683
09763;      Kempten (Allgäu) (Krfr.St);Insgesamt;Insgesamt;68907;34141;34766
09763;      Kempten (Allgäu) (Krfr.St);Deutsche;unter 6;3280;1676;1604
09763;      Kempten (Allgäu) (Krfr.St);Deutsche;6 bis unter 15;4440;2315;2125
09763;      Kempten (Allgäu) (Krfr.St);Deutsche;15 bis unter 18;1600;833;767
09763;      Kempten (Allgäu) (Krfr.St);Deutsche;18 bis unter 25;4831;2422;2409
09763;      Kempten (Allgäu) (Krfr.St);Deutsche;25 bis unter 30;4114;2210;1904
09763;      Kempten (Allgäu) (Krfr.St);Deutsche;30 bis unter 40;6833;3594;3239
09763;      Kempten (Allgäu) (Krfr.St);Deutsche;40 bis unter 50;6190;3106;3084
09763;      Kempten (Allgäu) (Krfr.St);Deutsche;50 bis unter 65;12049;5823;6226
09763;      Kempten (Allgäu) (Krfr.St);Deutsche;65 oder älter;14169;6027;8142
09763;      Kempten (Allgäu) (Krfr.St);Deutsche;Insgesamt;57506;28006;29500
09763;      Kempten (Allgäu) (Krfr.St);Ausländer;unter 6;574;304;270
09763;      Kempten (Allgäu) (Krfr.St);Ausländer;6 bis unter 15;593;317;276
09763;      Kempten (Allgäu) (Krfr.St);Ausländer;15 bis unter 18;223;125;98
09763;      Kempten (Allgäu) (Krfr.St);Ausländer;18 bis unter 25;1386;781;605
09763;      Kempten (Allgäu) (Krfr.St);Ausländer;25 bis unter 30;1285;719;566
09763;      Kempten (Allgäu) (Krfr.St);Ausländer;30 bis unter 40;2328;1250;1078
09763;      Kempten (Allgäu) (Krfr.St);Ausländer;40 bis unter 50;2102;1117;985
09763;      Kempten (Allgäu) (Krfr.St);Ausländer;50 bis unter 65;1813;966;847
09763;      Kempten (Allgäu) (Krfr.St);Ausländer;65 oder älter;1097;556;541
09763;      Kempten (Allgäu) (Krfr.St);Ausländer;Insgesamt;11401;6135;5266
09764;      Memmingen (Krfr.St);Insgesamt;unter 6;2512;1257;1255
09764;      Memmingen (Krfr.St);Insgesamt;6 bis unter 15;3474;1733;1741
09764;      Memmingen (Krfr.St);Insgesamt;15 bis unter 18;1281;660;621
09764;      Memmingen (Krfr.St);Insgesamt;18 bis unter 25;3385;1808;1577
09764;      Memmingen (Krfr.St);Insgesamt;25 bis unter 30;2981;1572;1409
09764;      Memmingen (Krfr.St);Insgesamt;30 bis unter 40;5592;2930;2662
09764;      Memmingen (Krfr.St);Insgesamt;40 bis unter 50;5459;2810;2649
09764;      Memmingen (Krfr.St);Insgesamt;50 bis unter 65;9684;4884;4800
09764;      Memmingen (Krfr.St);Insgesamt;65 oder älter;9469;4056;5413
09764;      Memmingen (Krfr.St);Insgesamt;Insgesamt;43837;21710;22127
09764;      Memmingen (Krfr.St);Deutsche;unter 6;2103;1040;1063
09764;      Memmingen (Krfr.St);Deutsche;6 bis unter 15;2977;1473;1504
09764;      Memmingen (Krfr.St);Deutsche;15 bis unter 18;1094;568;526
09764;      Memmingen (Krfr.St);Deutsche;18 bis unter 25;2499;1305;1194
09764;      Memmingen (Krfr.St);Deutsche;25 bis unter 30;2107;1092;1015
09764;      Memmingen (Krfr.St);Deutsche;30 bis unter 40;3947;2013;1934
09764;      Memmingen (Krfr.St);Deutsche;40 bis unter 50;3856;1947;1909
09764;      Memmingen (Krfr.St);Deutsche;50 bis unter 65;8247;4109;4138
09764;      Memmingen (Krfr.St);Deutsche;65 oder älter;8806;3723;5083
09764;      Memmingen (Krfr.St);Deutsche;Insgesamt;35636;17270;18366
09764;      Memmingen (Krfr.St);Ausländer;unter 6;409;217;192
09764;      Memmingen (Krfr.St);Ausländer;6 bis unter 15;497;260;237
09764;      Memmingen (Krfr.St);Ausländer;15 bis unter 18;187;92;95
09764;      Memmingen (Krfr.St);Ausländer;18 bis unter 25;886;503;383
09764;      Memmingen (Krfr.St);Ausländer;25 bis unter 30;874;480;394
09764;      Memmingen (Krfr.St);Ausländer;30 bis unter 40;1645;917;728
09764;      Memmingen (Krfr.St);Ausländer;40 bis unter 50;1603;863;740
09764;      Memmingen (Krfr.St);Ausländer;50 bis unter 65;1437;775;662
09764;      Memmingen (Krfr.St);Ausländer;65 oder älter;663;333;330
09764;      Memmingen (Krfr.St);Ausländer;Insgesamt;8201;4440;3761
KS097;    Kreisfreie Städte Schwaben;Insgesamt;unter 6;25552;13009;12543
KS097;    Kreisfreie Städte Schwaben;Insgesamt;6 bis unter 15;33161;17050;16111
KS097;    Kreisfreie Städte Schwaben;Insgesamt;15 bis unter 18;11655;5981;5674
KS097;    Kreisfreie Städte Schwaben;Insgesamt;18 bis unter 25;40185;20316;19869
KS097;    Kreisfreie Städte Schwaben;Insgesamt;25 bis unter 30;37063;19245;17818
KS097;    Kreisfreie Städte Schwaben;Insgesamt;30 bis unter 40;65369;34549;30820
KS097;    Kreisfreie Städte Schwaben;Insgesamt;40 bis unter 50;56171;28641;27530
KS097;    Kreisfreie Städte Schwaben;Insgesamt;50 bis unter 65;90513;44940;45573
KS097;    Kreisfreie Städte Schwaben;Insgesamt;65 oder älter;92103;38888;53215
KS097;    Kreisfreie Städte Schwaben;Insgesamt;Insgesamt;451772;222619;229153
KS097;    Kreisfreie Städte Schwaben;Deutsche;unter 6;21036;10760;10276
KS097;    Kreisfreie Städte Schwaben;Deutsche;6 bis unter 15;28323;14501;13822
KS097;    Kreisfreie Städte Schwaben;Deutsche;15 bis unter 18;9835;5015;4820
KS097;    Kreisfreie Städte Schwaben;Deutsche;18 bis unter 25;30033;14692;15341
KS097;    Kreisfreie Städte Schwaben;Deutsche;25 bis unter 30;26996;13753;13243
KS097;    Kreisfreie Städte Schwaben;Deutsche;30 bis unter 40;46431;24356;22075
KS097;    Kreisfreie Städte Schwaben;Deutsche;40 bis unter 50;39449;19944;19505
KS097;    Kreisfreie Städte Schwaben;Deutsche;50 bis unter 65;76429;37536;38893
KS097;    Kreisfreie Städte Schwaben;Deutsche;65 oder älter;82843;34520;48323
KS097;    Kreisfreie Städte Schwaben;Deutsche;Insgesamt;361375;175077;186298
KS097;    Kreisfreie Städte Schwaben;Ausländer;unter 6;4516;2249;2267
KS097;    Kreisfreie Städte Schwaben;Ausländer;6 bis unter 15;4838;2549;2289
KS097;    Kreisfreie Städte Schwaben;Ausländer;15 bis unter 18;1820;966;854
KS097;    Kreisfreie Städte Schwaben;Ausländer;18 bis unter 25;10152;5624;4528
KS097;    Kreisfreie Städte Schwaben;Ausländer;25 bis unter 30;10067;5492;4575
KS097;    Kreisfreie Städte Schwaben;Ausländer;30 bis unter 40;18938;10193;8745
KS097;    Kreisfreie Städte Schwaben;Ausländer;40 bis unter 50;16722;8697;8025
KS097;    Kreisfreie Städte Schwaben;Ausländer;50 bis unter 65;14084;7404;6680
KS097;    Kreisfreie Städte Schwaben;Ausländer;65 oder älter;9260;4368;4892
KS097;    Kreisfreie Städte Schwaben;Ausländer;Insgesamt;90397;47542;42855
09771;      Aichach-Friedberg (Lkr);Insgesamt;unter 6;8293;4228;4065
09771;      Aichach-Friedberg (Lkr);Insgesamt;6 bis unter 15;11434;5830;5604
09771;      Aichach-Friedberg (Lkr);Insgesamt;15 bis unter 18;4180;2132;2048
09771;      Aichach-Friedberg (Lkr);Insgesamt;18 bis unter 25;10259;5414;4845
09771;      Aichach-Friedberg (Lkr);Insgesamt;25 bis unter 30;7323;3910;3413
09771;      Aichach-Friedberg (Lkr);Insgesamt;30 bis unter 40;16449;8238;8211
09771;      Aichach-Friedberg (Lkr);Insgesamt;40 bis unter 50;17757;8997;8760
09771;      Aichach-Friedberg (Lkr);Insgesamt;50 bis unter 65;31417;15858;15559
09771;      Aichach-Friedberg (Lkr);Insgesamt;65 oder älter;26484;12044;14440
09771;      Aichach-Friedberg (Lkr);Insgesamt;Insgesamt;133596;66651;66945
09771;      Aichach-Friedberg (Lkr);Deutsche;unter 6;7578;3860;3718
09771;      Aichach-Friedberg (Lkr);Deutsche;6 bis unter 15;10639;5429;5210
09771;      Aichach-Friedberg (Lkr);Deutsche;15 bis unter 18;3935;1980;1955
09771;      Aichach-Friedberg (Lkr);Deutsche;18 bis unter 25;9202;4768;4434
09771;      Aichach-Friedberg (Lkr);Deutsche;25 bis unter 30;6263;3272;2991
09771;      Aichach-Friedberg (Lkr);Deutsche;30 bis unter 40;13969;6879;7090
09771;      Aichach-Friedberg (Lkr);Deutsche;40 bis unter 50;15439;7730;7709
09771;      Aichach-Friedberg (Lkr);Deutsche;50 bis unter 65;29672;14901;14771
09771;      Aichach-Friedberg (Lkr);Deutsche;65 oder älter;25681;11625;14056
09771;      Aichach-Friedberg (Lkr);Deutsche;Insgesamt;122378;60444;61934
09771;      Aichach-Friedberg (Lkr);Ausländer;unter 6;715;368;347
09771;      Aichach-Friedberg (Lkr);Ausländer;6 bis unter 15;795;401;394
09771;      Aichach-Friedberg (Lkr);Ausländer;15 bis unter 18;245;152;93
09771;      Aichach-Friedberg (Lkr);Ausländer;18 bis unter 25;1057;646;411
09771;      Aichach-Friedberg (Lkr);Ausländer;25 bis unter 30;1060;638;422
09771;      Aichach-Friedberg (Lkr);Ausländer;30 bis unter 40;2480;1359;1121
09771;      Aichach-Friedberg (Lkr);Ausländer;40 bis unter 50;2318;1267;1051
09771;      Aichach-Friedberg (Lkr);Ausländer;50 bis unter 65;1745;957;788
09771;      Aichach-Friedberg (Lkr);Ausländer;65 oder älter;803;419;384
09771;      Aichach-Friedberg (Lkr);Ausländer;Insgesamt;11218;6207;5011
09772;      Augsburg (Lkr);Insgesamt;unter 6;15245;7777;7468
09772;      Augsburg (Lkr);Insgesamt;6 bis unter 15;21204;10933;10271
09772;      Augsburg (Lkr);Insgesamt;15 bis unter 18;7724;3946;3778
09772;      Augsburg (Lkr);Insgesamt;18 bis unter 25;18912;10120;8792
09772;      Augsburg (Lkr);Insgesamt;25 bis unter 30;13976;7303;6673
09772;      Augsburg (Lkr);Insgesamt;30 bis unter 40;30667;15483;15184
09772;      Augsburg (Lkr);Insgesamt;40 bis unter 50;33010;16553;16457
09772;      Augsburg (Lkr);Insgesamt;50 bis unter 65;59238;29607;29631
09772;      Augsburg (Lkr);Insgesamt;65 oder älter;51558;23085;28473
09772;      Augsburg (Lkr);Insgesamt;Insgesamt;251534;124807;126727
09772;      Augsburg (Lkr);Deutsche;unter 6;13839;7084;6755
09772;      Augsburg (Lkr);Deutsche;6 bis unter 15;19640;10094;9546
09772;      Augsburg (Lkr);Deutsche;15 bis unter 18;7258;3691;3567
09772;      Augsburg (Lkr);Deutsche;18 bis unter 25;16463;8666;7797
09772;      Augsburg (Lkr);Deutsche;25 bis unter 30;11740;6026;5714
09772;      Augsburg (Lkr);Deutsche;30 bis unter 40;25523;12672;12851
09772;      Augsburg (Lkr);Deutsche;40 bis unter 50;28048;13955;14093
09772;      Augsburg (Lkr);Deutsche;50 bis unter 65;55355;27584;27771
09772;      Augsburg (Lkr);Deutsche;65 oder älter;49320;21969;27351
09772;      Augsburg (Lkr);Deutsche;Insgesamt;227186;111741;115445
09772;      Augsburg (Lkr);Ausländer;unter 6;1406;693;713
09772;      Augsburg (Lkr);Ausländer;6 bis unter 15;1564;839;725
09772;      Augsburg (Lkr);Ausländer;15 bis unter 18;466;255;211
09772;      Augsburg (Lkr);Ausländer;18 bis unter 25;2449;1454;995
09772;      Augsburg (Lkr);Ausländer;25 bis unter 30;2236;1277;959
09772;      Augsburg (Lkr);Ausländer;30 bis unter 40;5144;2811;2333
09772;      Augsburg (Lkr);Ausländer;40 bis unter 50;4962;2598;2364
09772;      Augsburg (Lkr);Ausländer;50 bis unter 65;3883;2023;1860
09772;      Augsburg (Lkr);Ausländer;65 oder älter;2238;1116;1122
09772;      Augsburg (Lkr);Ausländer;Insgesamt;24348;13066;11282
09773;      Dillingen a.d.Donau (Lkr);Insgesamt;unter 6;5387;2778;2609
09773;      Dillingen a.d.Donau (Lkr);Insgesamt;6 bis unter 15;7996;4097;3899
09773;      Dillingen a.d.Donau (Lkr);Insgesamt;15 bis unter 18;3020;1552;1468
09773;      Dillingen a.d.Donau (Lkr);Insgesamt;18 bis unter 25;7719;4116;3603
09773;      Dillingen a.d.Donau (Lkr);Insgesamt;25 bis unter 30;5811;3084;2727
09773;      Dillingen a.d.Donau (Lkr);Insgesamt;30 bis unter 40;11412;5951;5461
09773;      Dillingen a.d.Donau (Lkr);Insgesamt;40 bis unter 50;12520;6355;6165
09773;      Dillingen a.d.Donau (Lkr);Insgesamt;50 bis unter 65;22821;11524;11297
09773;      Dillingen a.d.Donau (Lkr);Insgesamt;65 oder älter;19335;8678;10657
09773;      Dillingen a.d.Donau (Lkr);Insgesamt;Insgesamt;96021;48135;47886
09773;      Dillingen a.d.Donau (Lkr);Deutsche;unter 6;4788;2471;2317
09773;      Dillingen a.d.Donau (Lkr);Deutsche;6 bis unter 15;7289;3745;3544
09773;      Dillingen a.d.Donau (Lkr);Deutsche;15 bis unter 18;2799;1429;1370
09773;      Dillingen a.d.Donau (Lkr);Deutsche;18 bis unter 25;6677;3476;3201
09773;      Dillingen a.d.Donau (Lkr);Deutsche;25 bis unter 30;4909;2567;2342
09773;      Dillingen a.d.Donau (Lkr);Deutsche;30 bis unter 40;9587;4925;4662
09773;      Dillingen a.d.Donau (Lkr);Deutsche;40 bis unter 50;10607;5328;5279
09773;      Dillingen a.d.Donau (Lkr);Deutsche;50 bis unter 65;21329;10678;10651
09773;      Dillingen a.d.Donau (Lkr);Deutsche;65 oder älter;18742;8380;10362
09773;      Dillingen a.d.Donau (Lkr);Deutsche;Insgesamt;86727;42999;43728
09773;      Dillingen a.d.Donau (Lkr);Ausländer;unter 6;599;307;292
09773;      Dillingen a.d.Donau (Lkr);Ausländer;6 bis unter 15;707;352;355
09773;      Dillingen a.d.Donau (Lkr);Ausländer;15 bis unter 18;221;123;98
09773;      Dillingen a.d.Donau (Lkr);Ausländer;18 bis unter 25;1042;640;402
09773;      Dillingen a.d.Donau (Lkr);Ausländer;25 bis unter 30;902;517;385
09773;      Dillingen a.d.Donau (Lkr);Ausländer;30 bis unter 40;1825;1026;799
09773;      Dillingen a.d.Donau (Lkr);Ausländer;40 bis unter 50;1913;1027;886
09773;      Dillingen a.d.Donau (Lkr);Ausländer;50 bis unter 65;1492;846;646
09773;      Dillingen a.d.Donau (Lkr);Ausländer;65 oder älter;593;298;295
09773;      Dillingen a.d.Donau (Lkr);Ausländer;Insgesamt;9294;5136;4158
09774;      Günzburg (Lkr);Insgesamt;unter 6;7225;3754;3471
09774;      Günzburg (Lkr);Insgesamt;6 bis unter 15;10409;5379;5030
09774;      Günzburg (Lkr);Insgesamt;15 bis unter 18;3929;2052;1877
09774;      Günzburg (Lkr);Insgesamt;18 bis unter 25;10170;5502;4668
09774;      Günzburg (Lkr);Insgesamt;25 bis unter 30;8001;4297;3704
09774;      Günzburg (Lkr);Insgesamt;30 bis unter 40;15480;8079;7401
09774;      Günzburg (Lkr);Insgesamt;40 bis unter 50;16699;8487;8212
09774;      Günzburg (Lkr);Insgesamt;50 bis unter 65;29461;14889;14572
09774;      Günzburg (Lkr);Insgesamt;65 oder älter;24373;11137;13236
09774;      Günzburg (Lkr);Insgesamt;Insgesamt;125747;63576;62171
09774;      Günzburg (Lkr);Deutsche;unter 6;6381;3310;3071
09774;      Günzburg (Lkr);Deutsche;6 bis unter 15;9498;4922;4576
09774;      Günzburg (Lkr);Deutsche;15 bis unter 18;3619;1886;1733
09774;      Günzburg (Lkr);Deutsche;18 bis unter 25;8263;4380;3883
09774;      Günzburg (Lkr);Deutsche;25 bis unter 30;6193;3265;2928
09774;      Günzburg (Lkr);Deutsche;30 bis unter 40;12063;6113;5950
09774;      Günzburg (Lkr);Deutsche;40 bis unter 50;13270;6591;6679
09774;      Günzburg (Lkr);Deutsche;50 bis unter 65;26797;13445;13352
09774;      Günzburg (Lkr);Deutsche;65 oder älter;23030;10488;12542
09774;      Günzburg (Lkr);Deutsche;Insgesamt;109114;54400;54714
09774;      Günzburg (Lkr);Ausländer;unter 6;844;444;400
09774;      Günzburg (Lkr);Ausländer;6 bis unter 15;911;457;454
09774;      Günzburg (Lkr);Ausländer;15 bis unter 18;310;166;144
09774;      Günzburg (Lkr);Ausländer;18 bis unter 25;1907;1122;785
09774;      Günzburg (Lkr);Ausländer;25 bis unter 30;1808;1032;776
09774;      Günzburg (Lkr);Ausländer;30 bis unter 40;3417;1966;1451
09774;      Günzburg (Lkr);Ausländer;40 bis unter 50;3429;1896;1533
09774;      Günzburg (Lkr);Ausländer;50 bis unter 65;2664;1444;1220
09774;      Günzburg (Lkr);Ausländer;65 oder älter;1343;649;694
09774;      Günzburg (Lkr);Ausländer;Insgesamt;16633;9176;7457
09775;      Neu-Ulm (Lkr);Insgesamt;unter 6;10027;5138;4889
09775;      Neu-Ulm (Lkr);Insgesamt;6 bis unter 15;14390;7254;7136
09775;      Neu-Ulm (Lkr);Insgesamt;15 bis unter 18;5234;2703;2531
09775;      Neu-Ulm (Lkr);Insgesamt;18 bis unter 25;14027;7436;6591
09775;      Neu-Ulm (Lkr);Insgesamt;25 bis unter 30;11083;5736;5347
09775;      Neu-Ulm (Lkr);Insgesamt;30 bis unter 40;22936;11799;11137
09775;      Neu-Ulm (Lkr);Insgesamt;40 bis unter 50;22828;11528;11300
09775;      Neu-Ulm (Lkr);Insgesamt;50 bis unter 65;38490;19217;19273
09775;      Neu-Ulm (Lkr);Insgesamt;65 oder älter;35185;15659;19526
09775;      Neu-Ulm (Lkr);Insgesamt;Insgesamt;174200;86470;87730
09775;      Neu-Ulm (Lkr);Deutsche;unter 6;8804;4513;4291
09775;      Neu-Ulm (Lkr);Deutsche;6 bis unter 15;12915;6481;6434
09775;      Neu-Ulm (Lkr);Deutsche;15 bis unter 18;4739;2419;2320
09775;      Neu-Ulm (Lkr);Deutsche;18 bis unter 25;11134;5708;5426
09775;      Neu-Ulm (Lkr);Deutsche;25 bis unter 30;8450;4249;4201
09775;      Neu-Ulm (Lkr);Deutsche;30 bis unter 40;17486;8807;8679
09775;      Neu-Ulm (Lkr);Deutsche;40 bis unter 50;17665;8764;8901
09775;      Neu-Ulm (Lkr);Deutsche;50 bis unter 65;34492;17100;17392
09775;      Neu-Ulm (Lkr);Deutsche;65 oder älter;32768;14429;18339
09775;      Neu-Ulm (Lkr);Deutsche;Insgesamt;148453;72470;75983
09775;      Neu-Ulm (Lkr);Ausländer;unter 6;1223;625;598
09775;      Neu-Ulm (Lkr);Ausländer;6 bis unter 15;1475;773;702
09775;      Neu-Ulm (Lkr);Ausländer;15 bis unter 18;495;284;211
09775;      Neu-Ulm (Lkr);Ausländer;18 bis unter 25;2893;1728;1165
09775;      Neu-Ulm (Lkr);Ausländer;25 bis unter 30;2633;1487;1146
09775;      Neu-Ulm (Lkr);Ausländer;30 bis unter 40;5450;2992;2458
09775;      Neu-Ulm (Lkr);Ausländer;40 bis unter 50;5163;2764;2399
09775;      Neu-Ulm (Lkr);Ausländer;50 bis unter 65;3998;2117;1881
09775;      Neu-Ulm (Lkr);Ausländer;65 oder älter;2417;1230;1187
09775;      Neu-Ulm (Lkr);Ausländer;Insgesamt;25747;14000;11747
09776;      Lindau (Bodensee) (Lkr);Insgesamt;unter 6;4448;2271;2177
09776;      Lindau (Bodensee) (Lkr);Insgesamt;6 bis unter 15;6451;3328;3123
09776;      Lindau (Bodensee) (Lkr);Insgesamt;15 bis unter 18;2570;1373;1197
09776;      Lindau (Bodensee) (Lkr);Insgesamt;18 bis unter 25;6074;3233;2841
09776;      Lindau (Bodensee) (Lkr);Insgesamt;25 bis unter 30;4509;2335;2174
09776;      Lindau (Bodensee) (Lkr);Insgesamt;30 bis unter 40;9779;5019;4760
09776;      Lindau (Bodensee) (Lkr);Insgesamt;40 bis unter 50;10302;5003;5299
09776;      Lindau (Bodensee) (Lkr);Insgesamt;50 bis unter 65;19080;9493;9587
09776;      Lindau (Bodensee) (Lkr);Insgesamt;65 oder älter;18456;8230;10226
09776;      Lindau (Bodensee) (Lkr);Insgesamt;Insgesamt;81669;40285;41384
09776;      Lindau (Bodensee) (Lkr);Deutsche;unter 6;3919;1984;1935
09776;      Lindau (Bodensee) (Lkr);Deutsche;6 bis unter 15;5863;3037;2826
09776;      Lindau (Bodensee) (Lkr);Deutsche;15 bis unter 18;2310;1219;1091
09776;      Lindau (Bodensee) (Lkr);Deutsche;18 bis unter 25;5027;2640;2387
09776;      Lindau (Bodensee) (Lkr);Deutsche;25 bis unter 30;3444;1758;1686
09776;      Lindau (Bodensee) (Lkr);Deutsche;30 bis unter 40;7613;3846;3767
09776;      Lindau (Bodensee) (Lkr);Deutsche;40 bis unter 50;8404;4119;4285
09776;      Lindau (Bodensee) (Lkr);Deutsche;50 bis unter 65;17090;8498;8592
09776;      Lindau (Bodensee) (Lkr);Deutsche;65 oder älter;17183;7627;9556
09776;      Lindau (Bodensee) (Lkr);Deutsche;Insgesamt;70853;34728;36125
09776;      Lindau (Bodensee) (Lkr);Ausländer;unter 6;529;287;242
09776;      Lindau (Bodensee) (Lkr);Ausländer;6 bis unter 15;588;291;297
09776;      Lindau (Bodensee) (Lkr);Ausländer;15 bis unter 18;260;154;106
09776;      Lindau (Bodensee) (Lkr);Ausländer;18 bis unter 25;1047;593;454
09776;      Lindau (Bodensee) (Lkr);Ausländer;25 bis unter 30;1065;577;488
09776;      Lindau (Bodensee) (Lkr);Ausländer;30 bis unter 40;2166;1173;993
09776;      Lindau (Bodensee) (Lkr);Ausländer;40 bis unter 50;1898;884;1014
09776;      Lindau (Bodensee) (Lkr);Ausländer;50 bis unter 65;1990;995;995
09776;      Lindau (Bodensee) (Lkr);Ausländer;65 oder älter;1273;603;670
09776;      Lindau (Bodensee) (Lkr);Ausländer;Insgesamt;10816;5557;5259
09777;      Ostallgäu (Lkr);Insgesamt;unter 6;8377;4287;4090
09777;      Ostallgäu (Lkr);Insgesamt;6 bis unter 15;11879;5986;5893
09777;      Ostallgäu (Lkr);Insgesamt;15 bis unter 18;4368;2262;2106
09777;      Ostallgäu (Lkr);Insgesamt;18 bis unter 25;10859;5806;5053
09777;      Ostallgäu (Lkr);Insgesamt;25 bis unter 30;8138;4260;3878
09777;      Ostallgäu (Lkr);Insgesamt;30 bis unter 40;16783;8563;8220
09777;      Ostallgäu (Lkr);Insgesamt;40 bis unter 50;17800;8926;8874
09777;      Ostallgäu (Lkr);Insgesamt;50 bis unter 65;32496;16246;16250
09777;      Ostallgäu (Lkr);Insgesamt;65 oder älter;29616;13632;15984
09777;      Ostallgäu (Lkr);Insgesamt;Insgesamt;140316;69968;70348
09777;      Ostallgäu (Lkr);Deutsche;unter 6;7726;3935;3791
09777;      Ostallgäu (Lkr);Deutsche;6 bis unter 15;11152;5625;5527
09777;      Ostallgäu (Lkr);Deutsche;15 bis unter 18;4110;2117;1993
09777;      Ostallgäu (Lkr);Deutsche;18 bis unter 25;9442;4945;4497
09777;      Ostallgäu (Lkr);Deutsche;25 bis unter 30;6916;3547;3369
09777;      Ostallgäu (Lkr);Deutsche;30 bis unter 40;14270;7185;7085
09777;      Ostallgäu (Lkr);Deutsche;40 bis unter 50;15428;7692;7736
09777;      Ostallgäu (Lkr);Deutsche;50 bis unter 65;30524;15230;15294
09777;      Ostallgäu (Lkr);Deutsche;65 oder älter;28493;13112;15381
09777;      Ostallgäu (Lkr);Deutsche;Insgesamt;128061;63388;64673
09777;      Ostallgäu (Lkr);Ausländer;unter 6;651;352;299
09777;      Ostallgäu (Lkr);Ausländer;6 bis unter 15;727;361;366
09777;      Ostallgäu (Lkr);Ausländer;15 bis unter 18;258;145;113
09777;      Ostallgäu (Lkr);Ausländer;18 bis unter 25;1417;861;556
09777;      Ostallgäu (Lkr);Ausländer;25 bis unter 30;1222;713;509
09777;      Ostallgäu (Lkr);Ausländer;30 bis unter 40;2513;1378;1135
09777;      Ostallgäu (Lkr);Ausländer;40 bis unter 50;2372;1234;1138
09777;      Ostallgäu (Lkr);Ausländer;50 bis unter 65;1972;1016;956
09777;      Ostallgäu (Lkr);Ausländer;65 oder älter;1123;520;603
09777;      Ostallgäu (Lkr);Ausländer;Insgesamt;12255;6580;5675
09778;      Unterallgäu (Lkr);Insgesamt;unter 6;8447;4278;4169
09778;      Unterallgäu (Lkr);Insgesamt;6 bis unter 15;11801;6069;5732
09778;      Unterallgäu (Lkr);Insgesamt;15 bis unter 18;4429;2263;2166
09778;      Unterallgäu (Lkr);Insgesamt;18 bis unter 25;11628;6345;5283
09778;      Unterallgäu (Lkr);Insgesamt;25 bis unter 30;8698;4690;4008
09778;      Unterallgäu (Lkr);Insgesamt;30 bis unter 40;17105;8910;8195
09778;      Unterallgäu (Lkr);Insgesamt;40 bis unter 50;18532;9566;8966
09778;      Unterallgäu (Lkr);Insgesamt;50 bis unter 65;33131;16792;16339
09778;      Unterallgäu (Lkr);Insgesamt;65 oder älter;30270;13695;16575
09778;      Unterallgäu (Lkr);Insgesamt;Insgesamt;144041;72608;71433
09778;      Unterallgäu (Lkr);Deutsche;unter 6;7670;3873;3797
09778;      Unterallgäu (Lkr);Deutsche;6 bis unter 15;10910;5610;5300
09778;      Unterallgäu (Lkr);Deutsche;15 bis unter 18;4144;2102;2042
09778;      Unterallgäu (Lkr);Deutsche;18 bis unter 25;10106;5377;4729
09778;      Unterallgäu (Lkr);Deutsche;25 bis unter 30;7235;3800;3435
09778;      Unterallgäu (Lkr);Deutsche;30 bis unter 40;14344;7327;7017
09778;      Unterallgäu (Lkr);Deutsche;40 bis unter 50;15876;8037;7839
09778;      Unterallgäu (Lkr);Deutsche;50 bis unter 65;31050;15610;15440
09778;      Unterallgäu (Lkr);Deutsche;65 oder älter;29291;13229;16062
09778;      Unterallgäu (Lkr);Deutsche;Insgesamt;130626;64965;65661
09778;      Unterallgäu (Lkr);Ausländer;unter 6;777;405;372
09778;      Unterallgäu (Lkr);Ausländer;6 bis unter 15;891;459;432
09778;      Unterallgäu (Lkr);Ausländer;15 bis unter 18;285;161;124
09778;      Unterallgäu (Lkr);Ausländer;18 bis unter 25;1522;968;554
09778;      Unterallgäu (Lkr);Ausländer;25 bis unter 30;1463;890;573
09778;      Unterallgäu (Lkr);Ausländer;30 bis unter 40;2761;1583;1178
09778;      Unterallgäu (Lkr);Ausländer;40 bis unter 50;2656;1529;1127
09778;      Unterallgäu (Lkr);Ausländer;50 bis unter 65;2081;1182;899
09778;      Unterallgäu (Lkr);Ausländer;65 oder älter;979;466;513
09778;      Unterallgäu (Lkr);Ausländer;Insgesamt;13415;7643;5772
09779;      Donau-Ries (Lkr);Insgesamt;unter 6;7481;3900;3581
09779;      Donau-Ries (Lkr);Insgesamt;6 bis unter 15;11289;5775;5514
09779;      Donau-Ries (Lkr);Insgesamt;15 bis unter 18;4131;2130;2001
09779;      Donau-Ries (Lkr);Insgesamt;18 bis unter 25;10912;5933;4979
09779;      Donau-Ries (Lkr);Insgesamt;25 bis unter 30;8049;4329;3720
09779;      Donau-Ries (Lkr);Insgesamt;30 bis unter 40;16636;8892;7744
09779;      Donau-Ries (Lkr);Insgesamt;40 bis unter 50;17639;9136;8503
09779;      Donau-Ries (Lkr);Insgesamt;50 bis unter 65;30868;15764;15104
09779;      Donau-Ries (Lkr);Insgesamt;65 oder älter;26491;11962;14529
09779;      Donau-Ries (Lkr);Insgesamt;Insgesamt;133496;67821;65675
09779;      Donau-Ries (Lkr);Deutsche;unter 6;6768;3535;3233
09779;      Donau-Ries (Lkr);Deutsche;6 bis unter 15;10326;5299;5027
09779;      Donau-Ries (Lkr);Deutsche;15 bis unter 18;3868;1990;1878
09779;      Donau-Ries (Lkr);Deutsche;18 bis unter 25;9283;4860;4423
09779;      Donau-Ries (Lkr);Deutsche;25 bis unter 30;6667;3515;3152
09779;      Donau-Ries (Lkr);Deutsche;30 bis unter 40;13822;7227;6595
09779;      Donau-Ries (Lkr);Deutsche;40 bis unter 50;15069;7662;7407
09779;      Donau-Ries (Lkr);Deutsche;50 bis unter 65;28953;14667;14286
09779;      Donau-Ries (Lkr);Deutsche;65 oder älter;25755;11594;14161
09779;      Donau-Ries (Lkr);Deutsche;Insgesamt;120511;60349;60162
09779;      Donau-Ries (Lkr);Ausländer;unter 6;713;365;348
09779;      Donau-Ries (Lkr);Ausländer;6 bis unter 15;963;476;487
09779;      Donau-Ries (Lkr);Ausländer;15 bis unter 18;263;140;123
09779;      Donau-Ries (Lkr);Ausländer;18 bis unter 25;1629;1073;556
09779;      Donau-Ries (Lkr);Ausländer;25 bis unter 30;1382;814;568
09779;      Donau-Ries (Lkr);Ausländer;30 bis unter 40;2814;1665;1149
09779;      Donau-Ries (Lkr);Ausländer;40 bis unter 50;2570;1474;1096
09779;      Donau-Ries (Lkr);Ausländer;50 bis unter 65;1915;1097;818
09779;      Donau-Ries (Lkr);Ausländer;65 oder älter;736;368;368
09779;      Donau-Ries (Lkr);Ausländer;Insgesamt;12985;7472;5513
09780;      Oberallgäu (Lkr);Insgesamt;unter 6;8747;4496;4251
09780;      Oberallgäu (Lkr);Insgesamt;6 bis unter 15;12045;6204;5841
09780;      Oberallgäu (Lkr);Insgesamt;15 bis unter 18;4544;2300;2244
09780;      Oberallgäu (Lkr);Insgesamt;18 bis unter 25;11407;6096;5311
09780;      Oberallgäu (Lkr);Insgesamt;25 bis unter 30;8840;4596;4244
09780;      Oberallgäu (Lkr);Insgesamt;30 bis unter 40;18056;9135;8921
09780;      Oberallgäu (Lkr);Insgesamt;40 bis unter 50;19697;9587;10110
09780;      Oberallgäu (Lkr);Insgesamt;50 bis unter 65;36820;18255;18565
09780;      Oberallgäu (Lkr);Insgesamt;65 oder älter;35206;15908;19298
09780;      Oberallgäu (Lkr);Insgesamt;Insgesamt;155362;76577;78785
09780;      Oberallgäu (Lkr);Deutsche;unter 6;8120;4177;3943
09780;      Oberallgäu (Lkr);Deutsche;6 bis unter 15;11353;5859;5494
09780;      Oberallgäu (Lkr);Deutsche;15 bis unter 18;4342;2189;2153
09780;      Oberallgäu (Lkr);Deutsche;18 bis unter 25;10002;5272;4730
09780;      Oberallgäu (Lkr);Deutsche;25 bis unter 30;7451;3821;3630
09780;      Oberallgäu (Lkr);Deutsche;30 bis unter 40;15460;7736;7724
09780;      Oberallgäu (Lkr);Deutsche;40 bis unter 50;17043;8299;8744
09780;      Oberallgäu (Lkr);Deutsche;50 bis unter 65;34274;16955;17319
09780;      Oberallgäu (Lkr);Deutsche;65 oder älter;33800;15236;18564
09780;      Oberallgäu (Lkr);Deutsche;Insgesamt;141845;69544;72301
09780;      Oberallgäu (Lkr);Ausländer;unter 6;627;319;308
09780;      Oberallgäu (Lkr);Ausländer;6 bis unter 15;692;345;347
09780;      Oberallgäu (Lkr);Ausländer;15 bis unter 18;202;111;91
09780;      Oberallgäu (Lkr);Ausländer;18 bis unter 25;1405;824;581
09780;      Oberallgäu (Lkr);Ausländer;25 bis unter 30;1389;775;614
09780;      Oberallgäu (Lkr);Ausländer;30 bis unter 40;2596;1399;1197
09780;      Oberallgäu (Lkr);Ausländer;40 bis unter 50;2654;1288;1366
09780;      Oberallgäu (Lkr);Ausländer;50 bis unter 65;2546;1300;1246
09780;      Oberallgäu (Lkr);Ausländer;65 oder älter;1406;672;734
09780;      Oberallgäu (Lkr);Ausländer;Insgesamt;13517;7033;6484
LK097;    Landkreise Schwaben;Insgesamt;unter 6;83677;42907;40770
LK097;    Landkreise Schwaben;Insgesamt;6 bis unter 15;118898;60855;58043
LK097;    Landkreise Schwaben;Insgesamt;15 bis unter 18;44129;22713;21416
LK097;    Landkreise Schwaben;Insgesamt;18 bis unter 25;111967;60001;51966
LK097;    Landkreise Schwaben;Insgesamt;25 bis unter 30;84428;44540;39888
LK097;    Landkreise Schwaben;Insgesamt;30 bis unter 40;175303;90069;85234
LK097;    Landkreise Schwaben;Insgesamt;40 bis unter 50;186784;94138;92646
LK097;    Landkreise Schwaben;Insgesamt;50 bis unter 65;333822;167645;166177
LK097;    Landkreise Schwaben;Insgesamt;65 oder älter;296974;134030;162944
LK097;    Landkreise Schwaben;Insgesamt;Insgesamt;1435982;716898;719084
LK097;    Landkreise Schwaben;Deutsche;unter 6;75593;38742;36851
LK097;    Landkreise Schwaben;Deutsche;6 bis unter 15;109585;56101;53484
LK097;    Landkreise Schwaben;Deutsche;15 bis unter 18;41124;21022;20102
LK097;    Landkreise Schwaben;Deutsche;18 bis unter 25;95599;50092;45507
LK097;    Landkreise Schwaben;Deutsche;25 bis unter 30;69268;35820;33448
LK097;    Landkreise Schwaben;Deutsche;30 bis unter 40;144137;72717;71420
LK097;    Landkreise Schwaben;Deutsche;40 bis unter 50;156849;78177;78672
LK097;    Landkreise Schwaben;Deutsche;50 bis unter 65;309536;154668;154868
LK097;    Landkreise Schwaben;Deutsche;65 oder älter;284063;127689;156374
LK097;    Landkreise Schwaben;Deutsche;Insgesamt;1285754;635028;650726
LK097;    Landkreise Schwaben;Ausländer;unter 6;8084;4165;3919
LK097;    Landkreise Schwaben;Ausländer;6 bis unter 15;9313;4754;4559
LK097;    Landkreise Schwaben;Ausländer;15 bis unter 18;3005;1691;1314
LK097;    Landkreise Schwaben;Ausländer;18 bis unter 25;16368;9909;6459
LK097;    Landkreise Schwaben;Ausländer;25 bis unter 30;15160;8720;6440
LK097;    Landkreise Schwaben;Ausländer;30 bis unter 40;31166;17352;13814
LK097;    Landkreise Schwaben;Ausländer;40 bis unter 50;29935;15961;13974
LK097;    Landkreise Schwaben;Ausländer;50 bis unter 65;24286;12977;11309
LK097;    Landkreise Schwaben;Ausländer;65 oder älter;12911;6341;6570
LK097;    Landkreise Schwaben;Ausländer;Insgesamt;150228;81870;68358
097;  Schwaben;Insgesamt;unter 6;109229;55916;53313
097;  Schwaben;Insgesamt;6 bis unter 15;152059;77905;74154
097;  Schwaben;Insgesamt;15 bis unter 18;55784;28694;27090
097;  Schwaben;Insgesamt;18 bis unter 25;152152;80317;71835
097;  Schwaben;Insgesamt;25 bis unter 30;121491;63785;57706
097;  Schwaben;Insgesamt;30 bis unter 40;240672;124618;116054
097;  Schwaben;Insgesamt;40 bis unter 50;242955;122779;120176
097;  Schwaben;Insgesamt;50 bis unter 65;424335;212585;211750
097;  Schwaben;Insgesamt;65 oder älter;389077;172918;216159
097;  Schwaben;Insgesamt;Insgesamt;1887754;939517;948237
097;  Schwaben;Deutsche;unter 6;96629;49502;47127
097;  Schwaben;Deutsche;6 bis unter 15;137908;70602;67306
097;  Schwaben;Deutsche;15 bis unter 18;50959;26037;24922
097;  Schwaben;Deutsche;18 bis unter 25;125632;64784;60848
097;  Schwaben;Deutsche;25 bis unter 30;96264;49573;46691
097;  Schwaben;Deutsche;30 bis unter 40;190568;97073;93495
097;  Schwaben;Deutsche;40 bis unter 50;196298;98121;98177
097;  Schwaben;Deutsche;50 bis unter 65;385965;192204;193761
097;  Schwaben;Deutsche;65 oder älter;366906;162209;204697
097;  Schwaben;Deutsche;Insgesamt;1647129;810105;837024
097;  Schwaben;Ausländer;unter 6;12600;6414;6186
097;  Schwaben;Ausländer;6 bis unter 15;14151;7303;6848
097;  Schwaben;Ausländer;15 bis unter 18;4825;2657;2168
097;  Schwaben;Ausländer;18 bis unter 25;26520;15533;10987
097;  Schwaben;Ausländer;25 bis unter 30;25227;14212;11015
097;  Schwaben;Ausländer;30 bis unter 40;50104;27545;22559
097;  Schwaben;Ausländer;40 bis unter 50;46657;24658;21999
097;  Schwaben;Ausländer;50 bis unter 65;38370;20381;17989
097;  Schwaben;Ausländer;65 oder älter;22171;10709;11462
097;  Schwaben;Ausländer;Insgesamt;240625;129412;111213
KS09;Kreisfreie Städte Bayern;Insgesamt;unter 6;226849;115887;110962
KS09;Kreisfreie Städte Bayern;Insgesamt;6 bis unter 15;280799;143973;136826
KS09;Kreisfreie Städte Bayern;Insgesamt;15 bis unter 18;91833;47580;44253
KS09;Kreisfreie Städte Bayern;Insgesamt;18 bis unter 25;336323;169608;166715
KS09;Kreisfreie Städte Bayern;Insgesamt;25 bis unter 30;334662;168875;165787
KS09;Kreisfreie Städte Bayern;Insgesamt;30 bis unter 40;603309;308952;294357
KS09;Kreisfreie Städte Bayern;Insgesamt;40 bis unter 50;497340;249878;247462
KS09;Kreisfreie Städte Bayern;Insgesamt;50 bis unter 65;754145;372697;381448
KS09;Kreisfreie Städte Bayern;Insgesamt;65 oder älter;740673;312784;427889
KS09;Kreisfreie Städte Bayern;Insgesamt;Insgesamt;3865933;1890234;1975699
KS09;Kreisfreie Städte Bayern;Deutsche;unter 6;185371;94607;90764
KS09;Kreisfreie Städte Bayern;Deutsche;6 bis unter 15;233967;119628;114339
KS09;Kreisfreie Städte Bayern;Deutsche;15 bis unter 18;75986;39100;36886
KS09;Kreisfreie Städte Bayern;Deutsche;18 bis unter 25;238172;115307;122865
KS09;Kreisfreie Städte Bayern;Deutsche;25 bis unter 30;235681;116431;119250
KS09;Kreisfreie Städte Bayern;Deutsche;30 bis unter 40;429425;219598;209827
KS09;Kreisfreie Städte Bayern;Deutsche;40 bis unter 50;355690;179457;176233
KS09;Kreisfreie Städte Bayern;Deutsche;50 bis unter 65;630522;309932;320590
KS09;Kreisfreie Städte Bayern;Deutsche;65 oder älter;660116;274396;385720
KS09;Kreisfreie Städte Bayern;Deutsche;Insgesamt;3044930;1468456;1576474
KS09;Kreisfreie Städte Bayern;Ausländer;unter 6;41478;21280;20198
KS09;Kreisfreie Städte Bayern;Ausländer;6 bis unter 15;46832;24345;22487
KS09;Kreisfreie Städte Bayern;Ausländer;15 bis unter 18;15847;8480;7367
KS09;Kreisfreie Städte Bayern;Ausländer;18 bis unter 25;98151;54301;43850
KS09;Kreisfreie Städte Bayern;Ausländer;25 bis unter 30;98981;52444;46537
KS09;Kreisfreie Städte Bayern;Ausländer;30 bis unter 40;173884;89354;84530
KS09;Kreisfreie Städte Bayern;Ausländer;40 bis unter 50;141650;70421;71229
KS09;Kreisfreie Städte Bayern;Ausländer;50 bis unter 65;123623;62765;60858
KS09;Kreisfreie Städte Bayern;Ausländer;65 oder älter;80557;38388;42169
KS09;Kreisfreie Städte Bayern;Ausländer;Insgesamt;821003;421778;399225
LK09;Landkreise Bayern;Insgesamt;unter 6;518835;265757;253078
LK09;Landkreise Bayern;Insgesamt;6 bis unter 15;752624;386563;366061
LK09;Landkreise Bayern;Insgesamt;15 bis unter 18;274520;141216;133304
LK09;Landkreise Bayern;Insgesamt;18 bis unter 25;707571;379854;327717
LK09;Landkreise Bayern;Insgesamt;25 bis unter 30;533378;283083;250295
LK09;Landkreise Bayern;Insgesamt;30 bis unter 40;1114617;570371;544246
LK09;Landkreise Bayern;Insgesamt;40 bis unter 50;1203865;605814;598051
LK09;Landkreise Bayern;Insgesamt;50 bis unter 65;2183487;1098355;1085132
LK09;Landkreise Bayern;Insgesamt;65 oder älter;1921891;862546;1059345
LK09;Landkreise Bayern;Insgesamt;Insgesamt;9210788;4593559;4617229
LK09;Landkreise Bayern;Deutsche;unter 6;466817;238872;227945
LK09;Landkreise Bayern;Deutsche;6 bis unter 15;691613;354939;336674
LK09;Landkreise Bayern;Deutsche;15 bis unter 18;255527;130833;124694
LK09;Landkreise Bayern;Deutsche;18 bis unter 25;610374;320628;289746
LK09;Landkreise Bayern;Deutsche;25 bis unter 30;439824;229100;210724
LK09;Landkreise Bayern;Deutsche;30 bis unter 40;923493;464849;458644
LK09;Landkreise Bayern;Deutsche;40 bis unter 50;1026556;510670;515886
LK09;Landkreise Bayern;Deutsche;50 bis unter 65;2039012;1020219;1018793
LK09;Landkreise Bayern;Deutsche;65 oder älter;1851785;828061;1023724
LK09;Landkreise Bayern;Deutsche;Insgesamt;8305001;4098171;4206830
LK09;Landkreise Bayern;Ausländer;unter 6;52018;26885;25133
LK09;Landkreise Bayern;Ausländer;6 bis unter 15;61011;31624;29387
LK09;Landkreise Bayern;Ausländer;15 bis unter 18;18993;10383;8610
LK09;Landkreise Bayern;Ausländer;18 bis unter 25;97197;59226;37971
LK09;Landkreise Bayern;Ausländer;25 bis unter 30;93554;53983;39571
LK09;Landkreise Bayern;Ausländer;30 bis unter 40;191124;105522;85602
LK09;Landkreise Bayern;Ausländer;40 bis unter 50;177309;95144;82165
LK09;Landkreise Bayern;Ausländer;50 bis unter 65;144475;78136;66339
LK09;Landkreise Bayern;Ausländer;65 oder älter;70106;34485;35621
LK09;Landkreise Bayern;Ausländer;Insgesamt;905787;495388;410399
09;Bayern;Insgesamt;unter 6;745684;381644;364040
09;Bayern;Insgesamt;6 bis unter 15;1033423;530536;502887
09;Bayern;Insgesamt;15 bis unter 18;366353;188796;177557
09;Bayern;Insgesamt;18 bis unter 25;1043894;549462;494432
09;Bayern;Insgesamt;25 bis unter 30;868040;451958;416082
09;Bayern;Insgesamt;30 bis unter 40;1717926;879323;838603
09;Bayern;Insgesamt;40 bis unter 50;1701205;855692;845513
09;Bayern;Insgesamt;50 bis unter 65;2937632;1471052;1466580
09;Bayern;Insgesamt;65 oder älter;2662564;1175330;1487234
09;Bayern;Insgesamt;Insgesamt;13076721;6483793;6592928
09;Bayern;Deutsche;unter 6;652188;333479;318709
09;Bayern;Deutsche;6 bis unter 15;925580;474567;451013
09;Bayern;Deutsche;15 bis unter 18;331513;169933;161580
09;Bayern;Deutsche;18 bis unter 25;848546;435935;412611
09;Bayern;Deutsche;25 bis unter 30;675505;345531;329974
09;Bayern;Deutsche;30 bis unter 40;1352918;684447;668471
09;Bayern;Deutsche;40 bis unter 50;1382246;690127;692119
09;Bayern;Deutsche;50 bis unter 65;2669534;1330151;1339383
09;Bayern;Deutsche;65 oder älter;2511901;1102457;1409444
09;Bayern;Deutsche;Insgesamt;11349931;5566627;5783304
09;Bayern;Ausländer;unter 6;93496;48165;45331
09;Bayern;Ausländer;6 bis unter 15;107843;55969;51874
09;Bayern;Ausländer;15 bis unter 18;34840;18863;15977
09;Bayern;Ausländer;18 bis unter 25;195348;113527;81821
09;Bayern;Ausländer;25 bis unter 30;192535;106427;86108
09;Bayern;Ausländer;30 bis unter 40;365008;194876;170132
09;Bayern;Ausländer;40 bis unter 50;318959;165565;153394
09;Bayern;Ausländer;50 bis unter 65;268098;140901;127197
09;Bayern;Ausländer;65 oder älter;150663;72873;77790
09;Bayern;Ausländer;Insgesamt;1726790;917166;809624
